Term	Accession	Genes (tot)	Stat (non-dir.) p	p adj (non-dir.)	Significant..in.gene.set.	Non.significant..in.gene.set.	Significant..not.in.gene.set.	Non.significant..not.in.gene.set.	effect.size
GO:0000002	mitochondrial genome maintenance	  6	0.19623335243315	1	2	4	909	5674	2.41090376875229
GO:0000030	mannosyltransferase activity	  6	0.19623335243315	1	2	4	909	5674	2.41090376875229
GO:0000038	very long-chain fatty acid metabolic process	  5	0.524912504930412	1	1	4	910	5674	1.44654226125137
GO:0000042	protein targeting to Golgi	  9	0.359581374002193	1	2	7	909	5671	1.60726917916819
GO:0000045	autophagosome assembly	 27	0.314618865714415	1	5	22	906	5656	1.33939098264016
GO:0000049	tRNA binding	 20	0.131823772311556	1	5	15	906	5663	1.80817782656422
GO:0000050	urea cycle	  5	1	1	0	5	911	5673	0
GO:0000055	ribosomal large subunit export from nucleus	  5	1	1	0	5	911	5673	0
GO:0000060	protein import into nucleus, translocation	 10	0.150143518293906	1	3	7	908	5671	2.16981339187706
GO:0000062	fatty-acyl-CoA binding	  6	1	1	0	6	911	5672	0
GO:0000070	mitotic sister chromatid segregation	  8	1	1	0	8	911	5670	0
GO:0000077	DNA damage checkpoint	 10	0.150143518293906	1	3	7	908	5671	2.16981339187706
GO:0000079	regulation of cyclin-dependent protein serine/threonine kinase activity	 20	0.785819229034214	1	2	18	909	5660	0.723271130625686
GO:0000082	G1/S transition of mitotic cell cycle	 46	0.896758306068193	1	4	42	907	5636	0.628931417935379
GO:0000083	regulation of transcription involved in G1/S transition of mitotic cell cycle	  5	0.524912504930412	1	1	4	910	5674	1.44654226125137
GO:0000086	G2/M transition of mitotic cell cycle	 69	0.858824107400335	1	7	62	904	5616	0.733753320924609
GO:0000118	histone deacetylase complex	 18	0.462686108033741	1	3	15	908	5663	1.20545188437614
GO:0000123	histone acetyltransferase complex	 15	0.0454641532950084	1	5	10	906	5668	2.41090376875229
GO:0000124	SAGA complex	  5	1	1	0	5	911	5673	0
GO:0000132	establishment of mitotic spindle orientation	  6	0.590648335429865	1	1	5	910	5673	1.20545188437614
GO:0000145	exocyst	 11	0.805664391834832	1	1	10	910	5668	0.657519209659715
GO:0000149	SNARE binding	 31	0.82259159109624	1	3	28	908	5650	0.699939803831309
GO:0000151	ubiquitin ligase complex	 44	0.581057099765452	1	6	38	905	5640	0.986278814489572
GO:0000159	protein phosphatase type 2A complex	 12	0.224422574243593	1	3	9	908	5669	1.80817782656421
GO:0000175	3	 14	0.596015503295557	1	2	12	909	5666	1.03324447232241
GO:0000176	nuclear exosome (RNase complex)	  5	0.143519565197953	1	2	3	909	5675	2.89308452250274
GO:0000178	exosome (RNase complex)	  8	0.305579489538918	1	2	6	909	5672	1.80817782656422
GO:0000183	chromatin silencing at rDNA	  6	0.19623335243315	1	2	4	909	5674	2.41090376875229
GO:0000184	nuclear-transcribed mRNA catabolic process, nonsense-mediated decay	 22	0.828939082355288	1	2	20	909	5658	0.657519209659715
GO:0000185	activation of MAPKKK activity	  8	1	1	0	8	911	5670	0
GO:0000186	activation of MAPKK activity	 26	0.493270603294985	1	4	22	907	5656	1.11272481634721
GO:0000187	activation of MAPK activity	 44	0.581057099765452	1	6	38	905	5640	0.986278814489572
GO:0000188	inactivation of MAPK activity	 14	0.303988344911165	1	3	11	908	5667	1.54986670848361
GO:0000226	microtubule cytoskeleton organization	 49	0.36468458382293	1	8	41	903	5637	1.18085082551132
GO:0000228	nuclear chromosome	 10	0.774429434347452	1	1	9	910	5669	0.723271130625686
GO:0000242	pericentriolar material	 14	0.875749379780082	1	1	13	910	5665	0.516622236161204
GO:0000245	spliceosomal complex assembly	 11	0.186315240979503	1	3	8	908	5670	1.97255762897914
GO:0000266	mitochondrial fission	 10	0.00689228204720671	0.768274064449573	5	5	906	5673	3.61635565312843
GO:0000278	mitotic cell cycle	 44	0.256930945279837	1	8	36	903	5642	1.31503841931943
GO:0000281	mitotic cytokinesis	 15	1	1	0	15	911	5663	0
GO:0000287	magnesium ion binding	 95	0.233984146036057	1	16	79	895	5599	1.2181408515801
GO:0000288	nuclear-transcribed mRNA catabolic process, deadenylation-dependent decay	  9	0.359581374002193	1	2	7	909	5671	1.60726917916819
GO:0000289	nuclear-transcribed mRNA poly(A) tail shortening	 15	0.344361377150163	1	3	12	908	5666	1.44654226125137
GO:0000302	response to reactive oxygen species	  7	1	1	0	7	911	5671	0
GO:0000307	cyclin-dependent protein kinase holoenzyme complex	  8	0.305579489538918	1	2	6	909	5672	1.80817782656422
GO:0000338	protein deneddylation	  6	0.590648335429865	1	1	5	910	5673	1.20545188437614
GO:0000340	RNA 7-methylguanosine cap binding	  5	1	1	0	5	911	5673	0
GO:0000375	RNA splicing, via transesterification reactions	 14	0.303988344911165	1	3	11	908	5667	1.54986670848361
GO:0000380	alternative mRNA splicing, via spliceosome	  9	0.359581374002193	1	2	7	909	5671	1.60726917916819
GO:0000381	regulation of alternative mRNA splicing, via spliceosome	 20	0.295727251817412	1	4	16	907	5662	1.44654226125137
GO:0000387	spliceosomal snRNP assembly	  7	0.0599286150311256	1	3	4	908	5674	3.09973341696723
GO:0000400	four-way junction DNA binding	  6	0.590648335429865	1	1	5	910	5673	1.20545188437614
GO:0000407	pre-autophagosomal structure	 10	0.774429434347452	1	1	9	910	5669	0.723271130625686
GO:0000413	protein peptidyl-prolyl isomerization	 18	1	1	0	18	911	5660	0
GO:0000421	autophagosome membrane	 14	0.116620999245796	1	4	10	907	5668	2.06648894464482
GO:0000422	autophagy of mitochondrion	 18	0.462686108033741	1	3	15	908	5663	1.20545188437614
GO:0000423	mitophagy	  5	1	1	0	5	911	5673	0
GO:0000439	core TFIIH complex	  5	5.00470543389846e-05	0.177264945402662	5	0	906	5678	7.23271130625686
GO:0000460	maturation of 5.8S rRNA	  7	0.647297183435849	1	1	6	910	5672	1.03324447232241
GO:0000462	maturation of SSU-rRNA from tricistronic rRNA transcript (SSU-rRNA, 5.8S rRNA, LSU-rRNA)	  6	1	1	0	6	911	5672	0
GO:0000470	maturation of LSU-rRNA	  5	0.524912504930412	1	1	4	910	5674	1.44654226125137
GO:0000502	proteasome complex	 28	0.343606597461169	1	5	23	906	5655	1.29155559040301
GO:0000715	nucleotide-excision repair, DNA damage recognition	 12	0.832578307772574	1	1	11	910	5667	0.602725942188072
GO:0000717	nucleotide-excision repair, DNA duplex unwinding	 11	0.0536855911323149	1	4	7	907	5671	2.63007683863886
GO:0000723	telomere maintenance	 11	0.805664391834832	1	1	10	910	5668	0.657519209659715
GO:0000724	double-strand break repair via homologous recombination	 23	0.634832927753238	1	3	20	908	5658	0.943397126903069
GO:0000731	DNA synthesis involved in DNA repair	  5	0.0212050012661332	1	3	2	908	5676	4.33962678375412
GO:0000774	adenyl-nucleotide exchange factor activity	  7	0.647297183435849	1	1	6	910	5672	1.03324447232241
GO:0000775	chromosome, centromeric region	 57	0.00888924201532428	0.780954774083801	15	42	896	5636	1.90334508059391
GO:0000776	kinetochore	 54	0.0615407811381527	1	12	42	899	5636	1.60726917916819
GO:0000777	condensed chromosome kinetochore	 40	0.0416319932204501	1	10	30	901	5648	1.80817782656422
GO:0000781	chromosome, telomeric region	 17	0.424058507911188	1	3	14	908	5664	1.27636081875121
GO:0000784	nuclear chromosome, telomeric region	 37	0.405559436943373	1	6	31	905	5647	1.17287210371733
GO:0000785	chromatin	 53	0.189087768304193	1	10	43	901	5635	1.3646625106145
GO:0000786	nucleosome	 17	0.920576476962146	1	1	16	910	5662	0.425453606250404
GO:0000790	nuclear chromatin	 84	0.177379219113322	1	15	69	896	5609	1.29155559040301
GO:0000792	heterochromatin	 13	0.855768388602616	1	1	12	910	5666	0.556362408173605
GO:0000793	condensed chromosome	 11	0.0536855911323149	1	4	7	907	5671	2.63007683863886
GO:0000794	condensed nuclear chromosome	 14	0.303988344911165	1	3	11	908	5667	1.54986670848361
GO:0000795	synaptonemal complex	  7	0.647297183435849	1	1	6	910	5672	1.03324447232241
GO:0000900	translation repressor activity, nucleic acid binding	  9	0.738180574705634	1	1	8	910	5670	0.803634589584096
GO:0000902	cell morphogenesis	 31	0.638235698030361	1	4	27	907	5651	0.933253071775079
GO:0000910	cytokinesis	 20	0.131823772311556	1	5	15	906	5663	1.80817782656422
GO:0000920	cell separation after cytokinesis	  7	1	1	0	7	911	5671	0
GO:0000922	spindle pole	 52	0.743544960994909	1	6	46	905	5632	0.834543612260407
GO:0000923	equatorial microtubule organizing center	  5	0.524912504930412	1	1	4	910	5674	1.44654226125137
GO:0000930	gamma-tubulin complex	  8	0.696113996849696	1	1	7	910	5671	0.904088913282108
GO:0000932	P-body	 44	0.407812795554757	1	7	37	904	5641	1.1506586169045
GO:0000956	nuclear-transcribed mRNA catabolic process	  6	0.590648335429865	1	1	5	910	5673	1.20545188437614
GO:0000975	regulatory region DNA binding	  7	0.647297183435849	1	1	6	910	5672	1.03324447232241
GO:0000976	transcription regulatory region sequence-specific DNA binding	 16	0.384511432262289	1	3	13	908	5665	1.35613336992316
GO:0000977	RNA polymerase II regulatory region sequence-specific DNA binding	 79	0.782311655447304	1	9	70	902	5608	0.823979769067237
GO:0000979	RNA polymerase II core promoter sequence-specific DNA binding	 28	0.554462782906824	1	4	24	907	5654	1.03324447232241
GO:0000980	RNA polymerase II distal enhancer sequence-specific DNA binding	 23	0.967568791201491	1	1	22	910	5656	0.31446570896769
GO:0000981	RNA polymerase II transcription factor activity, sequence-specific DNA binding	 59	0.106241846767523	1	12	47	899	5631	1.47105992669631
GO:0000982	transcription factor activity, RNA polymerase II core promoter proximal region sequence-specific binding	 10	0.774429434347452	1	1	9	910	5669	0.723271130625686
GO:0000987	core promoter proximal region sequence-specific DNA binding	  5	0.143519565197953	1	2	3	909	5675	2.89308452250274
GO:0000989	transcription factor activity, transcription factor binding	  6	0.590648335429865	1	1	5	910	5673	1.20545188437614
GO:0000993	RNA polymerase II core binding	 15	0.344361377150163	1	3	12	908	5666	1.44654226125137
GO:0001046	core promoter sequence-specific DNA binding	 23	0.0310679003179152	1	7	16	904	5662	2.20125996277383
GO:0001047	core promoter binding	 31	0.0550643993939009	1	8	23	903	5655	1.86650614355016
GO:0001054	RNA polymerase I activity	  5	0.524912504930412	1	1	4	910	5674	1.44654226125137
GO:0001056	RNA polymerase III activity	  9	0.359581374002193	1	2	7	909	5671	1.60726917916819
GO:0001075	transcription factor activity, RNA polymerase II core promoter sequence-specific binding involved in preinitiation complex assembly	  6	1	1	0	6	911	5672	0
GO:0001076	transcription factor activity, RNA polymerase II transcription factor binding	  6	0.590648335429865	1	1	5	910	5673	1.20545188437614
GO:0001077	transcriptional activator activity, RNA polymerase II core promoter proximal region sequence-specific binding	100	0.409240633434432	1	15	85	896	5593	1.08490669593853
GO:0001078	transcriptional repressor activity, RNA polymerase II core promoter proximal region sequence-specific binding	 58	0.169825964120468	1	11	47	900	5631	1.37172110980734
GO:0001085	RNA polymerase II transcription factor binding	 22	0.178553616091294	1	5	17	906	5661	1.64379802414929
GO:0001102	RNA polymerase II activating transcription factor binding	 18	0.733413953942175	1	2	16	909	5662	0.803634589584096
GO:0001103	RNA polymerase II repressing transcription factor binding	 12	0.0719932411872323	1	4	8	907	5670	2.41090376875229
GO:0001104	RNA polymerase II transcription cofactor activity	 14	0.875749379780082	1	1	13	910	5665	0.516622236161204
GO:0001105	RNA polymerase II transcription coactivator activity	 12	0.832578307772574	1	1	11	910	5667	0.602725942188072
GO:0001106	RNA polymerase II transcription corepressor activity	 12	1	1	0	12	911	5666	0
GO:0001158	enhancer sequence-specific DNA binding	  9	0.116572893917459	1	3	6	908	5672	2.41090376875229
GO:0001190	transcriptional activator activity, RNA polymerase II transcription factor binding	  8	1	1	0	8	911	5670	0
GO:0001191	transcriptional repressor activity, RNA polymerase II transcription factor binding	  7	0.250755247393959	1	2	5	909	5673	2.06648894464482
GO:0001205	transcriptional activator activity, RNA polymerase II distal enhancer sequence-specific binding	  5	1	1	0	5	911	5673	0
GO:0001223	transcription coactivator binding	  7	0.00897649165613564	0.780954774083801	4	3	907	5675	4.13297788928963
GO:0001227	transcriptional repressor activity, RNA polymerase II transcription regulatory region sequence-specific binding	 22	0.178553616091294	1	5	17	906	5661	1.64379802414929
GO:0001228	transcriptional activator activity, RNA polymerase II transcription regulatory region sequence-specific binding	 45	0.00218524505381573	0.462768071049249	14	31	897	5647	2.25017685083547
GO:0001501	skeletal system development	 58	0.0960792281176116	1	12	46	899	5632	1.49642302888073
GO:0001502	cartilage condensation	  6	0.19623335243315	1	2	4	909	5674	2.41090376875229
GO:0001503	ossification	 46	0.781742189874247	1	5	41	906	5637	0.786164272419224
GO:0001504	neurotransmitter uptake	  5	0.524912504930412	1	1	4	910	5674	1.44654226125137
GO:0001508	action potential	  8	1	1	0	8	911	5670	0
GO:0001510	RNA methylation	  5	0.143519565197953	1	2	3	909	5675	2.89308452250274
GO:0001516	prostaglandin biosynthetic process	  8	1	1	0	8	911	5670	0
GO:0001518	voltage-gated sodium channel complex	  8	1	1	0	8	911	5670	0
GO:0001523	retinoid metabolic process	 21	1	1	0	21	911	5657	0
GO:0001530	lipopolysaccharide binding	 10	0.774429434347452	1	1	9	910	5669	0.723271130625686
GO:0001533	cornified envelope	  7	0.647297183435849	1	1	6	910	5672	1.03324447232241
GO:0001540	amyloid-beta binding	 32	0.459558348788714	1	5	27	906	5651	1.13011114160263
GO:0001541	ovarian follicle development	 15	0.142496215955173	1	4	11	907	5667	1.92872301500183
GO:0001558	regulation of cell growth	 36	0.968369547384302	1	2	34	909	5644	0.401817294792048
GO:0001568	blood vessel development	 29	0.785423643074026	1	3	26	908	5652	0.748211514440365
GO:0001569	branching involved in blood vessel morphogenesis	 14	0.875749379780082	1	1	13	910	5665	0.516622236161204
GO:0001570	vasculogenesis	 30	0.988606390525596	1	1	29	910	5649	0.241090376875229
GO:0001578	microtubule bundle formation	 13	0.554297337812073	1	2	11	909	5667	1.11272481634721
GO:0001618	virus receptor activity	 34	0.993736379257875	1	1	33	910	5645	0.212726803125202
GO:0001649	osteoblast differentiation	 43	0.557432876463993	1	6	37	905	5641	1.00921553110561
GO:0001650	fibrillar center	 54	0.475622888878546	1	8	46	903	5632	1.07151278611213
GO:0001654	eye development	 16	0.170377804997621	1	4	12	907	5666	1.80817782656422
GO:0001656	metanephros development	 12	0.509611316519668	1	2	10	909	5668	1.20545188437614
GO:0001657	ureteric bud development	 23	0.634832927753238	1	3	20	908	5658	0.943397126903069
GO:0001658	branching involved in ureteric bud morphogenesis	 18	0.462686108033741	1	3	15	908	5663	1.20545188437614
GO:0001659	temperature homeostasis	  9	0.738180574705634	1	1	8	910	5670	0.803634589584096
GO:0001662	behavioral fear response	 23	0.967568791201491	1	1	22	910	5656	0.31446570896769
GO:0001664	G-protein coupled receptor binding	 20	0.949242054403644	1	1	19	910	5659	0.361635565312843
GO:0001666	response to hypoxia	 88	0.0927796992084153	1	17	71	894	5607	1.39722832052689
GO:0001669	acrosomal vesicle	 18	1	1	0	18	911	5660	0
GO:0001671	ATPase activator activity	 18	0.462686108033741	1	3	15	908	5663	1.20545188437614
GO:0001673	male germ cell nucleus	  6	0.590648335429865	1	1	5	910	5673	1.20545188437614
GO:0001675	acrosome assembly	  7	0.647297183435849	1	1	6	910	5672	1.03324447232241
GO:0001676	long-chain fatty acid metabolic process	  7	0.250755247393959	1	2	5	909	5673	2.06648894464482
GO:0001678	cellular glucose homeostasis	  9	0.116572893917459	1	3	6	908	5672	2.41090376875229
GO:0001682	tRNA 5	  6	1	1	0	6	911	5672	0
GO:0001701	in utero embryonic development	 93	0.648181651347489	1	12	81	899	5597	0.933253071775079
GO:0001702	gastrulation with mouth forming second	  7	0.250755247393959	1	2	5	909	5673	2.06648894464482
GO:0001706	endoderm formation	  6	0.590648335429865	1	1	5	910	5673	1.20545188437614
GO:0001707	mesoderm formation	 12	0.509611316519668	1	2	10	909	5668	1.20545188437614
GO:0001708	cell fate specification	  6	0.590648335429865	1	1	5	910	5673	1.20545188437614
GO:0001709	cell fate determination	  8	1	1	0	8	911	5670	0
GO:0001725	stress fiber	 20	0.536209630921365	1	3	17	908	5661	1.08490669593853
GO:0001726	ruffle	 52	0.591729487674911	1	7	45	904	5633	0.973634214303808
GO:0001731	formation of translation preinitiation complex	  7	0.647297183435849	1	1	6	910	5672	1.03324447232241
GO:0001736	establishment of planar polarity	  9	1	1	0	9	911	5669	0
GO:0001750	photoreceptor outer segment	 26	0.979283024427103	1	1	25	910	5653	0.278181204086802
GO:0001755	neural crest cell migration	 10	1	1	0	10	911	5668	0
GO:0001756	somitogenesis	 23	0.395750956840956	1	4	19	907	5659	1.25786283587076
GO:0001764	neuron migration	 54	0.0615407811381527	1	12	42	899	5636	1.60726917916819
GO:0001771	immunological synapse formation	  5	1	1	0	5	911	5673	0
GO:0001772	immunological synapse	 16	0.907797453739348	1	1	15	910	5663	0.452044456641054
GO:0001774	microglial cell activation	  9	0.738180574705634	1	1	8	910	5670	0.803634589584096
GO:0001775	cell activation	  7	1	1	0	7	911	5671	0
GO:0001779	natural killer cell differentiation	  5	1	1	0	5	911	5673	0
GO:0001782	B cell homeostasis	 12	0.509611316519668	1	2	10	909	5668	1.20545188437614
GO:0001784	phosphotyrosine residue binding	 20	0.949242054403644	1	1	19	910	5659	0.361635565312843
GO:0001786	phosphatidylserine binding	 19	0.941070913135173	1	1	18	910	5660	0.380669016118782
GO:0001816	cytokine production	  9	0.116572893917459	1	3	6	908	5672	2.41090376875229
GO:0001817	regulation of cytokine production	  5	1	1	0	5	911	5673	0
GO:0001818	negative regulation of cytokine production	  5	1	1	0	5	911	5673	0
GO:0001819	positive regulation of cytokine production	  7	0.647297183435849	1	1	6	910	5672	1.03324447232241
GO:0001822	kidney development	 51	0.852437567431259	1	5	46	906	5632	0.709089343750673
GO:0001824	blastocyst development	  5	1	1	0	5	911	5673	0
GO:0001825	blastocyst formation	  8	1	1	0	8	911	5670	0
GO:0001829	trophectodermal cell differentiation	  6	1	1	0	6	911	5672	0
GO:0001836	release of cytochrome c from mitochondria	 13	0.263838199411443	1	3	10	908	5668	1.66908722452081
GO:0001837	epithelial to mesenchymal transition	 14	0.116620999245796	1	4	10	907	5668	2.06648894464482
GO:0001841	neural tube formation	  8	0.696113996849696	1	1	7	910	5671	0.904088913282108
GO:0001843	neural tube closure	 41	0.837895515437052	1	4	37	907	5641	0.705630371342133
GO:0001886	endothelial cell morphogenesis	  6	1	1	0	6	911	5672	0
GO:0001889	liver development	 40	0.483207207096351	1	6	34	905	5644	1.08490669593853
GO:0001890	placenta development	 13	0.855768388602616	1	1	12	910	5666	0.556362408173605
GO:0001891	phagocytic cup	 11	1	1	0	11	911	5667	0
GO:0001892	embryonic placenta development	 11	0.805664391834832	1	1	10	910	5668	0.657519209659715
GO:0001893	maternal placenta development	  8	0.696113996849696	1	1	7	910	5671	0.904088913282108
GO:0001894	tissue homeostasis	  8	0.305579489538918	1	2	6	909	5672	1.80817782656422
GO:0001895	retina homeostasis	 12	1	1	0	12	911	5666	0
GO:0001917	photoreceptor inner segment	 11	0.462079859473656	1	2	9	909	5669	1.31503841931943
GO:0001921	positive regulation of receptor recycling	 10	0.150143518293906	1	3	7	908	5671	2.16981339187706
GO:0001931	uropod	  6	1	1	0	6	911	5672	0
GO:0001932	regulation of protein phosphorylation	 27	0.314618865714415	1	5	22	906	5656	1.33939098264016
GO:0001933	negative regulation of protein phosphorylation	 43	0.557432876463993	1	6	37	905	5641	1.00921553110561
GO:0001934	positive regulation of protein phosphorylation	 78	0.769313483747704	1	9	69	902	5609	0.834543612260407
GO:0001935	endothelial cell proliferation	  7	1	1	0	7	911	5671	0
GO:0001937	negative regulation of endothelial cell proliferation	 17	0.0742408303957595	1	5	12	906	5666	2.12726803125202
GO:0001938	positive regulation of endothelial cell proliferation	 29	0.0383860359042404	1	8	21	903	5657	1.99523070517431
GO:0001942	hair follicle development	 16	0.907797453739348	1	1	15	910	5663	0.452044456641054
GO:0001944	vasculature development	  9	0.738180574705634	1	1	8	910	5670	0.803634589584096
GO:0001945	lymph vessel development	  7	0.250755247393959	1	2	5	909	5673	2.06648894464482
GO:0001946	lymphangiogenesis	  7	1	1	0	7	911	5671	0
GO:0001947	heart looping	 23	0.847425382793578	1	2	21	909	5657	0.628931417935379
GO:0001952	regulation of cell-matrix adhesion	  6	0.590648335429865	1	1	5	910	5673	1.20545188437614
GO:0001953	negative regulation of cell-matrix adhesion	  7	0.647297183435849	1	1	6	910	5672	1.03324447232241
GO:0001954	positive regulation of cell-matrix adhesion	  9	1	1	0	9	911	5669	0
GO:0001955	blood vessel maturation	  6	1	1	0	6	911	5672	0
GO:0001956	positive regulation of neurotransmitter secretion	  5	0.524912504930412	1	1	4	910	5674	1.44654226125137
GO:0001958	endochondral ossification	 11	0.186315240979503	1	3	8	908	5670	1.97255762897914
GO:0001963	synaptic transmission, dopaminergic	  6	0.590648335429865	1	1	5	910	5673	1.20545188437614
GO:0001964	startle response	  9	1	1	0	9	911	5669	0
GO:0001965	G-protein alpha-subunit binding	 10	1	1	0	10	911	5668	0
GO:0001967	suckling behavior	  8	0.696113996849696	1	1	7	910	5671	0.904088913282108
GO:0001968	fibronectin binding	 12	0.832578307772574	1	1	11	910	5667	0.602725942188072
GO:0001972	retinoic acid binding	  5	0.524912504930412	1	1	4	910	5674	1.44654226125137
GO:0001973	adenosine receptor signaling pathway	  5	0.524912504930412	1	1	4	910	5674	1.44654226125137
GO:0001974	blood vessel remodeling	 17	0.424058507911188	1	3	14	908	5664	1.27636081875121
GO:0001975	response to amphetamine	 13	0.855768388602616	1	1	12	910	5666	0.556362408173605
GO:0002009	morphogenesis of an epithelium	  5	0.524912504930412	1	1	4	910	5674	1.44654226125137
GO:0002020	protease binding	 38	0.975434512664677	1	2	36	909	5642	0.380669016118782
GO:0002021	response to dietary excess	  6	0.590648335429865	1	1	5	910	5673	1.20545188437614
GO:0002024	diet induced thermogenesis	  5	1	1	0	5	911	5673	0
GO:0002026	regulation of the force of heart contraction	 10	1	1	0	10	911	5668	0
GO:0002027	regulation of heart rate	  8	1	1	0	8	911	5670	0
GO:0002028	regulation of sodium ion transport	 13	0.855768388602616	1	1	12	910	5666	0.556362408173605
GO:0002031	G-protein coupled receptor internalization	  5	1	1	0	5	911	5673	0
GO:0002039	p53 binding	 32	0.276018041431093	1	6	26	905	5652	1.35613336992316
GO:0002040	sprouting angiogenesis	 10	0.774429434347452	1	1	9	910	5669	0.723271130625686
GO:0002042	cell migration involved in sprouting angiogenesis	 10	1	1	0	10	911	5668	0
GO:0002052	positive regulation of neuroblast proliferation	  7	1	1	0	7	911	5671	0
GO:0002053	positive regulation of mesenchymal cell proliferation	 15	0.142496215955173	1	4	11	907	5667	1.92872301500183
GO:0002062	chondrocyte differentiation	 16	0.384511432262289	1	3	13	908	5665	1.35613336992316
GO:0002063	chondrocyte development	  8	0.0862825209590832	1	3	5	908	5673	2.71226673984632
GO:0002076	osteoblast development	  5	1	1	0	5	911	5673	0
GO:0002080	acrosomal membrane	  7	1	1	0	7	911	5671	0
GO:0002087	regulation of respiratory gaseous exchange by neurological system process	  5	0.524912504930412	1	1	4	910	5674	1.44654226125137
GO:0002088	lens development in camera-type eye	 11	0.462079859473656	1	2	9	909	5669	1.31503841931943
GO:0002089	lens morphogenesis in camera-type eye	  9	0.738180574705634	1	1	8	910	5670	0.803634589584096
GO:0002092	positive regulation of receptor internalization	 12	0.832578307772574	1	1	11	910	5667	0.602725942188072
GO:0002102	podosome	 13	0.554297337812073	1	2	11	909	5667	1.11272481634721
GO:0002161	aminoacyl-tRNA editing activity	  8	0.305579489538918	1	2	6	909	5672	1.80817782656422
GO:0002218	activation of innate immune response	  6	1	1	0	6	911	5672	0
GO:0002223	stimulatory C-type lectin receptor signaling pathway	 43	0.383808864829202	1	7	36	904	5642	1.17741811962321
GO:0002224	toll-like receptor signaling pathway	 18	0.931586037139791	1	1	17	910	5661	0.401817294792048
GO:0002227	innate immune response in mucosa	  5	1	1	0	5	911	5673	0
GO:0002230	positive regulation of defense response to virus by host	  6	1	1	0	6	911	5672	0
GO:0002237	response to molecule of bacterial origin	  7	1	1	0	7	911	5671	0
GO:0002244	hematopoietic progenitor cell differentiation	 26	0.979283024427103	1	1	25	910	5653	0.278181204086802
GO:0002250	adaptive immune response	 37	0.996002059837029	1	1	36	910	5642	0.195478683952888
GO:0002260	lymphocyte homeostasis	  5	0.524912504930412	1	1	4	910	5674	1.44654226125137
GO:0002281	macrophage activation involved in immune response	  6	1	1	0	6	911	5672	0
GO:0002315	marginal zone B cell differentiation	  5	1	1	0	5	911	5673	0
GO:0002377	immunoglobulin production	  5	1	1	0	5	911	5673	0
GO:0002437	inflammatory response to antigenic stimulus	  5	1	1	0	5	911	5673	0
GO:0002474	antigen processing and presentation of peptide antigen via MHC class I	 14	0.875749379780082	1	1	13	910	5665	0.516622236161204
GO:0002479	antigen processing and presentation of exogenous peptide antigen via MHC class I, TAP-dependent	 32	0.947938852250402	1	2	30	909	5648	0.452044456641054
GO:0002504	antigen processing and presentation of peptide or polysaccharide antigen via MHC class II	  8	0.696113996849696	1	1	7	910	5671	0.904088913282108
GO:0002523	leukocyte migration involved in inflammatory response	  9	1	1	0	9	911	5669	0
GO:0002526	acute inflammatory response	  6	1	1	0	6	911	5672	0
GO:0002548	monocyte chemotaxis	  9	0.738180574705634	1	1	8	910	5670	0.803634589584096
GO:0002576	platelet degranulation	 59	0.925446531077864	1	5	54	906	5624	0.612941636123463
GO:0002675	positive regulation of acute inflammatory response	  6	1	1	0	6	911	5672	0
GO:0002687	positive regulation of leukocyte migration	  5	1	1	0	5	911	5673	0
GO:0002690	positive regulation of leukocyte chemotaxis	  5	0.524912504930412	1	1	4	910	5674	1.44654226125137
GO:0002755	MyD88-dependent toll-like receptor signaling pathway	 13	0.554297337812073	1	2	11	909	5667	1.11272481634721
GO:0002931	response to ischemia	 18	0.462686108033741	1	3	15	908	5663	1.20545188437614
GO:0003007	heart morphogenesis	 23	0.203944604492174	1	5	18	906	5660	1.57232854483845
GO:0003009	skeletal muscle contraction	  6	1	1	0	6	911	5672	0
GO:0003014	renal system process	  7	1	1	0	7	911	5671	0
GO:0003091	renal water homeostasis	 16	0.670477249908291	1	2	14	909	5664	0.904088913282108
GO:0003148	outflow tract septum morphogenesis	  9	0.738180574705634	1	1	8	910	5670	0.803634589584096
GO:0003149	membranous septum morphogenesis	  5	1	1	0	5	911	5673	0
GO:0003151	outflow tract morphogenesis	 21	0.808458104218592	1	2	19	909	5659	0.688829648214939
GO:0003158	endothelium development	  5	1	1	0	5	911	5673	0
GO:0003181	atrioventricular valve morphogenesis	  6	1	1	0	6	911	5672	0
GO:0003183	mitral valve morphogenesis	  5	1	1	0	5	911	5673	0
GO:0003184	pulmonary valve morphogenesis	  5	1	1	0	5	911	5673	0
GO:0003197	endocardial cushion development	  6	1	1	0	6	911	5672	0
GO:0003198	epithelial to mesenchymal transition involved in endocardial cushion formation	  5	0.524912504930412	1	1	4	910	5674	1.44654226125137
GO:0003203	endocardial cushion morphogenesis	  7	0.647297183435849	1	1	6	910	5672	1.03324447232241
GO:0003214	cardiac left ventricle morphogenesis	  5	1	1	0	5	911	5673	0
GO:0003222	ventricular trabecula myocardium morphogenesis	  8	1	1	0	8	911	5670	0
GO:0003279	cardiac septum development	  5	0.143519565197953	1	2	3	909	5675	2.89308452250274
GO:0003281	ventricular septum development	 12	0.509611316519668	1	2	10	909	5668	1.20545188437614
GO:0003323	type B pancreatic cell development	  5	1	1	0	5	911	5673	0
GO:0003333	amino acid transmembrane transport	 16	0.907797453739348	1	1	15	910	5663	0.452044456641054
GO:0003334	keratinocyte development	  7	1	1	0	7	911	5671	0
GO:0003341	cilium movement	  7	1	1	0	7	911	5671	0
GO:0003351	epithelial cilium movement	  6	1	1	0	6	911	5672	0
GO:0003374	dynamin family protein polymerization involved in mitochondrial fission	  6	0.0380919907275585	1	3	3	908	5675	3.61635565312843
GO:0003376	sphingosine-1-phosphate signaling pathway	  5	1	1	0	5	911	5673	0
GO:0003407	neural retina development	  9	1	1	0	9	911	5669	0
GO:0003680	AT DNA binding	  5	0.524912504930412	1	1	4	910	5674	1.44654226125137
GO:0003684	damaged DNA binding	 26	0.285970151784858	1	5	21	906	5657	1.39090602043401
GO:0003688	DNA replication origin binding	  7	1	1	0	7	911	5671	0
GO:0003689	DNA clamp loader activity	  5	0.143519565197953	1	2	3	909	5675	2.89308452250274
GO:0003690	double-stranded DNA binding	 56	0.368291090674188	1	9	47	902	5631	1.16240003136271
GO:0003697	single-stranded DNA binding	 34	0.711034261448715	1	4	30	907	5648	0.850907212500807
GO:0003705	transcription factor activity, RNA polymerase II distal enhancer sequence-specific binding	 27	0.74203057279193	1	3	24	908	5654	0.803634589584096
GO:0003707	steroid hormone receptor activity	 19	0.500137274055772	1	3	16	908	5662	1.14200704835635
GO:0003712	transcription cofactor activity	 30	0.110293770889616	1	7	23	904	5655	1.6876326381266
GO:0003714	transcription corepressor activity	 83	0.251537340432797	1	14	69	897	5609	1.21997540105537
GO:0003724	RNA helicase activity	  7	1	1	0	7	911	5671	0
GO:0003725	double-stranded RNA binding	 39	0.642804817441497	1	5	34	906	5644	0.927270680289341
GO:0003727	single-stranded RNA binding	 26	0.493270603294985	1	4	22	907	5656	1.11272481634721
GO:0003729	mRNA binding	 70	0.0957152121856822	1	14	56	897	5622	1.44654226125137
GO:0003730	mRNA 3	 30	0.804750698218897	1	3	27	908	5651	0.723271130625686
GO:0003735	structural constituent of ribosome	 26	0.892479153310945	1	2	24	909	5654	0.556362408173605
GO:0003743	translation initiation factor activity	 25	0.975944413999558	1	1	24	910	5654	0.289308452250274
GO:0003746	translation elongation factor activity	 10	0.411940837929264	1	2	8	909	5670	1.44654226125137
GO:0003755	peptidyl-prolyl cis-trans isomerase activity	 18	1	1	0	18	911	5660	0
GO:0003756	protein disulfide isomerase activity	 11	0.805664391834832	1	1	10	910	5668	0.657519209659715
GO:0003774	motor activity	 45	0.7648451974473	1	5	40	906	5638	0.803634589584096
GO:0003777	microtubule motor activity	 34	0.993736379257875	1	1	33	910	5645	0.212726803125202
GO:0003785	actin monomer binding	 10	0.774429434347452	1	1	9	910	5669	0.723271130625686
GO:0003841	1-acylglycerol-3-phosphate O-acyltransferase activity	  8	0.696113996849696	1	1	7	910	5671	0.904088913282108
GO:0003887	DNA-directed DNA polymerase activity	  8	1	1	0	8	911	5670	0
GO:0003899	DNA-directed 5	 16	0.384511432262289	1	3	13	908	5665	1.35613336992316
GO:0003950	NAD+ ADP-ribosyltransferase activity	  9	1	1	0	9	911	5669	0
GO:0003951	NAD+ kinase activity	  9	0.359581374002193	1	2	7	909	5671	1.60726917916819
GO:0003993	acid phosphatase activity	  7	0.250755247393959	1	2	5	909	5673	2.06648894464482
GO:0003995	acyl-CoA dehydrogenase activity	  5	0.524912504930412	1	1	4	910	5674	1.44654226125137
GO:0004003	ATP-dependent DNA helicase activity	 10	0.774429434347452	1	1	9	910	5669	0.723271130625686
GO:0004004	ATP-dependent RNA helicase activity	 24	0.864076388223246	1	2	22	909	5656	0.602725942188072
GO:0004012	phospholipid-translocating ATPase activity	  8	1	1	0	8	911	5670	0
GO:0004016	adenylate cyclase activity	  6	1	1	0	6	911	5672	0
GO:0004029	aldehyde dehydrogenase (NAD) activity	  6	0.590648335429865	1	1	5	910	5673	1.20545188437614
GO:0004033	aldo-keto reductase (NADP) activity	  5	0.524912504930412	1	1	4	910	5674	1.44654226125137
GO:0004064	arylesterase activity	  5	1	1	0	5	911	5673	0
GO:0004089	carbonate dehydratase activity	  6	0.590648335429865	1	1	5	910	5673	1.20545188437614
GO:0004112	cyclic-nucleotide phosphodiesterase activity	  5	1	1	0	5	911	5673	0
GO:0004114	3	 14	0.596015503295557	1	2	12	909	5666	1.03324447232241
GO:0004115	3	 11	0.805664391834832	1	1	10	910	5668	0.657519209659715
GO:0004129	cytochrome-c oxidase activity	  9	0.116572893917459	1	3	6	908	5672	2.41090376875229
GO:0004143	diacylglycerol kinase activity	  7	0.250755247393959	1	2	5	909	5673	2.06648894464482
GO:0004175	endopeptidase activity	 29	0.203691418531707	1	6	23	905	5655	1.49642302888073
GO:0004177	aminopeptidase activity	 10	0.411940837929264	1	2	8	909	5670	1.44654226125137
GO:0004180	carboxypeptidase activity	 11	1	1	0	11	911	5667	0
GO:0004181	metallocarboxypeptidase activity	  5	1	1	0	5	911	5673	0
GO:0004185	serine-type carboxypeptidase activity	  6	1	1	0	6	911	5672	0
GO:0004190	aspartic-type endopeptidase activity	  9	0.738180574705634	1	1	8	910	5670	0.803634589584096
GO:0004197	cysteine-type endopeptidase activity	 29	0.785423643074026	1	3	26	908	5652	0.748211514440365
GO:0004222	metalloendopeptidase activity	 34	0.711034261448715	1	4	30	907	5648	0.850907212500807
GO:0004252	serine-type endopeptidase activity	 44	0.746976250002897	1	5	39	906	5639	0.821899012074643
GO:0004298	threonine-type endopeptidase activity	  6	0.19623335243315	1	2	4	909	5674	2.41090376875229
GO:0004364	glutathione transferase activity	 11	0.0536855911323149	1	4	7	907	5671	2.63007683863886
GO:0004383	guanylate cyclase activity	  8	1	1	0	8	911	5670	0
GO:0004385	guanylate kinase activity	  8	1	1	0	8	911	5670	0
GO:0004386	helicase activity	 51	0.852437567431259	1	5	46	906	5632	0.709089343750673
GO:0004402	histone acetyltransferase activity	 19	0.500137274055772	1	3	16	908	5662	1.14200704835635
GO:0004407	histone deacetylase activity	 17	0.920576476962146	1	1	16	910	5662	0.425453606250404
GO:0004435	phosphatidylinositol phospholipase C activity	 12	0.832578307772574	1	1	11	910	5667	0.602725942188072
GO:0004438	phosphatidylinositol-3-phosphatase activity	  9	0.738180574705634	1	1	8	910	5670	0.803634589584096
GO:0004497	monooxygenase activity	 24	0.664264323067229	1	3	21	908	5657	0.904088913282107
GO:0004518	nuclease activity	 45	0.604024670447671	1	6	39	905	5639	0.964361507500915
GO:0004519	endonuclease activity	 26	0.285970151784858	1	5	21	906	5657	1.39090602043401
GO:0004521	endoribonuclease activity	  5	0.524912504930412	1	1	4	910	5674	1.44654226125137
GO:0004526	ribonuclease P activity	  5	1	1	0	5	911	5673	0
GO:0004527	exonuclease activity	 23	0.847425382793578	1	2	21	909	5657	0.628931417935379
GO:0004535	poly(A)-specific ribonuclease activity	  6	1	1	0	6	911	5672	0
GO:0004540	ribonuclease activity	 12	0.509611316519668	1	2	10	909	5668	1.20545188437614
GO:0004550	nucleoside diphosphate kinase activity	  8	0.696113996849696	1	1	7	910	5671	0.904088913282108
GO:0004553	hydrolase activity, hydrolyzing O-glycosyl compounds	  6	1	1	0	6	911	5672	0
GO:0004571	mannosyl-oligosaccharide 1,2-alpha-mannosidase activity	  5	1	1	0	5	911	5673	0
GO:0004579	dolichyl-diphosphooligosaccharide-protein glycotransferase activity	  5	1	1	0	5	911	5673	0
GO:0004596	peptide alpha-N-acetyltransferase activity	  6	1	1	0	6	911	5672	0
GO:0004601	peroxidase activity	 13	0.263838199411443	1	3	10	908	5668	1.66908722452081
GO:0004602	glutathione peroxidase activity	  6	0.19623335243315	1	2	4	909	5674	2.41090376875229
GO:0004620	phospholipase activity	  8	1	1	0	8	911	5670	0
GO:0004622	lysophospholipase activity	 11	1	1	0	11	911	5667	0
GO:0004623	phospholipase A2 activity	 10	0.411940837929264	1	2	8	909	5670	1.44654226125137
GO:0004629	phospholipase C activity	  6	0.590648335429865	1	1	5	910	5673	1.20545188437614
GO:0004630	phospholipase D activity	  5	1	1	0	5	911	5673	0
GO:0004653	polypeptide N-acetylgalactosaminyltransferase activity	  8	0.696113996849696	1	1	7	910	5671	0.904088913282108
GO:0004675	transmembrane receptor protein serine/threonine kinase activity	  8	0.696113996849696	1	1	7	910	5671	0.904088913282108
GO:0004683	calmodulin-dependent protein kinase activity	 17	0.703333082174572	1	2	15	909	5663	0.850907212500807
GO:0004693	cyclin-dependent protein serine/threonine kinase activity	 12	0.0719932411872323	1	4	8	907	5670	2.41090376875229
GO:0004697	protein kinase C activity	 10	0.774429434347452	1	1	9	910	5669	0.723271130625686
GO:0004702	signal transducer, downstream of receptor, with serine/threonine kinase activity	 11	0.805664391834832	1	1	10	910	5668	0.657519209659715
GO:0004707	MAP kinase activity	  9	0.359581374002193	1	2	7	909	5671	1.60726917916819
GO:0004708	MAP kinase kinase activity	  8	1	1	0	8	911	5670	0
GO:0004709	MAP kinase kinase kinase activity	 12	0.224422574243593	1	3	9	908	5669	1.80817782656421
GO:0004712	protein serine/threonine/tyrosine kinase activity	 13	0.855768388602616	1	1	12	910	5666	0.556362408173605
GO:0004713	protein tyrosine kinase activity	 66	0.825752652269511	1	7	59	904	5619	0.767105744603
GO:0004714	transmembrane receptor protein tyrosine kinase activity	 26	0.285970151784858	1	5	21	906	5657	1.39090602043401
GO:0004715	non-membrane spanning protein tyrosine kinase activity	 17	0.920576476962146	1	1	16	910	5662	0.425453606250404
GO:0004716	signal transducer, downstream of receptor, with protein tyrosine kinase activity	  8	0.696113996849696	1	1	7	910	5671	0.904088913282108
GO:0004721	phosphoprotein phosphatase activity	 69	0.149737440550686	1	13	56	898	5622	1.36268473885999
GO:0004722	protein serine/threonine phosphatase activity	 25	0.461378226139581	1	4	21	907	5657	1.1572338090011
GO:0004725	protein tyrosine phosphatase activity	 50	0.247982927656921	1	9	41	902	5637	1.30188803512623
GO:0004726	non-membrane spanning protein tyrosine phosphatase activity	  7	0.647297183435849	1	1	6	910	5672	1.03324447232241
GO:0004745	retinol dehydrogenase activity	  6	1	1	0	6	911	5672	0
GO:0004812	aminoacyl-tRNA ligase activity	 19	0.500137274055772	1	3	16	908	5662	1.14200704835635
GO:0004843	thiol-dependent ubiquitin-specific protease activity	 45	0.431767890331025	1	7	38	904	5640	1.12508842541773
GO:0004857	enzyme inhibitor activity	 19	0.941070913135173	1	1	18	910	5660	0.380669016118782
GO:0004859	phospholipase inhibitor activity	  6	1	1	0	6	911	5672	0
GO:0004860	protein kinase inhibitor activity	 29	0.58353593328048	1	4	25	907	5653	0.997615352587153
GO:0004861	cyclin-dependent protein serine/threonine kinase inhibitor activity	  5	1	1	0	5	911	5673	0
GO:0004862	cAMP-dependent protein kinase inhibitor activity	  8	0.696113996849696	1	1	7	910	5671	0.904088913282108
GO:0004864	protein phosphatase inhibitor activity	 17	0.920576476962146	1	1	16	910	5662	0.425453606250404
GO:0004865	protein serine/threonine phosphatase inhibitor activity	  5	1	1	0	5	911	5673	0
GO:0004866	endopeptidase inhibitor activity	 17	1	1	0	17	911	5661	0
GO:0004867	serine-type endopeptidase inhibitor activity	 28	0.984635614894456	1	1	27	910	5651	0.258311118080602
GO:0004869	cysteine-type endopeptidase inhibitor activity	  7	1	1	0	7	911	5671	0
GO:0004872	receptor activity	 92	0.978135549017352	1	7	85	904	5593	0.550314990693457
GO:0004879	RNA polymerase II transcription factor activity, ligand-activated sequence-specific DNA binding	 11	0.186315240979503	1	3	8	908	5670	1.97255762897914
GO:0004888	transmembrane signaling receptor activity	 49	0.922244556495863	1	4	45	907	5633	0.590425412755662
GO:0004890	GABA-A receptor activity	 11	1	1	0	11	911	5667	0
GO:0004896	cytokine receptor activity	 16	0.907797453739348	1	1	15	910	5663	0.452044456641054
GO:0004970	ionotropic glutamate receptor activity	  8	1	1	0	8	911	5670	0
GO:0005001	transmembrane receptor protein tyrosine phosphatase activity	 10	0.774429434347452	1	1	9	910	5669	0.723271130625686
GO:0005003	ephrin receptor activity	  5	1	1	0	5	911	5673	0
GO:0005031	tumor necrosis factor-activated receptor activity	  8	1	1	0	8	911	5670	0
GO:0005041	low-density lipoprotein receptor activity	 10	1	1	0	10	911	5668	0
GO:0005044	scavenger receptor activity	 13	1	1	0	13	911	5665	0
GO:0005049	nuclear export signal receptor activity	  6	0.0380919907275585	1	3	3	908	5675	3.61635565312843
GO:0005057	signal transducer activity, downstream of receptor	 22	0.603648322851636	1	3	19	908	5659	0.986278814489572
GO:0005068	transmembrane receptor protein tyrosine kinase adaptor activity	  7	0.647297183435849	1	1	6	910	5672	1.03324447232241
GO:0005070	SH3/SH2 adaptor activity	 27	0.904515039752466	1	2	25	909	5653	0.535756393056064
GO:0005078	MAP-kinase scaffold activity	  5	0.524912504930412	1	1	4	910	5674	1.44654226125137
GO:0005080	protein kinase C binding	 18	1	1	0	18	911	5660	0
GO:0005085	guanyl-nucleotide exchange factor activity	 87	0.781345957846817	1	10	77	901	5601	0.831346127155961
GO:0005086	ARF guanyl-nucleotide exchange factor activity	 12	0.832578307772574	1	1	11	910	5667	0.602725942188072
GO:0005088	Ras guanyl-nucleotide exchange factor activity	 54	0.633170008036815	1	7	47	904	5631	0.937573687848112
GO:0005089	Rho guanyl-nucleotide exchange factor activity	 38	0.790567849663914	1	4	34	907	5644	0.761338032237564
GO:0005092	GDP-dissociation inhibitor activity	 10	0.774429434347452	1	1	9	910	5669	0.723271130625686
GO:0005095	GTPase inhibitor activity	  9	0.359581374002193	1	2	7	909	5671	1.60726917916819
GO:0005104	fibroblast growth factor receptor binding	  7	0.647297183435849	1	1	6	910	5672	1.03324447232241
GO:0005109	frizzled binding	  8	0.696113996849696	1	1	7	910	5671	0.904088913282108
GO:0005112	Notch binding	  8	1	1	0	8	911	5670	0
GO:0005114	type II transforming growth factor beta receptor binding	  7	0.647297183435849	1	1	6	910	5672	1.03324447232241
GO:0005123	death receptor binding	  6	0.590648335429865	1	1	5	910	5673	1.20545188437614
GO:0005125	cytokine activity	 47	0.797685888084228	1	5	42	906	5636	0.769437373006049
GO:0005138	interleukin-6 receptor binding	  5	0.524912504930412	1	1	4	910	5674	1.44654226125137
GO:0005154	epidermal growth factor receptor binding	 17	0.199958412567424	1	4	13	907	5665	1.70181442500161
GO:0005158	insulin receptor binding	 18	0.462686108033741	1	3	15	908	5663	1.20545188437614
GO:0005159	insulin-like growth factor receptor binding	 10	0.411940837929264	1	2	8	909	5670	1.44654226125137
GO:0005160	transforming growth factor beta receptor binding	 14	0.596015503295557	1	2	12	909	5666	1.03324447232241
GO:0005161	platelet-derived growth factor receptor binding	  7	1	1	0	7	911	5671	0
GO:0005164	tumor necrosis factor receptor binding	  5	0.524912504930412	1	1	4	910	5674	1.44654226125137
GO:0005178	integrin binding	 57	0.99980072984769	1	1	56	910	5622	0.126889672039594
GO:0005179	hormone activity	 22	0.603648322851636	1	3	19	908	5659	0.986278814489572
GO:0005184	neuropeptide hormone activity	  8	0.305579489538918	1	2	6	909	5672	1.80817782656422
GO:0005198	structural molecule activity	 63	0.658123960097974	1	8	55	903	5623	0.918439530953252
GO:0005200	structural constituent of cytoskeleton	 52	0.864021887264913	1	5	47	906	5631	0.695453010217006
GO:0005201	extracellular matrix structural constituent	 25	0.879045586415537	1	2	23	909	5655	0.578616904500549
GO:0005215	transporter activity	 91	0.990707847820544	1	6	85	905	5593	0.476882064148804
GO:0005216	ion channel activity	 73	0.999768920250621	1	2	71	909	5607	0.198156474144024
GO:0005229	intracellular calcium activated chloride channel activity	  6	1	1	0	6	911	5672	0
GO:0005230	extracellular ligand-gated ion channel activity	 13	1	1	0	13	911	5665	0
GO:0005231	excitatory extracellular ligand-gated ion channel activity	  5	1	1	0	5	911	5673	0
GO:0005234	extracellular-glutamate-gated ion channel activity	  8	1	1	0	8	911	5670	0
GO:0005242	inward rectifier potassium channel activity	  9	1	1	0	9	911	5669	0
GO:0005244	voltage-gated ion channel activity	 68	0.923415564944884	1	6	62	905	5616	0.638180409375605
GO:0005245	voltage-gated calcium channel activity	 18	0.931586037139791	1	1	17	910	5661	0.401817294792048
GO:0005246	calcium channel regulator activity	 13	0.0930371570174248	1	4	9	907	5669	2.22544963269442
GO:0005248	voltage-gated sodium channel activity	 12	1	1	0	12	911	5666	0
GO:0005249	voltage-gated potassium channel activity	 25	0.975944413999558	1	1	24	910	5654	0.289308452250274
GO:0005251	delayed rectifier potassium channel activity	  7	1	1	0	7	911	5671	0
GO:0005254	chloride channel activity	 25	0.975944413999558	1	1	24	910	5654	0.289308452250274
GO:0005261	cation channel activity	 10	0.774429434347452	1	1	9	910	5669	0.723271130625686
GO:0005262	calcium channel activity	 39	0.289137274728175	1	7	32	904	5646	1.29817895240508
GO:0005267	potassium channel activity	 35	0.732772844643882	1	4	31	907	5647	0.826595577857927
GO:0005272	sodium channel activity	 12	1	1	0	12	911	5666	0
GO:0005313	L-glutamate transmembrane transporter activity	  9	1	1	0	9	911	5669	0
GO:0005314	high-affinity glutamate transmembrane transporter activity	  6	1	1	0	6	911	5672	0
GO:0005319	lipid transporter activity	  7	0.647297183435849	1	1	6	910	5672	1.03324447232241
GO:0005328	neurotransmitter:sodium symporter activity	  5	1	1	0	5	911	5673	0
GO:0005344	oxygen transporter activity	  5	1	1	0	5	911	5673	0
GO:0005351	sugar:proton symporter activity	  6	1	1	0	6	911	5672	0
GO:0005355	glucose transmembrane transporter activity	  8	0.696113996849696	1	1	7	910	5671	0.904088913282108
GO:0005385	zinc ion transmembrane transporter activity	 10	0.411940837929264	1	2	8	909	5670	1.44654226125137
GO:0005388	calcium-transporting ATPase activity	  9	0.738180574705634	1	1	8	910	5670	0.803634589584096
GO:0005391	sodium:potassium-exchanging ATPase activity	  6	1	1	0	6	911	5672	0
GO:0005432	calcium:sodium antiporter activity	  5	1	1	0	5	911	5673	0
GO:0005452	inorganic anion exchanger activity	  6	0.590648335429865	1	1	5	910	5673	1.20545188437614
GO:0005484	SNAP receptor activity	 23	0.203944604492174	1	5	18	906	5660	1.57232854483845
GO:0005487	nucleocytoplasmic transporter activity	 10	0.774429434347452	1	1	9	910	5669	0.723271130625686
GO:0005496	steroid binding	  8	0.696113996849696	1	1	7	910	5671	0.904088913282108
GO:0005504	fatty acid binding	  6	1	1	0	6	911	5672	0
GO:0005506	iron ion binding	 44	0.746976250002897	1	5	39	906	5639	0.821899012074643
GO:0005507	copper ion binding	 16	0.0160121031228009	1	6	10	905	5668	2.71226673984632
GO:0005513	detection of calcium ion	  5	1	1	0	5	911	5673	0
GO:0005518	collagen binding	 29	0.58353593328048	1	4	25	907	5653	0.997615352587153
GO:0005520	insulin-like growth factor binding	 12	0.832578307772574	1	1	11	910	5667	0.602725942188072
GO:0005521	lamin binding	  9	0.116572893917459	1	3	6	908	5672	2.41090376875229
GO:0005522	profilin binding	  6	0.590648335429865	1	1	5	910	5673	1.20545188437614
GO:0005523	tropomyosin binding	  8	0.0862825209590832	1	3	5	908	5673	2.71226673984632
GO:0005528	FK506 binding	  6	1	1	0	6	911	5672	0
GO:0005536	glucose binding	  5	1	1	0	5	911	5673	0
GO:0005537	mannose binding	  7	1	1	0	7	911	5671	0
GO:0005539	glycosaminoglycan binding	 13	0.0930371570174248	1	4	9	907	5669	2.22544963269442
GO:0005540	hyaluronic acid binding	 11	1	1	0	11	911	5667	0
GO:0005543	phospholipid binding	 37	0.594402919411983	1	5	32	906	5646	0.977393419764441
GO:0005544	calcium-dependent phospholipid binding	 26	0.717842783670638	1	3	23	908	5655	0.834543612260407
GO:0005545	1-phosphatidylinositol binding	  9	0.738180574705634	1	1	8	910	5670	0.803634589584096
GO:0005546	phosphatidylinositol-4,5-bisphosphate binding	 28	0.0815976834848162	1	7	21	904	5657	1.80817782656421
GO:0005547	phosphatidylinositol-3,4,5-trisphosphate binding	 17	0.424058507911188	1	3	14	908	5664	1.27636081875121
GO:0005581	collagen trimer	 34	0.959368019848383	1	2	32	909	5646	0.425453606250404
GO:0005604	basement membrane	 38	0.975434512664677	1	2	36	909	5642	0.380669016118782
GO:0005605	basal lamina	  9	0.738180574705634	1	1	8	910	5670	0.803634589584096
GO:0005614	interstitial matrix	  5	1	1	0	5	911	5673	0
GO:0005623	cell	 37	0.405559436943373	1	6	31	905	5647	1.17287210371733
GO:0005635	nuclear envelope	 81	0.0861346243917421	1	16	65	895	5613	1.42868371481617
GO:0005637	nuclear inner membrane	 16	0.0160121031228009	1	6	10	905	5668	2.71226673984632
GO:0005640	nuclear outer membrane	 13	0.0246444305692994	1	5	8	906	5670	2.78181204086802
GO:0005641	nuclear envelope lumen	  7	1	1	0	7	911	5671	0
GO:0005643	nuclear pore	 38	0.266290250849306	1	7	31	904	5647	1.33234155641574
GO:0005655	nucleolar ribonuclease P complex	  5	1	1	0	5	911	5673	0
GO:0005662	DNA replication factor A complex	  7	0.647297183435849	1	1	6	910	5672	1.03324447232241
GO:0005665	DNA-directed RNA polymerase II, core complex	  6	1	1	0	6	911	5672	0
GO:0005666	DNA-directed RNA polymerase III complex	 10	0.411940837929264	1	2	8	909	5670	1.44654226125137
GO:0005667	transcription factor complex	 74	0.447945326688375	1	11	63	900	5615	1.07513276174088
GO:0005669	transcription factor TFIID complex	 13	0.263838199411443	1	3	10	908	5668	1.66908722452081
GO:0005671	Ada2/Gcn5/Ada3 transcription activator complex	  5	1	1	0	5	911	5673	0
GO:0005675	holo TFIIH complex	  6	0.000265848371575281	0.177264945402662	5	1	906	5677	6.02725942188072
GO:0005680	anaphase-promoting complex	  8	0.696113996849696	1	1	7	910	5671	0.904088913282108
GO:0005681	spliceosomal complex	 55	0.0692654065942818	1	12	43	899	5635	1.57804610318332
GO:0005685	U1 snRNP	  9	0.359581374002193	1	2	7	909	5671	1.60726917916819
GO:0005686	U2 snRNP	  7	0.647297183435849	1	1	6	910	5672	1.03324447232241
GO:0005689	U12-type spliceosomal complex	  8	0.305579489538918	1	2	6	909	5672	1.80817782656422
GO:0005697	telomerase holoenzyme complex	 10	0.411940837929264	1	2	8	909	5670	1.44654226125137
GO:0005719	nuclear euchromatin	 13	0.263838199411443	1	3	10	908	5668	1.66908722452081
GO:0005720	nuclear heterochromatin	  7	0.0599286150311256	1	3	4	908	5674	3.09973341696723
GO:0005721	pericentric heterochromatin	  5	0.524912504930412	1	1	4	910	5674	1.44654226125137
GO:0005736	DNA-directed RNA polymerase I complex	  5	0.524912504930412	1	1	4	910	5674	1.44654226125137
GO:0005740	mitochondrial envelope	  7	1	1	0	7	911	5671	0
GO:0005741	mitochondrial outer membrane	 82	0.028910633972168	1	18	64	893	5614	1.5876683355198
GO:0005746	mitochondrial respiratory chain	  6	0.19623335243315	1	2	4	909	5674	2.41090376875229
GO:0005747	mitochondrial respiratory chain complex I	 12	0.0719932411872323	1	4	8	907	5670	2.41090376875229
GO:0005753	mitochondrial proton-transporting ATP synthase complex	 10	0.00689228204720671	0.768274064449573	5	5	906	5673	3.61635565312843
GO:0005758	mitochondrial intermembrane space	 22	0.362393330345516	1	4	18	907	5660	1.31503841931943
GO:0005761	mitochondrial ribosome	  8	0.696113996849696	1	1	7	910	5671	0.904088913282108
GO:0005762	mitochondrial large ribosomal subunit	 13	0.554297337812073	1	2	11	909	5667	1.11272481634721
GO:0005763	mitochondrial small ribosomal subunit	  6	1	1	0	6	911	5672	0
GO:0005770	late endosome	 70	0.93527872289249	1	6	64	905	5614	0.619946683393445
GO:0005771	multivesicular body	 13	0.554297337812073	1	2	11	909	5667	1.11272481634721
GO:0005773	vacuole	  9	0.359581374002193	1	2	7	909	5671	1.60726917916819
GO:0005774	vacuolar membrane	  6	1	1	0	6	911	5672	0
GO:0005776	autophagosome	 39	0.161846713117336	1	8	31	903	5647	1.48363308846295
GO:0005777	peroxisome	 55	0.65296736456532	1	7	48	904	5630	0.9205268935236
GO:0005778	peroxisomal membrane	 30	0.611480146770197	1	4	26	907	5652	0.964361507500915
GO:0005779	integral component of peroxisomal membrane	  5	1	1	0	5	911	5673	0
GO:0005782	peroxisomal matrix	 17	0.920576476962146	1	1	16	910	5662	0.425453606250404
GO:0005790	smooth endoplasmic reticulum	 16	0.670477249908291	1	2	14	909	5664	0.904088913282108
GO:0005791	rough endoplasmic reticulum	 27	0.524340470700302	1	4	23	907	5655	1.07151278611213
GO:0005793	endoplasmic reticulum-Golgi intermediate compartment	 35	0.542560241686169	1	5	30	906	5648	1.03324447232241
GO:0005795	Golgi stack	 15	0.634731522702541	1	2	13	909	5665	0.964361507500915
GO:0005796	Golgi lumen	 26	0.139727506940132	1	6	20	905	5658	1.66908722452081
GO:0005798	Golgi-associated vesicle	  7	1	1	0	7	911	5671	0
GO:0005801	cis-Golgi network	 26	0.717842783670638	1	3	23	908	5655	0.834543612260407
GO:0005802	trans-Golgi network	 71	0.527199163559451	1	10	61	901	5617	1.01869173327561
GO:0005811	lipid droplet	 32	0.663761033636311	1	4	28	907	5650	0.904088913282108
GO:0005814	centriole	 48	0.999230778926321	1	1	47	910	5631	0.150681485547018
GO:0005819	spindle	 72	0.00334658448318661	0.596863342576333	19	53	892	5625	1.90863215026223
GO:0005834	heterotrimeric G-protein complex	 19	0.941070913135173	1	1	18	910	5660	0.380669016118782
GO:0005838	proteasome regulatory particle	  6	0.590648335429865	1	1	5	910	5673	1.20545188437614
GO:0005839	proteasome core complex	  7	0.250755247393959	1	2	5	909	5673	2.06648894464482
GO:0005840	ribosome	 45	0.7648451974473	1	5	40	906	5638	0.803634589584096
GO:0005844	polysome	 19	0.262946555916241	1	4	15	907	5663	1.52267606447513
GO:0005845	mRNA cap binding complex	  7	1	1	0	7	911	5671	0
GO:0005852	eukaryotic translation initiation factor 3 complex	  9	0.359581374002193	1	2	7	909	5671	1.60726917916819
GO:0005868	cytoplasmic dynein complex	 16	0.384511432262289	1	3	13	908	5665	1.35613336992316
GO:0005871	kinesin complex	 23	0.634832927753238	1	3	20	908	5658	0.943397126903069
GO:0005875	microtubule associated complex	 19	0.941070913135173	1	1	18	910	5660	0.380669016118782
GO:0005876	spindle microtubule	 15	0.142496215955173	1	4	11	907	5667	1.92872301500183
GO:0005881	cytoplasmic microtubule	 20	0.131823772311556	1	5	15	906	5663	1.80817782656422
GO:0005882	intermediate filament	 21	0.328967927753839	1	4	17	907	5661	1.37765929642988
GO:0005883	neurofilament	  7	0.647297183435849	1	1	6	910	5672	1.03324447232241
GO:0005884	actin filament	 30	0.933483829552772	1	2	28	909	5650	0.482180753750457
GO:0005890	sodium:potassium-exchanging ATPase complex	  6	1	1	0	6	911	5672	0
GO:0005891	voltage-gated calcium channel complex	 13	0.855768388602616	1	1	12	910	5666	0.556362408173605
GO:0005901	caveola	 39	0.921150755893196	1	3	36	908	5642	0.556362408173605
GO:0005902	microvillus	 26	0.892479153310945	1	2	24	909	5654	0.556362408173605
GO:0005903	brush border	 23	0.634832927753238	1	3	20	908	5658	0.943397126903069
GO:0005905	clathrin-coated pit	 44	0.407812795554757	1	7	37	904	5641	1.1506586169045
GO:0005911	cell-cell junction	 76	0.995545352593467	1	4	72	907	5606	0.380669016118782
GO:0005912	adherens junction	 34	0.993736379257875	1	1	33	910	5645	0.212726803125202
GO:0005913	cell-cell adherens junction	 38	0.912404932620371	1	3	35	908	5643	0.571003524178173
GO:0005916	fascia adherens	  5	1	1	0	5	911	5673	0
GO:0005921	gap junction	 11	0.805664391834832	1	1	10	910	5668	0.657519209659715
GO:0005922	connexin complex	  6	1	1	0	6	911	5672	0
GO:0005923	bicellular tight junction	 54	0.985232246278162	1	3	51	908	5627	0.401817294792048
GO:0005930	axoneme	 35	0.542560241686169	1	5	30	906	5648	1.03324447232241
GO:0005938	cell cortex	 67	0.449785900204556	1	10	57	901	5621	1.07950915018759
GO:0005942	phosphatidylinositol 3-kinase complex	  5	1	1	0	5	911	5673	0
GO:0005952	cAMP-dependent protein kinase complex	  5	0.524912504930412	1	1	4	910	5674	1.44654226125137
GO:0005975	carbohydrate metabolic process	 82	0.154086007437163	1	15	67	896	5611	1.3230569462665
GO:0005977	glycogen metabolic process	 15	0.634731522702541	1	2	13	909	5665	0.964361507500915
GO:0005978	glycogen biosynthetic process	 11	0.805664391834832	1	1	10	910	5668	0.657519209659715
GO:0005980	glycogen catabolic process	  6	0.590648335429865	1	1	5	910	5673	1.20545188437614
GO:0006006	glucose metabolic process	 32	0.0255632575290808	1	9	23	902	5655	2.03420005488474
GO:0006020	inositol metabolic process	  7	0.647297183435849	1	1	6	910	5672	1.03324447232241
GO:0006024	glycosaminoglycan biosynthetic process	 16	0.907797453739348	1	1	15	910	5663	0.452044456641054
GO:0006027	glycosaminoglycan catabolic process	  9	0.738180574705634	1	1	8	910	5670	0.803634589584096
GO:0006044	N-acetylglucosamine metabolic process	  7	0.647297183435849	1	1	6	910	5672	1.03324447232241
GO:0006090	pyruvate metabolic process	 11	0.0112141673759239	0.822910375966763	5	6	906	5672	3.28759604829857
GO:0006091	generation of precursor metabolites and energy	 19	0.262946555916241	1	4	15	907	5663	1.52267606447513
GO:0006094	gluconeogenesis	 24	0.230439938269259	1	5	19	906	5659	1.50681485547018
GO:0006096	glycolytic process	 18	0.230920507298425	1	4	14	907	5664	1.60726917916819
GO:0006099	tricarboxylic acid cycle	 20	0.000711623545251235	0.260912236004279	9	11	902	5667	3.25472008781559
GO:0006103	2-oxoglutarate metabolic process	 13	0.0930371570174248	1	4	9	907	5669	2.22544963269442
GO:0006105	succinate metabolic process	  5	0.143519565197953	1	2	3	909	5675	2.89308452250274
GO:0006107	oxaloacetate metabolic process	  9	0.0038850177872775	0.659898021296136	5	4	906	5674	4.01817294792048
GO:0006108	malate metabolic process	  7	0.00897649165613564	0.780954774083801	4	3	907	5675	4.13297788928963
GO:0006110	regulation of glycolytic process	 20	0.536209630921365	1	3	17	908	5661	1.08490669593853
GO:0006111	regulation of gluconeogenesis	  6	0.590648335429865	1	1	5	910	5673	1.20545188437614
GO:0006112	energy reserve metabolic process	  6	0.590648335429865	1	1	5	910	5673	1.20545188437614
GO:0006119	oxidative phosphorylation	  7	0.647297183435849	1	1	6	910	5672	1.03324447232241
GO:0006120	mitochondrial electron transport, NADH to ubiquinone	 10	0.411940837929264	1	2	8	909	5670	1.44654226125137
GO:0006122	mitochondrial electron transport, ubiquinol to cytochrome c	  5	0.524912504930412	1	1	4	910	5674	1.44654226125137
GO:0006123	mitochondrial electron transport, cytochrome c to oxygen	  5	0.0212050012661332	1	3	2	908	5676	4.33962678375412
GO:0006139	nucleobase-containing compound metabolic process	 24	0.0387972229747595	1	7	17	904	5661	2.10954079765825
GO:0006164	purine nucleotide biosynthetic process	  5	0.524912504930412	1	1	4	910	5674	1.44654226125137
GO:0006165	nucleoside diphosphate phosphorylation	  8	0.696113996849696	1	1	7	910	5671	0.904088913282108
GO:0006171	cAMP biosynthetic process	  9	1	1	0	9	911	5669	0
GO:0006182	cGMP biosynthetic process	 10	1	1	0	10	911	5668	0
GO:0006198	cAMP catabolic process	 10	0.774429434347452	1	1	9	910	5669	0.723271130625686
GO:0006221	pyrimidine nucleotide biosynthetic process	  5	0.143519565197953	1	2	3	909	5675	2.89308452250274
GO:0006241	CTP biosynthetic process	  6	0.19623335243315	1	2	4	909	5674	2.41090376875229
GO:0006259	DNA metabolic process	  8	1	1	0	8	911	5670	0
GO:0006260	DNA replication	 51	0.267168472905194	1	9	42	902	5636	1.27636081875121
GO:0006261	DNA-dependent DNA replication	  5	1	1	0	5	911	5673	0
GO:0006270	DNA replication initiation	 11	1	1	0	11	911	5667	0
GO:0006275	regulation of DNA replication	 12	0.832578307772574	1	1	11	910	5667	0.602725942188072
GO:0006283	transcription-coupled nucleotide-excision repair	 35	0.100527681908658	1	8	27	903	5651	1.65319115571585
GO:0006284	base-excision repair	 10	0.774429434347452	1	1	9	910	5669	0.723271130625686
GO:0006289	nucleotide-excision repair	 19	0.0104708041198931	0.822910375966763	7	12	904	5666	2.66468311283147
GO:0006293	nucleotide-excision repair, preincision complex stabilization	 13	0.0930371570174248	1	4	9	907	5669	2.22544963269442
GO:0006294	nucleotide-excision repair, preincision complex assembly	 15	0.0454641532950084	1	5	10	906	5668	2.41090376875229
GO:0006295	nucleotide-excision repair, DNA incision, 3	 13	0.0930371570174248	1	4	9	907	5669	2.22544963269442
GO:0006296	nucleotide-excision repair, DNA incision, 5	 19	0.110822824981617	1	5	14	906	5664	1.90334508059391
GO:0006297	nucleotide-excision repair, DNA gap filling	 10	0.411940837929264	1	2	8	909	5670	1.44654226125137
GO:0006298	mismatch repair	  8	0.696113996849696	1	1	7	910	5671	0.904088913282108
GO:0006301	postreplication repair	  7	0.250755247393959	1	2	5	909	5673	2.06648894464482
GO:0006302	double-strand break repair	 21	0.570749914782619	1	3	18	908	5660	1.03324447232241
GO:0006303	double-strand break repair via nonhomologous end joining	 23	0.634832927753238	1	3	20	908	5658	0.943397126903069
GO:0006306	DNA methylation	  8	0.0862825209590832	1	3	5	908	5673	2.71226673984632
GO:0006309	apoptotic DNA fragmentation	  9	0.116572893917459	1	3	6	908	5672	2.41090376875229
GO:0006310	DNA recombination	 28	0.764538707578142	1	3	25	908	5653	0.774933354241806
GO:0006325	chromatin organization	 24	0.428813160555296	1	4	20	907	5658	1.20545188437614
GO:0006334	nucleosome assembly	 29	0.785423643074026	1	3	26	908	5652	0.748211514440365
GO:0006335	DNA replication-dependent nucleosome assembly	  5	1	1	0	5	911	5673	0
GO:0006336	DNA replication-independent nucleosome assembly	  9	0.738180574705634	1	1	8	910	5670	0.803634589584096
GO:0006337	nucleosome disassembly	  6	0.590648335429865	1	1	5	910	5673	1.20545188437614
GO:0006338	chromatin remodeling	 34	0.0371469466654889	1	9	25	902	5653	1.91454122812682
GO:0006342	chromatin silencing	  8	0.305579489538918	1	2	6	909	5672	1.80817782656422
GO:0006346	methylation-dependent chromatin silencing	  5	0.524912504930412	1	1	4	910	5674	1.44654226125137
GO:0006349	regulation of gene expression by genetic imprinting	  5	1	1	0	5	911	5673	0
GO:0006352	DNA-templated transcription, initiation	  9	0.359581374002193	1	2	7	909	5671	1.60726917916819
GO:0006359	regulation of transcription from RNA polymerase III promoter	  6	0.0380919907275585	1	3	3	908	5675	3.61635565312843
GO:0006361	transcription initiation from RNA polymerase I promoter	 14	0.00133414075720288	0.339920005781621	7	7	904	5671	3.61635565312843
GO:0006362	transcription elongation from RNA polymerase I promoter	 13	0.00495166774756936	0.682033737744821	6	7	905	5671	3.33817444904163
GO:0006363	termination of RNA polymerase I transcription	 14	0.00133414075720288	0.339920005781621	7	7	904	5671	3.61635565312843
GO:0006364	rRNA processing	 51	0.570153069335484	1	7	44	904	5634	0.992725081250942
GO:0006367	transcription initiation from RNA polymerase II promoter	 59	0.106241846767523	1	12	47	899	5631	1.47105992669631
GO:0006368	transcription elongation from RNA polymerase II promoter	 41	0.19777317257507	1	8	33	903	5645	1.41126074268427
GO:0006369	termination of RNA polymerase II transcription	 28	0.0815976834848162	1	7	21	904	5657	1.80817782656421
GO:0006370	7-methylguanosine mRNA capping	 15	0.0454641532950084	1	5	10	906	5668	2.41090376875229
GO:0006376	mRNA splice site selection	 11	0.186315240979503	1	3	8	908	5670	1.97255762897914
GO:0006378	mRNA polyadenylation	 14	0.303988344911165	1	3	11	908	5667	1.54986670848361
GO:0006379	mRNA cleavage	  6	0.19623335243315	1	2	4	909	5674	2.41090376875229
GO:0006383	transcription from RNA polymerase III promoter	 14	0.303988344911165	1	3	11	908	5667	1.54986670848361
GO:0006396	RNA processing	 57	0.389113658541876	1	9	48	902	5630	1.14200704835635
GO:0006400	tRNA modification	 12	0.00039644503474676	0.177264945402662	7	5	904	5673	4.2190815953165
GO:0006401	RNA catabolic process	 12	0.832578307772574	1	1	11	910	5667	0.602725942188072
GO:0006402	mRNA catabolic process	 12	0.509611316519668	1	2	10	909	5668	1.20545188437614
GO:0006405	RNA export from nucleus	 24	0.664264323067229	1	3	21	908	5657	0.904088913282107
GO:0006406	mRNA export from nucleus	 48	0.812699283128196	1	5	43	906	5635	0.75340742773509
GO:0006409	tRNA export from nucleus	 20	0.785819229034214	1	2	18	909	5660	0.723271130625686
GO:0006412	translation	 97	0.706066565422167	1	12	85	899	5593	0.894768409021467
GO:0006413	translational initiation	 33	0.953991585553062	1	2	31	909	5647	0.438346139773143
GO:0006414	translational elongation	 10	0.411940837929264	1	2	8	909	5670	1.44654226125137
GO:0006417	regulation of translation	 69	0.149737440550686	1	13	56	898	5622	1.36268473885999
GO:0006418	tRNA aminoacylation for protein translation	 22	0.362393330345516	1	4	18	907	5660	1.31503841931943
GO:0006446	regulation of translational initiation	 13	0.855768388602616	1	1	12	910	5666	0.556362408173605
GO:0006450	regulation of translational fidelity	  9	0.359581374002193	1	2	7	909	5671	1.60726917916819
GO:0006457	protein folding	 80	0.428277915436365	1	12	68	899	5610	1.08490669593853
GO:0006458	de novo	  8	0.305579489538918	1	2	6	909	5672	1.80817782656422
GO:0006461	protein complex assembly	 62	0.231312403491633	1	11	51	900	5627	1.28322297369073
GO:0006464	cellular protein modification process	 51	0.570153069335484	1	7	44	904	5634	0.992725081250942
GO:0006465	signal peptide processing	  6	0.590648335429865	1	1	5	910	5673	1.20545188437614
GO:0006469	negative regulation of protein kinase activity	 54	0.475622888878546	1	8	46	903	5632	1.07151278611213
GO:0006470	protein dephosphorylation	 91	0.117683761182705	1	17	74	894	5604	1.35116584842161
GO:0006471	protein ADP-ribosylation	  5	0.524912504930412	1	1	4	910	5674	1.44654226125137
GO:0006473	protein acetylation	  6	0.0380919907275585	1	3	3	908	5675	3.61635565312843
GO:0006479	protein methylation	 24	0.0387972229747595	1	7	17	904	5661	2.10954079765825
GO:0006486	protein glycosylation	 63	0.513212896488666	1	9	54	902	5624	1.03324447232241
GO:0006487	protein N-linked glycosylation	 14	1	1	0	14	911	5664	0
GO:0006488	dolichol-linked oligosaccharide biosynthetic process	  8	1	1	0	8	911	5670	0
GO:0006491	N-glycan processing	  9	1	1	0	9	911	5669	0
GO:0006493	protein O-linked glycosylation	 19	0.500137274055772	1	3	16	908	5662	1.14200704835635
GO:0006501	C-terminal protein lipidation	 26	1	1	0	26	911	5652	0
GO:0006506	GPI anchor biosynthetic process	 11	0.805664391834832	1	1	10	910	5668	0.657519209659715
GO:0006509	membrane protein ectodomain proteolysis	 13	0.554297337812073	1	2	11	909	5667	1.11272481634721
GO:0006511	ubiquitin-dependent protein catabolic process	 93	0.300426591578571	1	15	78	896	5600	1.16656633971885
GO:0006513	protein monoubiquitination	 17	0.199958412567424	1	4	13	907	5665	1.70181442500161
GO:0006515	protein quality control for misfolded or incompletely synthesized proteins	  7	0.250755247393959	1	2	5	909	5673	2.06648894464482
GO:0006516	glycoprotein catabolic process	  6	1	1	0	6	911	5672	0
GO:0006517	protein deglycosylation	  7	1	1	0	7	911	5671	0
GO:0006518	peptide metabolic process	  5	1	1	0	5	911	5673	0
GO:0006520	cellular amino acid metabolic process	 15	0.142496215955173	1	4	11	907	5667	1.92872301500183
GO:0006521	regulation of cellular amino acid metabolic process	 19	0.760858269222929	1	2	17	909	5661	0.761338032237564
GO:0006536	glutamate metabolic process	  8	0.0862825209590832	1	3	5	908	5673	2.71226673984632
GO:0006541	glutamine metabolic process	 11	0.0536855911323149	1	4	7	907	5671	2.63007683863886
GO:0006554	lysine catabolic process	  8	0.696113996849696	1	1	7	910	5671	0.904088913282108
GO:0006596	polyamine biosynthetic process	  6	1	1	0	6	911	5672	0
GO:0006605	protein targeting	 20	0.785819229034214	1	2	18	909	5660	0.723271130625686
GO:0006606	protein import into nucleus	 25	0.461378226139581	1	4	21	907	5657	1.1572338090011
GO:0006607	NLS-bearing protein import into nucleus	 13	0.0930371570174248	1	4	9	907	5669	2.22544963269442
GO:0006610	ribosomal protein import into nucleus	  5	0.0212050012661332	1	3	2	908	5676	4.33962678375412
GO:0006611	protein export from nucleus	 10	0.150143518293906	1	3	7	908	5671	2.16981339187706
GO:0006612	protein targeting to membrane	 12	0.832578307772574	1	1	11	910	5667	0.602725942188072
GO:0006613	cotranslational protein targeting to membrane	  5	0.524912504930412	1	1	4	910	5674	1.44654226125137
GO:0006614	SRP-dependent cotranslational protein targeting to membrane	 13	0.554297337812073	1	2	11	909	5667	1.11272481634721
GO:0006622	protein targeting to lysosome	 10	1	1	0	10	911	5668	0
GO:0006625	protein targeting to peroxisome	  5	0.524912504930412	1	1	4	910	5674	1.44654226125137
GO:0006626	protein targeting to mitochondrion	 15	0.142496215955173	1	4	11	907	5667	1.92872301500183
GO:0006631	fatty acid metabolic process	 61	0.472371670692232	1	9	52	902	5626	1.06712134026741
GO:0006633	fatty acid biosynthetic process	 35	0.00583640796773354	0.768274064449573	11	24	900	5654	2.2731378391093
GO:0006635	fatty acid beta-oxidation	 21	0.956281251912897	1	1	20	910	5658	0.34441482410747
GO:0006636	unsaturated fatty acid biosynthetic process	  7	0.000824151916137237	0.260912236004279	5	2	906	5676	5.16622236161204
GO:0006637	acyl-CoA metabolic process	  7	0.647297183435849	1	1	6	910	5672	1.03324447232241
GO:0006641	triglyceride metabolic process	 15	0.892964940999907	1	1	14	910	5664	0.482180753750457
GO:0006644	phospholipid metabolic process	 30	0.988606390525596	1	1	29	910	5649	0.241090376875229
GO:0006646	phosphatidylethanolamine biosynthetic process	  5	0.524912504930412	1	1	4	910	5674	1.44654226125137
GO:0006654	phosphatidic acid biosynthetic process	 14	0.875749379780082	1	1	13	910	5665	0.516622236161204
GO:0006656	phosphatidylcholine biosynthetic process	 10	0.411940837929264	1	2	8	909	5670	1.44654226125137
GO:0006661	phosphatidylinositol biosynthetic process	 41	0.508440361117283	1	6	35	905	5643	1.0584455570132
GO:0006665	sphingolipid metabolic process	 17	0.703333082174572	1	2	15	909	5663	0.850907212500807
GO:0006672	ceramide metabolic process	 12	0.832578307772574	1	1	11	910	5667	0.602725942188072
GO:0006687	glycosphingolipid metabolic process	 18	0.0915910810089212	1	5	13	906	5665	2.00908647396024
GO:0006688	glycosphingolipid biosynthetic process	  5	1	1	0	5	911	5673	0
GO:0006691	leukotriene metabolic process	  5	1	1	0	5	911	5673	0
GO:0006693	prostaglandin metabolic process	  9	1	1	0	9	911	5669	0
GO:0006694	steroid biosynthetic process	 25	0.0476838836623241	1	7	18	904	5660	2.02515916575192
GO:0006695	cholesterol biosynthetic process	 21	0.0594058306282263	1	6	15	905	5663	2.06648894464482
GO:0006699	bile acid biosynthetic process	 10	0.774429434347452	1	1	9	910	5669	0.723271130625686
GO:0006702	androgen biosynthetic process	  5	0.524912504930412	1	1	4	910	5674	1.44654226125137
GO:0006729	tetrahydrobiopterin biosynthetic process	  5	0.524912504930412	1	1	4	910	5674	1.44654226125137
GO:0006730	one-carbon metabolic process	 12	0.509611316519668	1	2	10	909	5668	1.20545188437614
GO:0006734	NADH metabolic process	  7	0.00897649165613564	0.780954774083801	4	3	907	5675	4.13297788928963
GO:0006749	glutathione metabolic process	 17	0.0219169330647994	1	6	11	905	5667	2.55272163750242
GO:0006750	glutathione biosynthetic process	  8	0.0862825209590832	1	3	5	908	5673	2.71226673984632
GO:0006754	ATP biosynthetic process	 15	0.0113043477494733	0.822910375966763	6	9	905	5669	2.89308452250274
GO:0006768	biotin metabolic process	  6	0.590648335429865	1	1	5	910	5673	1.20545188437614
GO:0006779	porphyrin-containing compound biosynthetic process	  6	0.19623335243315	1	2	4	909	5674	2.41090376875229
GO:0006782	protoporphyrinogen IX biosynthetic process	  6	0.19623335243315	1	2	4	909	5674	2.41090376875229
GO:0006783	heme biosynthetic process	 10	0.411940837929264	1	2	8	909	5670	1.44654226125137
GO:0006796	phosphate-containing compound metabolic process	 11	0.462079859473656	1	2	9	909	5669	1.31503841931943
GO:0006801	superoxide metabolic process	  9	0.738180574705634	1	1	8	910	5670	0.803634589584096
GO:0006805	xenobiotic metabolic process	 24	0.103262336139248	1	6	18	905	5660	1.80817782656421
GO:0006807	nitrogen compound metabolic process	  7	0.647297183435849	1	1	6	910	5672	1.03324447232241
GO:0006809	nitric oxide biosynthetic process	 10	1	1	0	10	911	5668	0
GO:0006812	cation transport	 29	0.372755593071474	1	5	24	906	5654	1.24701919073394
GO:0006813	potassium ion transport	 63	0.786890538902516	1	7	56	904	5622	0.803634589584096
GO:0006814	sodium ion transport	 48	0.502526164340484	1	7	41	904	5637	1.05477039882913
GO:0006816	calcium ion transport	 65	0.553012119471361	1	9	56	902	5622	1.00145233471249
GO:0006820	anion transport	  6	0.590648335429865	1	1	5	910	5673	1.20545188437614
GO:0006821	chloride transport	 32	1	1	0	32	911	5646	0
GO:0006825	copper ion transport	  5	1	1	0	5	911	5673	0
GO:0006826	iron ion transport	  8	1	1	0	8	911	5670	0
GO:0006829	zinc II ion transport	 12	0.224422574243593	1	3	9	908	5669	1.80817782656421
GO:0006836	neurotransmitter transport	 21	0.956281251912897	1	1	20	910	5658	0.34441482410747
GO:0006839	mitochondrial transport	 20	0.295727251817412	1	4	16	907	5662	1.44654226125137
GO:0006851	mitochondrial calcium ion transmembrane transport	 10	0.150143518293906	1	3	7	908	5671	2.16981339187706
GO:0006853	carnitine shuttle	  5	1	1	0	5	911	5673	0
GO:0006855	drug transmembrane transport	  7	0.250755247393959	1	2	5	909	5673	2.06648894464482
GO:0006865	amino acid transport	 21	0.956281251912897	1	1	20	910	5658	0.34441482410747
GO:0006869	lipid transport	 52	0.864021887264913	1	5	47	906	5631	0.695453010217006
GO:0006874	cellular calcium ion homeostasis	 48	0.91445389602517	1	4	44	907	5634	0.602725942188072
GO:0006878	cellular copper ion homeostasis	  6	0.590648335429865	1	1	5	910	5673	1.20545188437614
GO:0006879	cellular iron ion homeostasis	 32	0.839022338419681	1	3	29	908	5649	0.678066684961581
GO:0006882	cellular zinc ion homeostasis	  7	0.250755247393959	1	2	5	909	5673	2.06648894464482
GO:0006883	cellular sodium ion homeostasis	 10	1	1	0	10	911	5668	0
GO:0006884	cell volume homeostasis	  5	1	1	0	5	911	5673	0
GO:0006885	regulation of pH	  8	0.305579489538918	1	2	6	909	5672	1.80817782656422
GO:0006887	exocytosis	 65	0.957002880086757	1	5	60	906	5618	0.556362408173605
GO:0006888	ER to Golgi vesicle-mediated transport	 76	0.245765078102733	1	13	63	898	5615	1.23717430238604
GO:0006890	retrograde vesicle-mediated transport, Golgi to ER	 29	0.58353593328048	1	4	25	907	5653	0.997615352587153
GO:0006891	intra-Golgi vesicle-mediated transport	 12	0.224422574243593	1	3	9	908	5669	1.80817782656421
GO:0006892	post-Golgi vesicle-mediated transport	 11	1	1	0	11	911	5667	0
GO:0006893	Golgi to plasma membrane transport	 10	0.411940837929264	1	2	8	909	5670	1.44654226125137
GO:0006895	Golgi to endosome transport	 11	1	1	0	11	911	5667	0
GO:0006897	endocytosis	 96	0.872110497116019	1	10	86	901	5592	0.75340742773509
GO:0006898	receptor-mediated endocytosis	 56	0.961127043399747	1	4	52	907	5626	0.516622236161204
GO:0006900	vesicle budding from membrane	  5	0.524912504930412	1	1	4	910	5674	1.44654226125137
GO:0006903	vesicle targeting	  6	1	1	0	6	911	5672	0
GO:0006904	vesicle docking involved in exocytosis	 14	1	1	0	14	911	5664	0
GO:0006906	vesicle fusion	 30	0.401898545597323	1	5	25	906	5653	1.20545188437614
GO:0006909	phagocytosis	 29	0.785423643074026	1	3	26	908	5652	0.748211514440365
GO:0006911	phagocytosis, engulfment	 12	0.832578307772574	1	1	11	910	5667	0.602725942188072
GO:0006913	nucleocytoplasmic transport	 10	1	1	0	10	911	5668	0
GO:0006914	autophagy	 86	0.534140493027134	1	12	74	899	5604	1.00921553110561
GO:0006919	activation of cysteine-type endopeptidase activity involved in apoptotic process	 30	0.227040830442229	1	6	24	905	5654	1.44654226125137
GO:0006928	movement of cell or subcellular component	 37	0.594402919411983	1	5	32	906	5646	0.977393419764441
GO:0006935	chemotaxis	 57	0.911050528717516	1	5	52	906	5626	0.63444836019797
GO:0006936	muscle contraction	 40	0.98096231592147	1	2	38	909	5640	0.361635565312843
GO:0006937	regulation of muscle contraction	  8	1	1	0	8	911	5670	0
GO:0006939	smooth muscle contraction	  8	1	1	0	8	911	5670	0
GO:0006940	regulation of smooth muscle contraction	  7	1	1	0	7	911	5671	0
GO:0006941	striated muscle contraction	  8	0.696113996849696	1	1	7	910	5671	0.904088913282108
GO:0006950	response to stress	 31	0.430880175764085	1	5	26	906	5652	1.16656633971885
GO:0006952	defense response	 30	0.933483829552772	1	2	28	909	5650	0.482180753750457
GO:0006953	acute-phase response	 13	0.554297337812073	1	2	11	909	5667	1.11272481634721
GO:0006956	complement activation	  9	1	1	0	9	911	5669	0
GO:0006958	complement activation, classical pathway	 12	1	1	0	12	911	5666	0
GO:0006959	humoral immune response	 17	0.920576476962146	1	1	16	910	5662	0.425453606250404
GO:0006968	cellular defense response	 15	0.892964940999907	1	1	14	910	5664	0.482180753750457
GO:0006970	response to osmotic stress	  7	0.647297183435849	1	1	6	910	5672	1.03324447232241
GO:0006972	hyperosmotic response	  6	0.590648335429865	1	1	5	910	5673	1.20545188437614
GO:0006977	DNA damage response, signal transduction by p53 class mediator resulting in cell cycle arrest	 23	0.203944604492174	1	5	18	906	5660	1.57232854483845
GO:0006979	response to oxidative stress	 61	0.332099002906674	1	10	51	901	5627	1.1856903780749
GO:0006983	ER overload response	  5	1	1	0	5	911	5673	0
GO:0006986	response to unfolded protein	 33	0.854121486059169	1	3	30	908	5648	0.657519209659715
GO:0006995	cellular response to nitrogen starvation	  6	0.19623335243315	1	2	4	909	5674	2.41090376875229
GO:0006996	organelle organization	  6	1	1	0	6	911	5672	0
GO:0006997	nucleus organization	 10	0.150143518293906	1	3	7	908	5671	2.16981339187706
GO:0006998	nuclear envelope organization	  7	1	1	0	7	911	5671	0
GO:0006999	nuclear pore organization	  5	0.524912504930412	1	1	4	910	5674	1.44654226125137
GO:0007004	telomere maintenance via telomerase	  7	0.647297183435849	1	1	6	910	5672	1.03324447232241
GO:0007005	mitochondrion organization	 34	0.181150928150866	1	7	27	904	5651	1.48908762187641
GO:0007009	plasma membrane organization	  7	0.250755247393959	1	2	5	909	5673	2.06648894464482
GO:0007010	cytoskeleton organization	 79	0.872131286480277	1	8	71	903	5607	0.7324264613931
GO:0007015	actin filament organization	 33	0.688030862024796	1	4	29	907	5649	0.876692279546286
GO:0007016	cytoskeletal anchoring at plasma membrane	  7	1	1	0	7	911	5671	0
GO:0007017	microtubule-based process	 18	0.462686108033741	1	3	15	908	5663	1.20545188437614
GO:0007018	microtubule-based movement	 42	0.851539858984682	1	4	38	907	5640	0.688829648214939
GO:0007020	microtubule nucleation	 13	0.554297337812073	1	2	11	909	5667	1.11272481634721
GO:0007026	negative regulation of microtubule depolymerization	 10	0.774429434347452	1	1	9	910	5669	0.723271130625686
GO:0007029	endoplasmic reticulum organization	 15	1	1	0	15	911	5663	0
GO:0007030	Golgi organization	 39	0.289137274728175	1	7	32	904	5646	1.29817895240508
GO:0007031	peroxisome organization	 12	0.509611316519668	1	2	10	909	5668	1.20545188437614
GO:0007032	endosome organization	 15	0.892964940999907	1	1	14	910	5664	0.482180753750457
GO:0007034	vacuolar transport	  7	0.647297183435849	1	1	6	910	5672	1.03324447232241
GO:0007035	vacuolar acidification	 10	1	1	0	10	911	5668	0
GO:0007040	lysosome organization	 14	0.596015503295557	1	2	12	909	5666	1.03324447232241
GO:0007041	lysosomal transport	  6	1	1	0	6	911	5672	0
GO:0007043	cell-cell junction assembly	  9	0.738180574705634	1	1	8	910	5670	0.803634589584096
GO:0007044	cell-substrate junction assembly	  5	0.524912504930412	1	1	4	910	5674	1.44654226125137
GO:0007050	cell cycle arrest	 59	0.581362792509991	1	8	51	903	5627	0.98070661779754
GO:0007051	spindle organization	  5	1	1	0	5	911	5673	0
GO:0007052	mitotic spindle organization	 18	1	1	0	18	911	5660	0
GO:0007059	chromosome segregation	 29	0.372755593071474	1	5	24	906	5654	1.24701919073394
GO:0007062	sister chromatid cohesion	 43	0.383808864829202	1	7	36	904	5642	1.17741811962321
GO:0007064	mitotic sister chromatid cohesion	  8	0.305579489538918	1	2	6	909	5672	1.80817782656422
GO:0007077	mitotic nuclear envelope disassembly	 22	0.828939082355288	1	2	20	909	5658	0.657519209659715
GO:0007080	mitotic metaphase plate congression	 13	0.855768388602616	1	1	12	910	5666	0.556362408173605
GO:0007088	regulation of mitotic nuclear division	  7	0.250755247393959	1	2	5	909	5673	2.06648894464482
GO:0007093	mitotic cell cycle checkpoint	  9	0.359581374002193	1	2	7	909	5671	1.60726917916819
GO:0007094	mitotic spindle assembly checkpoint	  8	1	1	0	8	911	5670	0
GO:0007096	regulation of exit from mitosis	  6	1	1	0	6	911	5672	0
GO:0007097	nuclear migration	  6	0.590648335429865	1	1	5	910	5673	1.20545188437614
GO:0007098	centrosome cycle	 16	0.670477249908291	1	2	14	909	5664	0.904088913282108
GO:0007099	centriole replication	  6	1	1	0	6	911	5672	0
GO:0007131	reciprocal meiotic recombination	  8	0.305579489538918	1	2	6	909	5672	1.80817782656422
GO:0007140	male meiotic nuclear division	  7	0.647297183435849	1	1	6	910	5672	1.03324447232241
GO:0007143	female meiotic nuclear division	  5	0.524912504930412	1	1	4	910	5674	1.44654226125137
GO:0007154	cell communication	 22	0.603648322851636	1	3	19	908	5659	0.986278814489572
GO:0007156	homophilic cell adhesion via plasma membrane adhesion molecules	 47	0.967068203024211	1	3	44	908	5634	0.461662423803629
GO:0007157	heterophilic cell-cell adhesion via plasma membrane cell adhesion molecules	 27	0.904515039752466	1	2	25	909	5653	0.535756393056064
GO:0007158	neuron cell-cell adhesion	 12	0.509611316519668	1	2	10	909	5668	1.20545188437614
GO:0007159	leukocyte cell-cell adhesion	 12	1	1	0	12	911	5666	0
GO:0007160	cell-matrix adhesion	 38	0.912404932620371	1	3	35	908	5643	0.571003524178173
GO:0007162	negative regulation of cell adhesion	 23	1	1	0	23	911	5655	0
GO:0007163	establishment or maintenance of cell polarity	 12	0.832578307772574	1	1	11	910	5667	0.602725942188072
GO:0007166	cell surface receptor signaling pathway	 84	0.910463400833279	1	8	76	903	5602	0.688829648214939
GO:0007169	transmembrane receptor protein tyrosine kinase signaling pathway	 43	0.557432876463993	1	6	37	905	5641	1.00921553110561
GO:0007171	activation of transmembrane receptor protein tyrosine kinase activity	  8	0.696113996849696	1	1	7	910	5671	0.904088913282108
GO:0007173	epidermal growth factor receptor signaling pathway	 32	0.947938852250402	1	2	30	909	5648	0.452044456641054
GO:0007175	negative regulation of epidermal growth factor-activated receptor activity	  6	0.590648335429865	1	1	5	910	5673	1.20545188437614
GO:0007178	transmembrane receptor protein serine/threonine kinase signaling pathway	 10	0.774429434347452	1	1	9	910	5669	0.723271130625686
GO:0007179	transforming growth factor beta receptor signaling pathway	 55	0.894273928606158	1	5	50	906	5628	0.657519209659715
GO:0007183	SMAD protein complex assembly	  6	0.590648335429865	1	1	5	910	5673	1.20545188437614
GO:0007187	G-protein coupled receptor signaling pathway, coupled to cyclic nucleotide second messenger	 12	0.509611316519668	1	2	10	909	5668	1.20545188437614
GO:0007188	adenylate cyclase-modulating G-protein coupled receptor signaling pathway	 16	1	1	0	16	911	5662	0
GO:0007189	adenylate cyclase-activating G-protein coupled receptor signaling pathway	 15	0.892964940999907	1	1	14	910	5664	0.482180753750457
GO:0007190	activation of adenylate cyclase activity	 16	0.384511432262289	1	3	13	908	5665	1.35613336992316
GO:0007191	adenylate cyclase-activating dopamine receptor signaling pathway	  6	0.590648335429865	1	1	5	910	5673	1.20545188437614
GO:0007193	adenylate cyclase-inhibiting G-protein coupled receptor signaling pathway	 22	1	1	0	22	911	5656	0
GO:0007194	negative regulation of adenylate cyclase activity	  9	1	1	0	9	911	5669	0
GO:0007200	phospholipase C-activating G-protein coupled receptor signaling pathway	 17	1	1	0	17	911	5661	0
GO:0007202	activation of phospholipase C activity	 12	0.832578307772574	1	1	11	910	5667	0.602725942188072
GO:0007204	positive regulation of cytosolic calcium ion concentration	 48	0.970575823490813	1	3	45	908	5633	0.452044456641054
GO:0007205	protein kinase C-activating G-protein coupled receptor signaling pathway	 15	0.892964940999907	1	1	14	910	5664	0.482180753750457
GO:0007212	dopamine receptor signaling pathway	 10	1	1	0	10	911	5668	0
GO:0007213	G-protein coupled acetylcholine receptor signaling pathway	  8	0.696113996849696	1	1	7	910	5671	0.904088913282108
GO:0007214	gamma-aminobutyric acid signaling pathway	 16	1	1	0	16	911	5662	0
GO:0007215	glutamate receptor signaling pathway	  9	0.738180574705634	1	1	8	910	5670	0.803634589584096
GO:0007218	neuropeptide signaling pathway	 26	0.717842783670638	1	3	23	908	5655	0.834543612260407
GO:0007219	Notch signaling pathway	 48	0.2111432946356	1	9	39	902	5639	1.35613336992316
GO:0007220	Notch receptor processing	  7	0.647297183435849	1	1	6	910	5672	1.03324447232241
GO:0007223	Wnt signaling pathway, calcium modulating pathway	 23	0.634832927753238	1	3	20	908	5658	0.943397126903069
GO:0007224	smoothened signaling pathway	 32	0.143623520359433	1	7	25	904	5653	1.58215559824369
GO:0007229	integrin-mediated signaling pathway	 40	1	1	0	40	911	5638	0
GO:0007249	I-kappaB kinase/NF-kappaB signaling	 20	0.785819229034214	1	2	18	909	5660	0.723271130625686
GO:0007250	activation of NF-kappaB-inducing kinase activity	  6	0.590648335429865	1	1	5	910	5673	1.20545188437614
GO:0007252	I-kappaB phosphorylation	  8	1	1	0	8	911	5670	0
GO:0007254	JNK cascade	 23	0.203944604492174	1	5	18	906	5660	1.57232854483845
GO:0007257	activation of JUN kinase activity	  9	0.359581374002193	1	2	7	909	5671	1.60726917916819
GO:0007259	JAK-STAT cascade	 18	0.462686108033741	1	3	15	908	5663	1.20545188437614
GO:0007263	nitric oxide mediated signal transduction	 11	0.805664391834832	1	1	10	910	5668	0.657519209659715
GO:0007264	small GTPase mediated signal transduction	 79	0.668216592750819	1	10	69	901	5609	0.915533076741375
GO:0007265	Ras protein signal transduction	 36	0.892223627195809	1	3	33	908	5645	0.602725942188072
GO:0007266	Rho protein signal transduction	 29	1	1	0	29	911	5649	0
GO:0007267	cell-cell signaling	 85	0.9168268266025	1	8	77	903	5601	0.680725770000646
GO:0007269	neurotransmitter secretion	 32	0.459558348788714	1	5	27	906	5651	1.13011114160263
GO:0007270	neuron-neuron synaptic transmission	  7	0.250755247393959	1	2	5	909	5673	2.06648894464482
GO:0007271	synaptic transmission, cholinergic	  6	0.590648335429865	1	1	5	910	5673	1.20545188437614
GO:0007274	neuromuscular synaptic transmission	  9	0.738180574705634	1	1	8	910	5670	0.803634589584096
GO:0007276	gamete generation	  5	0.524912504930412	1	1	4	910	5674	1.44654226125137
GO:0007281	germ cell development	 12	0.832578307772574	1	1	11	910	5667	0.602725942188072
GO:0007286	spermatid development	 32	0.839022338419681	1	3	29	908	5649	0.678066684961581
GO:0007289	spermatid nucleus differentiation	  5	1	1	0	5	911	5673	0
GO:0007292	female gamete generation	  5	0.524912504930412	1	1	4	910	5674	1.44654226125137
GO:0007338	single fertilization	 17	0.920576476962146	1	1	16	910	5662	0.425453606250404
GO:0007339	binding of sperm to zona pellucida	  6	0.590648335429865	1	1	5	910	5673	1.20545188437614
GO:0007340	acrosome reaction	  6	1	1	0	6	911	5672	0
GO:0007346	regulation of mitotic cell cycle	 39	0.642804817441497	1	5	34	906	5644	0.927270680289341
GO:0007368	determination of left/right symmetry	 30	0.611480146770197	1	4	26	907	5652	0.964361507500915
GO:0007369	gastrulation	 15	0.634731522702541	1	2	13	909	5665	0.964361507500915
GO:0007389	pattern specification process	 17	0.920576476962146	1	1	16	910	5662	0.425453606250404
GO:0007405	neuroblast proliferation	 11	0.186315240979503	1	3	8	908	5670	1.97255762897914
GO:0007409	axonogenesis	 55	0.791207334100818	1	6	49	905	5629	0.789023051591658
GO:0007411	axon guidance	 96	0.577853262908711	1	13	83	898	5595	0.979429656055616
GO:0007413	axonal fasciculation	  6	0.590648335429865	1	1	5	910	5673	1.20545188437614
GO:0007416	synapse assembly	 29	0.203691418531707	1	6	23	905	5655	1.49642302888073
GO:0007417	central nervous system development	 54	0.327055284146732	1	9	45	902	5633	1.20545188437614
GO:0007422	peripheral nervous system development	 14	0.303988344911165	1	3	11	908	5667	1.54986670848361
GO:0007435	salivary gland morphogenesis	  7	0.647297183435849	1	1	6	910	5672	1.03324447232241
GO:0007492	endoderm development	  5	0.143519565197953	1	2	3	909	5675	2.89308452250274
GO:0007498	mesoderm development	 14	0.596015503295557	1	2	12	909	5666	1.03324447232241
GO:0007517	muscle organ development	 38	0.790567849663914	1	4	34	907	5644	0.761338032237564
GO:0007519	skeletal muscle tissue development	 20	0.0478199829917973	1	6	14	905	5664	2.16981339187706
GO:0007528	neuromuscular junction development	 21	0.808458104218592	1	2	19	909	5659	0.688829648214939
GO:0007548	sex differentiation	  6	0.590648335429865	1	1	5	910	5673	1.20545188437614
GO:0007565	female pregnancy	 38	0.43167240933601	1	6	32	905	5646	1.14200704835635
GO:0007566	embryo implantation	 19	0.500137274055772	1	3	16	908	5662	1.14200704835635
GO:0007568	aging	 81	0.991260115108539	1	5	76	906	5602	0.446463660880053
GO:0007569	cell aging	  7	0.250755247393959	1	2	5	909	5673	2.06648894464482
GO:0007584	response to nutrient	 33	0.301378346214684	1	6	27	905	5651	1.31503841931943
GO:0007585	respiratory gaseous exchange	 16	1	1	0	16	911	5662	0
GO:0007586	digestion	  8	0.305579489538918	1	2	6	909	5672	1.80817782656422
GO:0007595	lactation	 15	0.634731522702541	1	2	13	909	5665	0.964361507500915
GO:0007596	blood coagulation	 70	0.645976191113237	1	9	61	902	5617	0.929920025090168
GO:0007597	blood coagulation, intrinsic pathway	  7	0.647297183435849	1	1	6	910	5672	1.03324447232241
GO:0007599	hemostasis	 18	0.733413953942175	1	2	16	909	5662	0.803634589584096
GO:0007601	visual perception	 53	0.760242543249861	1	6	47	905	5631	0.818797506368701
GO:0007602	phototransduction	  6	0.590648335429865	1	1	5	910	5673	1.20545188437614
GO:0007605	sensory perception of sound	 45	0.886756904660023	1	4	41	907	5637	0.642907671667276
GO:0007608	sensory perception of smell	 14	0.596015503295557	1	2	12	909	5666	1.03324447232241
GO:0007610	behavior	  7	0.647297183435849	1	1	6	910	5672	1.03324447232241
GO:0007611	learning or memory	 28	0.343606597461169	1	5	23	906	5655	1.29155559040301
GO:0007612	learning	 44	0.954032116951568	1	3	41	908	5637	0.493139407244786
GO:0007613	memory	 42	0.533206270189371	1	6	36	905	5642	1.03324447232241
GO:0007616	long-term memory	 22	0.962345164748973	1	1	21	910	5657	0.328759604829857
GO:0007623	circadian rhythm	 38	0.790567849663914	1	4	34	907	5644	0.761338032237564
GO:0007626	locomotory behavior	 47	0.905974344950422	1	4	43	907	5635	0.615549898404839
GO:0007628	adult walking behavior	 17	1	1	0	17	911	5661	0
GO:0007631	feeding behavior	 13	0.855768388602616	1	1	12	910	5666	0.556362408173605
GO:0008009	chemokine activity	  9	0.738180574705634	1	1	8	910	5670	0.803634589584096
GO:0008013	beta-catenin binding	 39	0.00490904410245537	0.682033737744821	12	27	899	5651	2.22544963269442
GO:0008015	blood circulation	 19	0.500137274055772	1	3	16	908	5662	1.14200704835635
GO:0008016	regulation of heart contraction	 14	0.875749379780082	1	1	13	910	5665	0.516622236161204
GO:0008021	synaptic vesicle	 68	0.741386769650854	1	8	60	903	5618	0.850907212500807
GO:0008022	protein C-terminus binding	 91	0.0405085737362762	1	19	72	892	5606	1.51012653647121
GO:0008023	transcription elongation factor complex	 11	1	1	0	11	911	5667	0
GO:0008028	monocarboxylic acid transmembrane transporter activity	  6	0.590648335429865	1	1	5	910	5673	1.20545188437614
GO:0008033	tRNA processing	 36	0.051875722969395	1	9	27	902	5651	1.80817782656421
GO:0008037	cell recognition	  9	1	1	0	9	911	5669	0
GO:0008045	motor neuron axon guidance	  9	0.738180574705634	1	1	8	910	5670	0.803634589584096
GO:0008047	enzyme activator activity	 20	0.295727251817412	1	4	16	907	5662	1.44654226125137
GO:0008053	mitochondrial fusion	  9	0.0257017750423318	1	4	5	907	5673	3.21453835833638
GO:0008064	regulation of actin polymerization or depolymerization	  6	0.19623335243315	1	2	4	909	5674	2.41090376875229
GO:0008066	glutamate receptor activity	  5	1	1	0	5	911	5673	0
GO:0008074	guanylate cyclase complex, soluble	  8	1	1	0	8	911	5670	0
GO:0008076	voltage-gated potassium channel complex	 48	0.668570690706105	1	6	42	905	5636	0.904088913282107
GO:0008080	N-acetyltransferase activity	 10	1	1	0	10	911	5668	0
GO:0008081	phosphoric diester hydrolase activity	 28	0.764538707578142	1	3	25	908	5653	0.774933354241806
GO:0008083	growth factor activity	 51	0.570153069335484	1	7	44	904	5634	0.992725081250942
GO:0008089	anterograde axonal transport	 10	0.411940837929264	1	2	8	909	5670	1.44654226125137
GO:0008092	cytoskeletal protein binding	 37	0.972117166346556	1	2	35	909	5643	0.390957367905776
GO:0008093	cytoskeletal adaptor activity	  5	0.143519565197953	1	2	3	909	5675	2.89308452250274
GO:0008094	DNA-dependent ATPase activity	 15	0.00220551085165047	0.462768071049249	7	8	904	5670	3.3752652762532
GO:0008104	protein localization	 29	0.785423643074026	1	3	26	908	5652	0.748211514440365
GO:0008135	translation factor activity, RNA binding	 14	0.596015503295557	1	2	12	909	5666	1.03324447232241
GO:0008137	NADH dehydrogenase (ubiquinone) activity	  8	0.305579489538918	1	2	6	909	5672	1.80817782656422
GO:0008138	protein tyrosine/serine/threonine phosphatase activity	 20	0.131823772311556	1	5	15	906	5663	1.80817782656422
GO:0008139	nuclear localization sequence binding	 11	0.0112141673759239	0.822910375966763	5	6	906	5672	3.28759604829857
GO:0008143	poly(A) binding	  9	0.116572893917459	1	3	6	908	5672	2.41090376875229
GO:0008144	drug binding	 29	0.785423643074026	1	3	26	908	5652	0.748211514440365
GO:0008146	sulfotransferase activity	 18	0.931586037139791	1	1	17	910	5661	0.401817294792048
GO:0008154	actin polymerization or depolymerization	  8	0.305579489538918	1	2	6	909	5672	1.80817782656422
GO:0008156	negative regulation of DNA replication	 11	0.186315240979503	1	3	8	908	5670	1.97255762897914
GO:0008157	protein phosphatase 1 binding	 10	1	1	0	10	911	5668	0
GO:0008168	methyltransferase activity	 70	0.000334198618633656	0.177264945402662	21	49	890	5629	2.16981339187706
GO:0008173	RNA methyltransferase activity	  5	0.143519565197953	1	2	3	909	5675	2.89308452250274
GO:0008179	adenylate cyclase binding	  7	1	1	0	7	911	5671	0
GO:0008180	COP9 signalosome	 17	0.424058507911188	1	3	14	908	5664	1.27636081875121
GO:0008191	metalloendopeptidase inhibitor activity	  6	1	1	0	6	911	5672	0
GO:0008195	phosphatidate phosphatase activity	  8	1	1	0	8	911	5670	0
GO:0008198	ferrous iron binding	  9	0.0257017750423318	1	4	5	907	5673	3.21453835833638
GO:0008201	heparin binding	 66	0.572418168723781	1	9	57	902	5621	0.986278814489572
GO:0008202	steroid metabolic process	 41	0.336013808640909	1	7	34	904	5644	1.23485314984873
GO:0008203	cholesterol metabolic process	 35	0.542560241686169	1	5	30	906	5648	1.03324447232241
GO:0008209	androgen metabolic process	  7	1	1	0	7	911	5671	0
GO:0008217	regulation of blood pressure	 31	0.990188884538583	1	1	30	910	5648	0.23331326794377
GO:0008219	cell death	 20	0.785819229034214	1	2	18	909	5660	0.723271130625686
GO:0008234	cysteine-type peptidase activity	 61	0.332099002906674	1	10	51	901	5627	1.1856903780749
GO:0008236	serine-type peptidase activity	 34	0.515505366345407	1	5	29	906	5649	1.06363401562601
GO:0008237	metallopeptidase activity	 49	0.826808965729871	1	5	44	906	5634	0.738031765944578
GO:0008250	oligosaccharyltransferase complex	  6	1	1	0	6	911	5672	0
GO:0008266	poly(U) RNA binding	 10	0.774429434347452	1	1	9	910	5669	0.723271130625686
GO:0008274	gamma-tubulin ring complex	  5	0.143519565197953	1	2	3	909	5675	2.89308452250274
GO:0008276	protein methyltransferase activity	  7	0.250755247393959	1	2	5	909	5673	2.06648894464482
GO:0008277	regulation of G-protein coupled receptor protein signaling pathway	 27	0.74203057279193	1	3	24	908	5654	0.803634589584096
GO:0008278	cohesin complex	  6	0.19623335243315	1	2	4	909	5674	2.41090376875229
GO:0008286	insulin receptor signaling pathway	 45	0.0834148010416857	1	10	35	901	5643	1.60726917916819
GO:0008299	isoprenoid biosynthetic process	  5	0.0212050012661332	1	3	2	908	5676	4.33962678375412
GO:0008301	DNA binding, bending	  6	0.590648335429865	1	1	5	910	5673	1.20545188437614
GO:0008305	integrin complex	 13	1	1	0	13	911	5665	0
GO:0008306	associative learning	 15	0.634731522702541	1	2	13	909	5665	0.964361507500915
GO:0008307	structural constituent of muscle	 17	1	1	0	17	911	5661	0
GO:0008324	cation transmembrane transporter activity	 10	0.411940837929264	1	2	8	909	5670	1.44654226125137
GO:0008327	methyl-CpG binding	  6	0.19623335243315	1	2	4	909	5674	2.41090376875229
GO:0008328	ionotropic glutamate receptor complex	  8	1	1	0	8	911	5670	0
GO:0008331	high voltage-gated calcium channel activity	  8	1	1	0	8	911	5670	0
GO:0008333	endosome to lysosome transport	 20	0.785819229034214	1	2	18	909	5660	0.723271130625686
GO:0008334	histone mRNA metabolic process	  5	0.524912504930412	1	1	4	910	5674	1.44654226125137
GO:0008340	determination of adult lifespan	  6	1	1	0	6	911	5672	0
GO:0008344	adult locomotory behavior	 28	0.181275299679347	1	6	22	905	5656	1.54986670848361
GO:0008347	glial cell migration	  9	1	1	0	9	911	5669	0
GO:0008349	MAP kinase kinase kinase kinase activity	  5	1	1	0	5	911	5673	0
GO:0008353	RNA polymerase II carboxy-terminal domain kinase activity	  9	0.000397566460112502	0.177264945402662	6	3	905	5675	4.82180753750457
GO:0008354	germ cell migration	  8	0.696113996849696	1	1	7	910	5671	0.904088913282108
GO:0008360	regulation of cell shape	 73	0.993747143052908	1	4	69	907	5609	0.396312948288047
GO:0008361	regulation of cell size	  7	1	1	0	7	911	5671	0
GO:0008373	sialyltransferase activity	  8	0.696113996849696	1	1	7	910	5671	0.904088913282108
GO:0008375	acetylglucosaminyltransferase activity	  5	0.143519565197953	1	2	3	909	5675	2.89308452250274
GO:0008378	galactosyltransferase activity	  6	0.0380919907275585	1	3	3	908	5675	3.61635565312843
GO:0008385	IkappaB kinase complex	  7	1	1	0	7	911	5671	0
GO:0008395	steroid hydroxylase activity	  6	0.590648335429865	1	1	5	910	5673	1.20545188437614
GO:0008406	gonad development	  5	0.524912504930412	1	1	4	910	5674	1.44654226125137
GO:0008408	3	  6	1	1	0	6	911	5672	0
GO:0008409	5	  5	0.524912504930412	1	1	4	910	5674	1.44654226125137
GO:0008429	phosphatidylethanolamine binding	  6	0.19623335243315	1	2	4	909	5674	2.41090376875229
GO:0008430	selenium binding	  6	0.0380919907275585	1	3	3	908	5675	3.61635565312843
GO:0008432	JUN kinase binding	  6	1	1	0	6	911	5672	0
GO:0008440	inositol-1,4,5-trisphosphate 3-kinase activity	  5	1	1	0	5	911	5673	0
GO:0008469	histone-arginine N-methyltransferase activity	  5	0.524912504930412	1	1	4	910	5674	1.44654226125137
GO:0008483	transaminase activity	 12	0.0030155942707453	0.566138145460447	6	6	905	5672	3.61635565312843
GO:0008509	anion transmembrane transporter activity	  5	0.143519565197953	1	2	3	909	5675	2.89308452250274
GO:0008514	organic anion transmembrane transporter activity	  8	1	1	0	8	911	5670	0
GO:0008526	phosphatidylinositol transporter activity	  5	1	1	0	5	911	5673	0
GO:0008535	respiratory chain complex IV assembly	  5	0.524912504930412	1	1	4	910	5674	1.44654226125137
GO:0008536	Ran GTPase binding	 19	0.0377421978853749	1	6	13	905	5665	2.28401409671269
GO:0008542	visual learning	 28	0.554462782906824	1	4	24	907	5654	1.03324447232241
GO:0008543	fibroblast growth factor receptor signaling pathway	 38	0.619059057302281	1	5	33	906	5645	0.951672540296955
GO:0008544	epidermis development	 18	0.230920507298425	1	4	14	907	5664	1.60726917916819
GO:0008565	protein transporter activity	 35	0.201306739711418	1	7	28	904	5650	1.44654226125137
GO:0008569	ATP-dependent microtubule motor activity, minus-end-directed	  6	0.590648335429865	1	1	5	910	5673	1.20545188437614
GO:0008574	ATP-dependent microtubule motor activity, plus-end-directed	 13	1	1	0	13	911	5665	0
GO:0008584	male gonad development	 43	0.0644533571734002	1	10	33	901	5645	1.68202588517601
GO:0008585	female gonad development	  7	0.250755247393959	1	2	5	909	5673	2.06648894464482
GO:0008589	regulation of smoothened signaling pathway	  9	0.359581374002193	1	2	7	909	5671	1.60726917916819
GO:0008593	regulation of Notch signaling pathway	  5	1	1	0	5	911	5673	0
GO:0008603	cAMP-dependent protein kinase regulator activity	  6	0.590648335429865	1	1	5	910	5673	1.20545188437614
GO:0008610	lipid biosynthetic process	 12	0.509611316519668	1	2	10	909	5668	1.20545188437614
GO:0008625	extrinsic apoptotic signaling pathway via death domain receptors	 16	0.670477249908291	1	2	14	909	5664	0.904088913282108
GO:0008630	intrinsic apoptotic signaling pathway in response to DNA damage	 19	0.262946555916241	1	4	15	907	5663	1.52267606447513
GO:0008631	intrinsic apoptotic signaling pathway in response to oxidative stress	  8	1	1	0	8	911	5670	0
GO:0008637	apoptotic mitochondrial changes	 10	0.774429434347452	1	1	9	910	5669	0.723271130625686
GO:0008641	ubiquitin-like modifier activating enzyme activity	  6	0.590648335429865	1	1	5	910	5673	1.20545188437614
GO:0008643	carbohydrate transport	 13	0.263838199411443	1	3	10	908	5668	1.66908722452081
GO:0008652	cellular amino acid biosynthetic process	 20	0.295727251817412	1	4	16	907	5662	1.44654226125137
GO:0008654	phospholipid biosynthetic process	 21	0.570749914782619	1	3	18	908	5660	1.03324447232241
GO:0008656	cysteine-type endopeptidase activator activity involved in apoptotic process	  5	1	1	0	5	911	5673	0
GO:0008970	phosphatidylcholine 1-acylhydrolase activity	  5	1	1	0	5	911	5673	0
GO:0009055	electron carrier activity	 25	0.0476838836623241	1	7	18	904	5660	2.02515916575192
GO:0009058	biosynthetic process	 18	0.0291301788015386	1	6	12	905	5666	2.41090376875229
GO:0009060	aerobic respiration	 12	0.509611316519668	1	2	10	909	5668	1.20545188437614
GO:0009062	fatty acid catabolic process	  7	0.250755247393959	1	2	5	909	5673	2.06648894464482
GO:0009083	branched-chain amino acid catabolic process	 15	0.344361377150163	1	3	12	908	5666	1.44654226125137
GO:0009086	methionine biosynthetic process	  6	1	1	0	6	911	5672	0
GO:0009116	nucleoside metabolic process	 10	0.411940837929264	1	2	8	909	5670	1.44654226125137
GO:0009117	nucleotide metabolic process	 13	0.554297337812073	1	2	11	909	5667	1.11272481634721
GO:0009165	nucleotide biosynthetic process	  8	0.0862825209590832	1	3	5	908	5673	2.71226673984632
GO:0009190	cyclic nucleotide biosynthetic process	  8	1	1	0	8	911	5670	0
GO:0009235	cobalamin metabolic process	  8	1	1	0	8	911	5670	0
GO:0009249	protein lipoylation	  5	1	1	0	5	911	5673	0
GO:0009267	cellular response to starvation	 29	0.785423643074026	1	3	26	908	5652	0.748211514440365
GO:0009268	response to pH	  8	0.696113996849696	1	1	7	910	5671	0.904088913282108
GO:0009306	protein secretion	 16	0.0588514488278301	1	5	11	906	5667	2.26022228320527
GO:0009311	oligosaccharide metabolic process	  8	0.696113996849696	1	1	7	910	5671	0.904088913282108
GO:0009313	oligosaccharide catabolic process	  6	0.590648335429865	1	1	5	910	5673	1.20545188437614
GO:0009314	response to radiation	 20	0.536209630921365	1	3	17	908	5661	1.08490669593853
GO:0009395	phospholipid catabolic process	  5	1	1	0	5	911	5673	0
GO:0009408	response to heat	 26	0.892479153310945	1	2	24	909	5654	0.556362408173605
GO:0009409	response to cold	 25	0.879045586415537	1	2	23	909	5655	0.578616904500549
GO:0009411	response to UV	 23	0.395750956840956	1	4	19	907	5659	1.25786283587076
GO:0009416	response to light stimulus	 10	0.411940837929264	1	2	8	909	5670	1.44654226125137
GO:0009435	NAD biosynthetic process	  5	1	1	0	5	911	5673	0
GO:0009566	fertilization	  9	0.738180574705634	1	1	8	910	5670	0.803634589584096
GO:0009611	response to wounding	 42	0.70827425173457	1	5	37	906	5641	0.861037060268674
GO:0009612	response to mechanical stimulus	 33	0.953991585553062	1	2	31	909	5647	0.438346139773143
GO:0009615	response to virus	 51	0.97909628931721	1	3	48	908	5630	0.425453606250404
GO:0009617	response to bacterium	 16	0.670477249908291	1	2	14	909	5664	0.904088913282108
GO:0009629	response to gravity	  5	0.524912504930412	1	1	4	910	5674	1.44654226125137
GO:0009636	response to toxic substance	 39	0.921150755893196	1	3	36	908	5642	0.556362408173605
GO:0009650	UV protection	  9	0.359581374002193	1	2	7	909	5671	1.60726917916819
GO:0009653	anatomical structure morphogenesis	 29	0.58353593328048	1	4	25	907	5653	0.997615352587153
GO:0009725	response to hormone	 23	0.203944604492174	1	5	18	906	5660	1.57232854483845
GO:0009749	response to glucose	 32	0.839022338419681	1	3	29	908	5649	0.678066684961581
GO:0009755	hormone-mediated signaling pathway	  7	1	1	0	7	911	5671	0
GO:0009790	embryo development	 16	0.670477249908291	1	2	14	909	5664	0.904088913282108
GO:0009791	post-embryonic development	 45	0.160546374462504	1	9	36	902	5642	1.44654226125137
GO:0009880	embryonic pattern specification	 11	0.805664391834832	1	1	10	910	5668	0.657519209659715
GO:0009887	animal organ morphogenesis	 41	0.983253149158224	1	2	39	909	5639	0.352815185671066
GO:0009897	external side of plasma membrane	 72	0.886597243274902	1	7	65	904	5613	0.703180265886084
GO:0009898	cytoplasmic side of plasma membrane	 23	0.634832927753238	1	3	20	908	5658	0.943397126903069
GO:0009922	fatty acid elongase activity	  5	0.143519565197953	1	2	3	909	5675	2.89308452250274
GO:0009925	basal plasma membrane	 15	0.634731522702541	1	2	13	909	5665	0.964361507500915
GO:0009931	calcium-dependent protein serine/threonine kinase activity	  5	0.524912504930412	1	1	4	910	5674	1.44654226125137
GO:0009952	anterior/posterior pattern specification	 32	0.143623520359433	1	7	25	904	5653	1.58215559824369
GO:0009953	dorsal/ventral pattern formation	 18	0.733413953942175	1	2	16	909	5662	0.803634589584096
GO:0009954	proximal/distal pattern formation	  9	1	1	0	9	911	5669	0
GO:0009966	regulation of signal transduction	 13	0.263838199411443	1	3	10	908	5668	1.66908722452081
GO:0009967	positive regulation of signal transduction	 29	0.924901620797181	1	2	27	909	5651	0.498807676293577
GO:0009968	negative regulation of signal transduction	 39	0.642804817441497	1	5	34	906	5644	0.927270680289341
GO:0009987	cellular process	  9	1	1	0	9	911	5669	0
GO:0010001	glial cell differentiation	  8	1	1	0	8	911	5670	0
GO:0010008	endosome membrane	 99	0.732687462782786	1	12	87	899	5591	0.876692279546286
GO:0010033	response to organic substance	 37	0.594402919411983	1	5	32	906	5646	0.977393419764441
GO:0010035	response to inorganic substance	  7	0.647297183435849	1	1	6	910	5672	1.03324447232241
GO:0010038	response to metal ion	 10	0.411940837929264	1	2	8	909	5670	1.44654226125137
GO:0010039	response to iron ion	 12	0.224422574243593	1	3	9	908	5669	1.80817782656421
GO:0010043	response to zinc ion	 20	0.536209630921365	1	3	17	908	5661	1.08490669593853
GO:0010107	potassium ion import	 14	1	1	0	14	911	5664	0
GO:0010165	response to X-ray	  9	0.116572893917459	1	3	6	908	5672	2.41090376875229
GO:0010212	response to ionizing radiation	 17	0.199958412567424	1	4	13	907	5665	1.70181442500161
GO:0010226	response to lithium ion	  5	1	1	0	5	911	5673	0
GO:0010243	response to organonitrogen compound	 18	0.00749044159132103	0.780954774083801	7	11	904	5667	2.81272106354433
GO:0010248	establishment or maintenance of transmembrane electrochemical gradient	  6	1	1	0	6	911	5672	0
GO:0010259	multicellular organism aging	  6	0.19623335243315	1	2	4	909	5674	2.41090376875229
GO:0010288	response to lead ion	 11	0.805664391834832	1	1	10	910	5668	0.657519209659715
GO:0010314	phosphatidylinositol-5-phosphate binding	  5	0.143519565197953	1	2	3	909	5675	2.89308452250274
GO:0010332	response to gamma radiation	 11	0.0536855911323149	1	4	7	907	5671	2.63007683863886
GO:0010369	chromocenter	  5	0.524912504930412	1	1	4	910	5674	1.44654226125137
GO:0010389	regulation of G2/M transition of mitotic cell cycle	 42	0.942810391560151	1	3	39	908	5639	0.516622236161204
GO:0010447	response to acidic pH	  6	0.590648335429865	1	1	5	910	5673	1.20545188437614
GO:0010459	negative regulation of heart rate	  5	1	1	0	5	911	5673	0
GO:0010460	positive regulation of heart rate	  7	1	1	0	7	911	5671	0
GO:0010466	negative regulation of peptidase activity	 30	0.988606390525596	1	1	29	910	5649	0.241090376875229
GO:0010468	regulation of gene expression	 97	0.475586658385512	1	14	83	897	5595	1.04389647719171
GO:0010469	regulation of receptor activity	  7	1	1	0	7	911	5671	0
GO:0010470	regulation of gastrulation	  5	1	1	0	5	911	5673	0
GO:0010494	cytoplasmic stress granule	 20	0.536209630921365	1	3	17	908	5661	1.08490669593853
GO:0010498	proteasomal protein catabolic process	  8	0.305579489538918	1	2	6	909	5672	1.80817782656422
GO:0010501	RNA secondary structure unwinding	 19	0.941070913135173	1	1	18	910	5660	0.380669016118782
GO:0010506	regulation of autophagy	 33	0.301378346214684	1	6	27	905	5651	1.31503841931943
GO:0010507	negative regulation of autophagy	 11	0.805664391834832	1	1	10	910	5668	0.657519209659715
GO:0010508	positive regulation of autophagy	 29	0.785423643074026	1	3	26	908	5652	0.748211514440365
GO:0010510	regulation of acetyl-CoA biosynthetic process from pyruvate	 11	0.186315240979503	1	3	8	908	5670	1.97255762897914
GO:0010518	positive regulation of phospholipase activity	  7	0.647297183435849	1	1	6	910	5672	1.03324447232241
GO:0010524	positive regulation of calcium ion transport into cytosol	  5	1	1	0	5	911	5673	0
GO:0010575	positive regulation of vascular endothelial growth factor production	  8	1	1	0	8	911	5670	0
GO:0010586	miRNA metabolic process	  9	0.359581374002193	1	2	7	909	5671	1.60726917916819
GO:0010595	positive regulation of endothelial cell migration	 24	0.864076388223246	1	2	22	909	5656	0.602725942188072
GO:0010596	negative regulation of endothelial cell migration	  9	0.738180574705634	1	1	8	910	5670	0.803634589584096
GO:0010608	posttranscriptional regulation of gene expression	  9	0.738180574705634	1	1	8	910	5670	0.803634589584096
GO:0010613	positive regulation of cardiac muscle hypertrophy	  9	0.738180574705634	1	1	8	910	5670	0.803634589584096
GO:0010629	negative regulation of gene expression	 79	0.410389748256866	1	12	67	899	5611	1.09863969208965
GO:0010633	negative regulation of epithelial cell migration	  8	1	1	0	8	911	5670	0
GO:0010634	positive regulation of epithelial cell migration	 18	0.931586037139791	1	1	17	910	5661	0.401817294792048
GO:0010666	positive regulation of cardiac muscle cell apoptotic process	  5	1	1	0	5	911	5673	0
GO:0010667	negative regulation of cardiac muscle cell apoptotic process	  9	0.738180574705634	1	1	8	910	5670	0.803634589584096
GO:0010717	regulation of epithelial to mesenchymal transition	  7	0.250755247393959	1	2	5	909	5673	2.06648894464482
GO:0010718	positive regulation of epithelial to mesenchymal transition	 21	0.328967927753839	1	4	17	907	5661	1.37765929642988
GO:0010719	negative regulation of epithelial to mesenchymal transition	 10	0.411940837929264	1	2	8	909	5670	1.44654226125137
GO:0010738	regulation of protein kinase A signaling	  8	0.696113996849696	1	1	7	910	5671	0.904088913282108
GO:0010744	positive regulation of macrophage derived foam cell differentiation	  5	0.524912504930412	1	1	4	910	5674	1.44654226125137
GO:0010763	positive regulation of fibroblast migration	  8	1	1	0	8	911	5670	0
GO:0010764	negative regulation of fibroblast migration	  5	1	1	0	5	911	5673	0
GO:0010765	positive regulation of sodium ion transport	 10	0.774429434347452	1	1	9	910	5669	0.723271130625686
GO:0010800	positive regulation of peptidyl-threonine phosphorylation	 10	1	1	0	10	911	5668	0
GO:0010801	negative regulation of peptidyl-threonine phosphorylation	  7	0.250755247393959	1	2	5	909	5673	2.06648894464482
GO:0010803	regulation of tumor necrosis factor-mediated signaling pathway	 16	0.907797453739348	1	1	15	910	5663	0.452044456641054
GO:0010804	negative regulation of tumor necrosis factor-mediated signaling pathway	  5	0.524912504930412	1	1	4	910	5674	1.44654226125137
GO:0010811	positive regulation of cell-substrate adhesion	 16	0.907797453739348	1	1	15	910	5663	0.452044456641054
GO:0010812	negative regulation of cell-substrate adhesion	  7	0.647297183435849	1	1	6	910	5672	1.03324447232241
GO:0010821	regulation of mitochondrion organization	  6	0.19623335243315	1	2	4	909	5674	2.41090376875229
GO:0010824	regulation of centrosome duplication	  7	1	1	0	7	911	5671	0
GO:0010839	negative regulation of keratinocyte proliferation	  8	0.696113996849696	1	1	7	910	5671	0.904088913282108
GO:0010842	retina layer formation	  9	0.738180574705634	1	1	8	910	5670	0.803634589584096
GO:0010862	positive regulation of pathway-restricted SMAD protein phosphorylation	 16	0.670477249908291	1	2	14	909	5664	0.904088913282108
GO:0010863	positive regulation of phospholipase C activity	  6	0.590648335429865	1	1	5	910	5673	1.20545188437614
GO:0010875	positive regulation of cholesterol efflux	  5	0.524912504930412	1	1	4	910	5674	1.44654226125137
GO:0010880	regulation of release of sequestered calcium ion into cytosol by sarcoplasmic reticulum	  9	1	1	0	9	911	5669	0
GO:0010881	regulation of cardiac muscle contraction by regulation of the release of sequestered calcium ion	 10	1	1	0	10	911	5668	0
GO:0010882	regulation of cardiac muscle contraction by calcium ion signaling	  5	1	1	0	5	911	5673	0
GO:0010906	regulation of glucose metabolic process	 12	0.509611316519668	1	2	10	909	5668	1.20545188437614
GO:0010907	positive regulation of glucose metabolic process	  7	0.250755247393959	1	2	5	909	5673	2.06648894464482
GO:0010917	negative regulation of mitochondrial membrane potential	  6	0.590648335429865	1	1	5	910	5673	1.20545188437614
GO:0010923	negative regulation of phosphatase activity	 23	0.203944604492174	1	5	18	906	5660	1.57232854483845
GO:0010942	positive regulation of cell death	 17	0.199958412567424	1	4	13	907	5665	1.70181442500161
GO:0010951	negative regulation of endopeptidase activity	 39	0.997036601850938	1	1	38	910	5640	0.185454136057868
GO:0010952	positive regulation of peptidase activity	  8	1	1	0	8	911	5670	0
GO:0010955	negative regulation of protein processing	  6	0.590648335429865	1	1	5	910	5673	1.20545188437614
GO:0010971	positive regulation of G2/M transition of mitotic cell cycle	  9	0.738180574705634	1	1	8	910	5670	0.803634589584096
GO:0010972	negative regulation of G2/M transition of mitotic cell cycle	 22	0.603648322851636	1	3	19	908	5659	0.986278814489572
GO:0010975	regulation of neuron projection development	 14	0.596015503295557	1	2	12	909	5666	1.03324447232241
GO:0010976	positive regulation of neuron projection development	 50	0.548060319992759	1	7	43	904	5635	1.01257958287596
GO:0010977	negative regulation of neuron projection development	 32	0.663761033636311	1	4	28	907	5650	0.904088913282108
GO:0010996	response to auditory stimulus	  7	1	1	0	7	911	5671	0
GO:0012501	programmed cell death	  9	0.359581374002193	1	2	7	909	5671	1.60726917916819
GO:0012505	endomembrane system	 53	0.306767426333482	1	9	44	902	5634	1.22819625955305
GO:0012506	vesicle membrane	 12	0.832578307772574	1	1	11	910	5667	0.602725942188072
GO:0012507	ER to Golgi transport vesicle membrane	 29	0.58353593328048	1	4	25	907	5653	0.997615352587153
GO:0014002	astrocyte development	 10	0.774429434347452	1	1	9	910	5669	0.723271130625686
GO:0014003	oligodendrocyte development	 12	1	1	0	12	911	5666	0
GO:0014032	neural crest cell development	 11	0.186315240979503	1	3	8	908	5670	1.97255762897914
GO:0014047	glutamate secretion	 23	0.634832927753238	1	3	20	908	5658	0.943397126903069
GO:0014059	regulation of dopamine secretion	  7	0.647297183435849	1	1	6	910	5672	1.03324447232241
GO:0014065	phosphatidylinositol 3-kinase signaling	 18	0.462686108033741	1	3	15	908	5663	1.20545188437614
GO:0014066	regulation of phosphatidylinositol 3-kinase signaling	 39	0.289137274728175	1	7	32	904	5646	1.29817895240508
GO:0014068	positive regulation of phosphatidylinositol 3-kinase signaling	 38	0.790567849663914	1	4	34	907	5644	0.761338032237564
GO:0014070	response to organic cyclic compound	 59	0.925446531077864	1	5	54	906	5624	0.612941636123463
GO:0014075	response to amine	  5	1	1	0	5	911	5673	0
GO:0014701	junctional sarcoplasmic reticulum membrane	  6	1	1	0	6	911	5672	0
GO:0014704	intercalated disc	 26	1	1	0	26	911	5652	0
GO:0014823	response to activity	 22	0.603648322851636	1	3	19	908	5659	0.986278814489572
GO:0014824	artery smooth muscle contraction	  6	0.590648335429865	1	1	5	910	5673	1.20545188437614
GO:0014850	response to muscle activity	  9	0.738180574705634	1	1	8	910	5670	0.803634589584096
GO:0014898	cardiac muscle hypertrophy in response to stress	  5	0.524912504930412	1	1	4	910	5674	1.44654226125137
GO:0014911	positive regulation of smooth muscle cell migration	  7	1	1	0	7	911	5671	0
GO:0014912	negative regulation of smooth muscle cell migration	  7	0.647297183435849	1	1	6	910	5672	1.03324447232241
GO:0015012	heparan sulfate proteoglycan biosynthetic process	  8	0.305579489538918	1	2	6	909	5672	1.80817782656422
GO:0015026	coreceptor activity	 12	0.832578307772574	1	1	11	910	5667	0.602725942188072
GO:0015030	Cajal body	 24	0.972068460896197	1	1	23	910	5655	0.301362971094036
GO:0015035	protein disulfide oxidoreductase activity	 10	0.411940837929264	1	2	8	909	5670	1.44654226125137
GO:0015036	disulfide oxidoreductase activity	  5	0.143519565197953	1	2	3	909	5675	2.89308452250274
GO:0015037	peptide disulfide oxidoreductase activity	  5	1	1	0	5	911	5673	0
GO:0015075	ion transmembrane transporter activity	  5	0.524912504930412	1	1	4	910	5674	1.44654226125137
GO:0015078	hydrogen ion transmembrane transporter activity	 12	0.509611316519668	1	2	10	909	5668	1.20545188437614
GO:0015095	magnesium ion transmembrane transporter activity	  7	1	1	0	7	911	5671	0
GO:0015171	amino acid transmembrane transporter activity	 21	0.956281251912897	1	1	20	910	5658	0.34441482410747
GO:0015175	neutral amino acid transmembrane transporter activity	  5	1	1	0	5	911	5673	0
GO:0015194	L-serine transmembrane transporter activity	  5	1	1	0	5	911	5673	0
GO:0015248	sterol transporter activity	  8	0.696113996849696	1	1	7	910	5671	0.904088913282108
GO:0015266	protein channel activity	  6	0.590648335429865	1	1	5	910	5673	1.20545188437614
GO:0015267	channel activity	  5	0.524912504930412	1	1	4	910	5674	1.44654226125137
GO:0015269	calcium-activated potassium channel activity	  9	1	1	0	9	911	5669	0
GO:0015276	ligand-gated ion channel activity	  7	1	1	0	7	911	5671	0
GO:0015278	calcium-release channel activity	  8	0.696113996849696	1	1	7	910	5671	0.904088913282108
GO:0015293	symporter activity	 40	0.31241174882479	1	7	33	904	5645	1.26572447859495
GO:0015297	antiporter activity	 18	0.733413953942175	1	2	16	909	5662	0.803634589584096
GO:0015299	solute:proton antiporter activity	  5	0.524912504930412	1	1	4	910	5674	1.44654226125137
GO:0015301	anion:anion antiporter activity	  6	0.590648335429865	1	1	5	910	5673	1.20545188437614
GO:0015347	sodium-independent organic anion transmembrane transporter activity	  8	1	1	0	8	911	5670	0
GO:0015459	potassium channel regulator activity	 24	0.428813160555296	1	4	20	907	5658	1.20545188437614
GO:0015467	G-protein activated inward rectifier potassium channel activity	  7	1	1	0	7	911	5671	0
GO:0015485	cholesterol binding	 18	1	1	0	18	911	5660	0
GO:0015629	actin cytoskeleton	 97	0.361862225172212	1	15	82	896	5596	1.11846051127683
GO:0015630	microtubule cytoskeleton	 83	0.251537340432797	1	14	69	897	5609	1.21997540105537
GO:0015631	tubulin binding	 24	0.428813160555296	1	4	20	907	5658	1.20545188437614
GO:0015671	oxygen transport	  6	1	1	0	6	911	5672	0
GO:0015693	magnesium ion transport	  5	1	1	0	5	911	5673	0
GO:0015698	inorganic anion transport	  6	0.590648335429865	1	1	5	910	5673	1.20545188437614
GO:0015701	bicarbonate transport	 15	0.344361377150163	1	3	12	908	5666	1.44654226125137
GO:0015711	organic anion transport	  7	1	1	0	7	911	5671	0
GO:0015718	monocarboxylic acid transport	  6	0.590648335429865	1	1	5	910	5673	1.20545188437614
GO:0015721	bile acid and bile salt transport	  6	1	1	0	6	911	5672	0
GO:0015758	glucose transport	 12	1	1	0	12	911	5666	0
GO:0015804	neutral amino acid transport	  5	1	1	0	5	911	5673	0
GO:0015813	L-glutamate transport	  8	1	1	0	8	911	5670	0
GO:0015825	L-serine transport	  5	1	1	0	5	911	5673	0
GO:0015833	peptide transport	  6	1	1	0	6	911	5672	0
GO:0015914	phospholipid transport	 20	0.785819229034214	1	2	18	909	5660	0.723271130625686
GO:0015918	sterol transport	  7	0.647297183435849	1	1	6	910	5672	1.03324447232241
GO:0015935	small ribosomal subunit	  5	1	1	0	5	911	5673	0
GO:0015949	nucleobase-containing small molecule interconversion	 17	0.703333082174572	1	2	15	909	5663	0.850907212500807
GO:0015986	ATP synthesis coupled proton transport	 10	0.00689228204720671	0.768274064449573	5	5	906	5673	3.61635565312843
GO:0015991	ATP hydrolysis coupled proton transport	 15	0.634731522702541	1	2	13	909	5665	0.964361507500915
GO:0015992	proton transport	 41	0.0485106290258095	1	10	31	901	5647	1.76407592835533
GO:0016010	dystrophin-associated glycoprotein complex	  8	1	1	0	8	911	5670	0
GO:0016018	cyclosporin A binding	  8	1	1	0	8	911	5670	0
GO:0016042	lipid catabolic process	 39	0.807455053346476	1	4	35	907	5643	0.741816544231473
GO:0016049	cell growth	 29	0.924901620797181	1	2	27	909	5651	0.498807676293577
GO:0016050	vesicle organization	 17	0.920576476962146	1	1	16	910	5662	0.425453606250404
GO:0016055	Wnt signaling pathway	 76	0.245765078102733	1	13	63	898	5615	1.23717430238604
GO:0016064	immunoglobulin mediated immune response	  7	1	1	0	7	911	5671	0
GO:0016070	RNA metabolic process	 26	0.285970151784858	1	5	21	906	5657	1.39090602043401
GO:0016079	synaptic vesicle exocytosis	 17	0.703333082174572	1	2	15	909	5663	0.850907212500807
GO:0016081	synaptic vesicle docking	  7	0.0599286150311256	1	3	4	908	5674	3.09973341696723
GO:0016082	synaptic vesicle priming	  8	0.696113996849696	1	1	7	910	5671	0.904088913282108
GO:0016125	sterol metabolic process	  7	0.647297183435849	1	1	6	910	5672	1.03324447232241
GO:0016126	sterol biosynthetic process	 22	0.178553616091294	1	5	17	906	5661	1.64379802414929
GO:0016180	snRNA processing	  5	1	1	0	5	911	5673	0
GO:0016188	synaptic vesicle maturation	  5	1	1	0	5	911	5673	0
GO:0016197	endosomal transport	 29	1	1	0	29	911	5649	0
GO:0016209	antioxidant activity	 10	0.411940837929264	1	2	8	909	5670	1.44654226125137
GO:0016234	inclusion body	 13	0.554297337812073	1	2	11	909	5667	1.11272481634721
GO:0016235	aggresome	 15	0.892964940999907	1	1	14	910	5664	0.482180753750457
GO:0016236	macroautophagy	 48	0.502526164340484	1	7	41	904	5637	1.05477039882913
GO:0016239	positive regulation of macroautophagy	 13	0.0930371570174248	1	4	9	907	5669	2.22544963269442
GO:0016241	regulation of macroautophagy	 39	0.807455053346476	1	4	35	907	5643	0.741816544231473
GO:0016254	preassembly of GPI anchor in ER membrane	  6	0.590648335429865	1	1	5	910	5673	1.20545188437614
GO:0016266	O-glycan processing	 13	0.855768388602616	1	1	12	910	5666	0.556362408173605
GO:0016274	protein-arginine N-methyltransferase activity	  6	0.590648335429865	1	1	5	910	5673	1.20545188437614
GO:0016279	protein-lysine N-methyltransferase activity	  7	0.0599286150311256	1	3	4	908	5674	3.09973341696723
GO:0016282	eukaryotic 43S preinitiation complex	  5	0.524912504930412	1	1	4	910	5674	1.44654226125137
GO:0016303	1-phosphatidylinositol-3-kinase activity	 19	0.500137274055772	1	3	16	908	5662	1.14200704835635
GO:0016307	phosphatidylinositol phosphate kinase activity	  6	1	1	0	6	911	5672	0
GO:0016308	1-phosphatidylinositol-4-phosphate 5-kinase activity	  5	1	1	0	5	911	5673	0
GO:0016311	dephosphorylation	 84	0.499353733333739	1	12	72	899	5606	1.03324447232241
GO:0016322	neuron remodeling	  6	0.590648335429865	1	1	5	910	5673	1.20545188437614
GO:0016323	basolateral plasma membrane	 73	0.980215254306547	1	5	68	906	5610	0.495391185360059
GO:0016327	apicolateral plasma membrane	  9	1	1	0	9	911	5669	0
GO:0016328	lateral plasma membrane	 22	0.962345164748973	1	1	21	910	5657	0.328759604829857
GO:0016331	morphogenesis of embryonic epithelium	  6	1	1	0	6	911	5672	0
GO:0016339	calcium-dependent cell-cell adhesion via plasma membrane cell adhesion molecules	  8	0.305579489538918	1	2	6	909	5672	1.80817782656422
GO:0016358	dendrite development	 15	0.892964940999907	1	1	14	910	5664	0.482180753750457
GO:0016363	nuclear matrix	 52	0.0954544193883144	1	11	41	900	5637	1.52999662247741
GO:0016407	acetyltransferase activity	  6	0.19623335243315	1	2	4	909	5674	2.41090376875229
GO:0016409	palmitoyltransferase activity	  7	0.647297183435849	1	1	6	910	5672	1.03324447232241
GO:0016442	RISC complex	  6	1	1	0	6	911	5672	0
GO:0016459	myosin complex	 14	0.596015503295557	1	2	12	909	5666	1.03324447232241
GO:0016461	unconventional myosin complex	  5	0.524912504930412	1	1	4	910	5674	1.44654226125137
GO:0016471	vacuolar proton-transporting V-type ATPase complex	  5	0.524912504930412	1	1	4	910	5674	1.44654226125137
GO:0016477	cell migration	 90	0.601053947307503	1	12	78	899	5600	0.964361507500915
GO:0016485	protein processing	 32	0.663761033636311	1	4	28	907	5650	0.904088913282108
GO:0016486	peptide hormone processing	  7	0.250755247393959	1	2	5	909	5673	2.06648894464482
GO:0016504	peptidase activator activity	  7	1	1	0	7	911	5671	0
GO:0016514	SWI/SNF complex	  7	0.250755247393959	1	2	5	909	5673	2.06648894464482
GO:0016525	negative regulation of angiogenesis	 33	0.301378346214684	1	6	27	905	5651	1.31503841931943
GO:0016528	sarcoplasm	  5	0.524912504930412	1	1	4	910	5674	1.44654226125137
GO:0016529	sarcoplasmic reticulum	 30	0.611480146770197	1	4	26	907	5652	0.964361507500915
GO:0016538	cyclin-dependent protein serine/threonine kinase regulator activity	 10	0.0382414370390818	1	4	6	907	5672	2.89308452250274
GO:0016571	histone methylation	 11	0.0112141673759239	0.822910375966763	5	6	906	5672	3.28759604829857
GO:0016573	histone acetylation	 17	0.703333082174572	1	2	15	909	5663	0.850907212500807
GO:0016575	histone deacetylation	 20	0.295727251817412	1	4	16	907	5662	1.44654226125137
GO:0016578	histone deubiquitination	  7	0.250755247393959	1	2	5	909	5673	2.06648894464482
GO:0016580	Sin3 complex	  5	0.524912504930412	1	1	4	910	5674	1.44654226125137
GO:0016581	NuRD complex	 10	0.774429434347452	1	1	9	910	5669	0.723271130625686
GO:0016592	mediator complex	 16	0.670477249908291	1	2	14	909	5664	0.904088913282108
GO:0016594	glycine binding	  5	0.524912504930412	1	1	4	910	5674	1.44654226125137
GO:0016595	glutamate binding	  8	0.696113996849696	1	1	7	910	5671	0.904088913282108
GO:0016597	amino acid binding	  6	0.590648335429865	1	1	5	910	5673	1.20545188437614
GO:0016601	Rac protein signal transduction	 11	0.462079859473656	1	2	9	909	5669	1.31503841931943
GO:0016605	PML body	 46	0.0451413222501087	1	11	35	900	5643	1.72956139932229
GO:0016614	oxidoreductase activity, acting on CH-OH group of donors	  5	1	1	0	5	911	5673	0
GO:0016616	oxidoreductase activity, acting on the CH-OH group of donors, NAD or NADP as acceptor	 13	0.0246444305692994	1	5	8	906	5670	2.78181204086802
GO:0016627	oxidoreductase activity, acting on the CH-CH group of donors	 10	0.411940837929264	1	2	8	909	5670	1.44654226125137
GO:0016628	oxidoreductase activity, acting on the CH-CH group of donors, NAD or NADP as acceptor	  6	0.590648335429865	1	1	5	910	5673	1.20545188437614
GO:0016651	oxidoreductase activity, acting on NAD(P)H	  5	0.143519565197953	1	2	3	909	5675	2.89308452250274
GO:0016671	oxidoreductase activity, acting on a sulfur group of donors, disulfide as acceptor	  6	0.0380919907275585	1	3	3	908	5675	3.61635565312843
GO:0016702	oxidoreductase activity, acting on single donors with incorporation of molecular oxygen, incorporation of two atoms of oxygen	  6	0.590648335429865	1	1	5	910	5673	1.20545188437614
GO:0016705	oxidoreductase activity, acting on paired donors, with incorporation or reduction of molecular oxygen	 19	0.941070913135173	1	1	18	910	5660	0.380669016118782
GO:0016706	oxidoreductase activity, acting on paired donors, with incorporation or reduction of molecular oxygen, 2-oxoglutarate as one donor, and incorporation of one atom each of oxygen into both donors	  6	0.19623335243315	1	2	4	909	5674	2.41090376875229
GO:0016709	oxidoreductase activity, acting on paired donors, with incorporation or reduction of molecular oxygen, NAD(P)H as one donor, and incorporation of one atom of oxygen	  5	0.524912504930412	1	1	4	910	5674	1.44654226125137
GO:0016746	transferase activity, transferring acyl groups	 63	0.152894906708718	1	12	51	899	5627	1.37765929642988
GO:0016747	transferase activity, transferring acyl groups other than amino-acyl groups	  8	0.305579489538918	1	2	6	909	5672	1.80817782656422
GO:0016757	transferase activity, transferring glycosyl groups	 73	0.304887164207398	1	12	61	899	5617	1.18893884486414
GO:0016773	phosphotransferase activity, alcohol group as acceptor	  6	0.590648335429865	1	1	5	910	5673	1.20545188437614
GO:0016779	nucleotidyltransferase activity	 33	0.953991585553062	1	2	31	909	5647	0.438346139773143
GO:0016780	phosphotransferase activity, for other substituted phosphate groups	  5	0.524912504930412	1	1	4	910	5674	1.44654226125137
GO:0016788	hydrolase activity, acting on ester bonds	 13	0.554297337812073	1	2	11	909	5667	1.11272481634721
GO:0016791	phosphatase activity	 59	0.29402990326196	1	10	49	901	5629	1.22588327224693
GO:0016798	hydrolase activity, acting on glycosyl bonds	 25	0.879045586415537	1	2	23	909	5655	0.578616904500549
GO:0016805	dipeptidase activity	  5	1	1	0	5	911	5673	0
GO:0016810	hydrolase activity, acting on carbon-nitrogen (but not peptide) bonds	  6	0.19623335243315	1	2	4	909	5674	2.41090376875229
GO:0016817	hydrolase activity, acting on acid anhydrides	  5	0.524912504930412	1	1	4	910	5674	1.44654226125137
GO:0016818	hydrolase activity, acting on acid anhydrides, in phosphorus-containing anhydrides	  6	1	1	0	6	911	5672	0
GO:0016829	lyase activity	 60	0.601314652386293	1	8	52	903	5626	0.964361507500915
GO:0016831	carboxy-lyase activity	  9	0.738180574705634	1	1	8	910	5670	0.803634589584096
GO:0016849	phosphorus-oxygen lyase activity	  8	1	1	0	8	911	5670	0
GO:0016853	isomerase activity	 56	0.902977404150011	1	5	51	906	5627	0.645777795201505
GO:0016868	intramolecular transferase activity, phosphotransferases	  5	1	1	0	5	911	5673	0
GO:0016874	ligase activity	 69	0.239094505441845	1	12	57	899	5621	1.25786283587076
GO:0016887	ATPase activity	 90	0.0650269846123443	1	18	72	893	5606	1.44654226125137
GO:0016918	retinal binding	  6	1	1	0	6	911	5672	0
GO:0016922	ligand-dependent nuclear receptor binding	 13	0.554297337812073	1	2	11	909	5667	1.11272481634721
GO:0016925	protein sumoylation	 32	0.663761033636311	1	4	28	907	5650	0.904088913282108
GO:0017015	regulation of transforming growth factor beta receptor signaling pathway	 11	0.186315240979503	1	3	8	908	5670	1.97255762897914
GO:0017016	Ras GTPase binding	 11	0.186315240979503	1	3	8	908	5670	1.97255762897914
GO:0017017	MAP kinase tyrosine/serine/threonine phosphatase activity	  6	0.590648335429865	1	1	5	910	5673	1.20545188437614
GO:0017022	myosin binding	 10	1	1	0	10	911	5668	0
GO:0017025	TBP-class protein binding	  5	1	1	0	5	911	5673	0
GO:0017046	peptide hormone binding	  8	1	1	0	8	911	5670	0
GO:0017048	Rho GTPase binding	 17	0.703333082174572	1	2	15	909	5663	0.850907212500807
GO:0017049	GTP-Rho binding	  6	1	1	0	6	911	5672	0
GO:0017053	transcriptional repressor complex	 30	0.046235513128273	1	8	22	903	5656	1.92872301500183
GO:0017056	structural constituent of nuclear pore	  9	0.359581374002193	1	2	7	909	5671	1.60726917916819
GO:0017075	syntaxin-1 binding	 15	0.892964940999907	1	1	14	910	5664	0.482180753750457
GO:0017080	sodium channel regulator activity	 19	1	1	0	19	911	5659	0
GO:0017091	AU-rich element binding	 10	0.411940837929264	1	2	8	909	5670	1.44654226125137
GO:0017101	aminoacyl-tRNA synthetase multienzyme complex	  8	0.305579489538918	1	2	6	909	5672	1.80817782656422
GO:0017110	nucleoside-diphosphatase activity	  7	1	1	0	7	911	5671	0
GO:0017111	nucleoside-triphosphatase activity	  8	0.696113996849696	1	1	7	910	5671	0.904088913282108
GO:0017112	Rab guanyl-nucleotide exchange factor activity	 23	0.00234981333400812	0.465654675689275	9	14	902	5664	2.83019138070921
GO:0017119	Golgi transport complex	  8	1	1	0	8	911	5670	0
GO:0017124	SH3 domain binding	 65	0.813463020479952	1	7	58	904	5620	0.778907371443047
GO:0017128	phospholipid scramblase activity	  5	1	1	0	5	911	5673	0
GO:0017134	fibroblast growth factor binding	 10	0.411940837929264	1	2	8	909	5670	1.44654226125137
GO:0017137	Rab GTPase binding	 61	0.0705706354261833	1	13	48	898	5630	1.54139749149736
GO:0017145	stem cell division	  5	0.524912504930412	1	1	4	910	5674	1.44654226125137
GO:0017146	NMDA selective glutamate receptor complex	  6	1	1	0	6	911	5672	0
GO:0017147	Wnt-protein binding	 16	0.907797453739348	1	1	15	910	5663	0.452044456641054
GO:0017148	negative regulation of translation	 37	0.243970680561519	1	7	30	904	5648	1.36835078767022
GO:0017154	semaphorin receptor activity	  5	1	1	0	5	911	5673	0
GO:0017156	calcium ion regulated exocytosis	 13	0.855768388602616	1	1	12	910	5666	0.556362408173605
GO:0017157	regulation of exocytosis	 20	0.536209630921365	1	3	17	908	5661	1.08490669593853
GO:0017158	regulation of calcium ion-dependent exocytosis	 11	0.462079859473656	1	2	9	909	5669	1.31503841931943
GO:0017160	Ral GTPase binding	 10	0.774429434347452	1	1	9	910	5669	0.723271130625686
GO:0018022	peptidyl-lysine methylation	  5	0.143519565197953	1	2	3	909	5675	2.89308452250274
GO:0018024	histone-lysine N-methyltransferase activity	 16	0.170377804997621	1	4	12	907	5666	1.80817782656422
GO:0018105	peptidyl-serine phosphorylation	 81	0.222867459834863	1	14	67	897	5611	1.25009825046415
GO:0018107	peptidyl-threonine phosphorylation	 40	0.665604476062232	1	5	35	906	5643	0.904088913282108
GO:0018108	peptidyl-tyrosine phosphorylation	 70	0.645976191113237	1	9	61	902	5617	0.929920025090168
GO:0018146	keratan sulfate biosynthetic process	 11	0.186315240979503	1	3	8	908	5670	1.97255762897914
GO:0018149	peptide cross-linking	  8	0.696113996849696	1	1	7	910	5671	0.904088913282108
GO:0018230	peptidyl-L-cysteine S-palmitoylation	  5	1	1	0	5	911	5673	0
GO:0018279	protein N-linked glycosylation via asparagine	 19	0.500137274055772	1	3	16	908	5662	1.14200704835635
GO:0018344	protein geranylgeranylation	  5	0.524912504930412	1	1	4	910	5674	1.44654226125137
GO:0018345	protein palmitoylation	  8	0.696113996849696	1	1	7	910	5671	0.904088913282108
GO:0019001	guanyl nucleotide binding	 10	0.411940837929264	1	2	8	909	5670	1.44654226125137
GO:0019003	GDP binding	 38	0.266290250849306	1	7	31	904	5647	1.33234155641574
GO:0019005	SCF ubiquitin ligase complex	 21	0.328967927753839	1	4	17	907	5661	1.37765929642988
GO:0019013	viral nucleocapsid	 14	0.303988344911165	1	3	11	908	5667	1.54986670848361
GO:0019058	viral life cycle	 14	0.875749379780082	1	1	13	910	5665	0.516622236161204
GO:0019079	viral genome replication	  8	0.0862825209590832	1	3	5	908	5673	2.71226673984632
GO:0019083	viral transcription	 23	0.847425382793578	1	2	21	909	5657	0.628931417935379
GO:0019208	phosphatase regulator activity	  5	1	1	0	5	911	5673	0
GO:0019213	deacetylase activity	  5	0.143519565197953	1	2	3	909	5675	2.89308452250274
GO:0019216	regulation of lipid metabolic process	 43	0.130481053020641	1	9	34	902	5644	1.51382329665841
GO:0019221	cytokine-mediated signaling pathway	 58	0.91852867905015	1	5	53	906	5625	0.623509595366971
GO:0019226	transmission of nerve impulse	  9	0.738180574705634	1	1	8	910	5670	0.803634589584096
GO:0019227	neuronal action potential propagation	  5	0.524912504930412	1	1	4	910	5674	1.44654226125137
GO:0019228	neuronal action potential	 15	1	1	0	15	911	5663	0
GO:0019229	regulation of vasoconstriction	  7	1	1	0	7	911	5671	0
GO:0019233	sensory perception of pain	 26	0.979283024427103	1	1	25	910	5653	0.278181204086802
GO:0019367	fatty acid elongation, saturated fatty acid	  5	0.143519565197953	1	2	3	909	5675	2.89308452250274
GO:0019369	arachidonic acid metabolic process	  8	0.696113996849696	1	1	7	910	5671	0.904088913282108
GO:0019370	leukotriene biosynthetic process	  5	1	1	0	5	911	5673	0
GO:0019371	cyclooxygenase pathway	  7	0.647297183435849	1	1	6	910	5672	1.03324447232241
GO:0019430	removal of superoxide radicals	  7	0.647297183435849	1	1	6	910	5672	1.03324447232241
GO:0019433	triglyceride catabolic process	 10	1	1	0	10	911	5668	0
GO:0019538	protein metabolic process	  5	1	1	0	5	911	5673	0
GO:0019674	NAD metabolic process	  8	0.696113996849696	1	1	7	910	5671	0.904088913282108
GO:0019706	protein-cysteine S-palmitoyltransferase activity	 12	0.832578307772574	1	1	11	910	5667	0.602725942188072
GO:0019722	calcium-mediated signaling	 23	1	1	0	23	911	5655	0
GO:0019725	cellular homeostasis	  9	1	1	0	9	911	5669	0
GO:0019730	antimicrobial humoral response	 14	0.875749379780082	1	1	13	910	5665	0.516622236161204
GO:0019731	antibacterial humoral response	  8	0.696113996849696	1	1	7	910	5671	0.904088913282108
GO:0019752	carboxylic acid metabolic process	  6	0.19623335243315	1	2	4	909	5674	2.41090376875229
GO:0019789	SUMO transferase activity	  6	0.590648335429865	1	1	5	910	5673	1.20545188437614
GO:0019825	oxygen binding	  7	0.647297183435849	1	1	6	910	5672	1.03324447232241
GO:0019827	stem cell population maintenance	 27	0.314618865714415	1	5	22	906	5656	1.33939098264016
GO:0019829	cation-transporting ATPase activity	  5	1	1	0	5	911	5673	0
GO:0019835	cytolysis	  5	1	1	0	5	911	5673	0
GO:0019838	growth factor binding	 24	1	1	0	24	911	5654	0
GO:0019841	retinol binding	  5	1	1	0	5	911	5673	0
GO:0019843	rRNA binding	 10	0.411940837929264	1	2	8	909	5670	1.44654226125137
GO:0019855	calcium channel inhibitor activity	  5	0.143519565197953	1	2	3	909	5675	2.89308452250274
GO:0019869	chloride channel inhibitor activity	  6	0.590648335429865	1	1	5	910	5673	1.20545188437614
GO:0019882	antigen processing and presentation	 20	0.536209630921365	1	3	17	908	5661	1.08490669593853
GO:0019886	antigen processing and presentation of exogenous peptide antigen via MHC class II	 50	0.707689588448099	1	6	44	905	5634	0.867925356750823
GO:0019888	protein phosphatase regulator activity	 26	0.493270603294985	1	4	22	907	5656	1.11272481634721
GO:0019894	kinesin binding	 28	0.554462782906824	1	4	24	907	5654	1.03324447232241
GO:0019897	extrinsic component of plasma membrane	  7	0.647297183435849	1	1	6	910	5672	1.03324447232241
GO:0019898	extrinsic component of membrane	 33	0.48780477781979	1	5	28	906	5650	1.09586534943286
GO:0019900	kinase binding	 55	0.347584212543492	1	9	46	902	5632	1.18353457738749
GO:0019902	phosphatase binding	 20	0.131823772311556	1	5	15	906	5663	1.80817782656422
GO:0019903	protein phosphatase binding	 32	0.459558348788714	1	5	27	906	5651	1.13011114160263
GO:0019905	syntaxin binding	 42	0.359844906684757	1	7	35	904	5643	1.20545188437614
GO:0019911	structural constituent of myelin sheath	  6	1	1	0	6	911	5672	0
GO:0019915	lipid storage	  8	0.696113996849696	1	1	7	910	5671	0.904088913282108
GO:0019919	peptidyl-arginine methylation, to asymmetrical-dimethyl arginine	  6	0.19623335243315	1	2	4	909	5674	2.41090376875229
GO:0019933	cAMP-mediated signaling	 17	0.199958412567424	1	4	13	907	5665	1.70181442500161
GO:0019955	cytokine binding	  9	1	1	0	9	911	5669	0
GO:0019985	translesion synthesis	 15	0.634731522702541	1	2	13	909	5665	0.964361507500915
GO:0019992	diacylglycerol binding	  6	0.590648335429865	1	1	5	910	5673	1.20545188437614
GO:0020037	heme binding	 38	0.975434512664677	1	2	36	909	5642	0.380669016118782
GO:0021510	spinal cord development	 14	0.875749379780082	1	1	13	910	5665	0.516622236161204
GO:0021522	spinal cord motor neuron differentiation	  6	0.590648335429865	1	1	5	910	5673	1.20545188437614
GO:0021537	telencephalon development	 12	1	1	0	12	911	5666	0
GO:0021542	dentate gyrus development	 11	0.805664391834832	1	1	10	910	5668	0.657519209659715
GO:0021549	cerebellum development	 24	0.664264323067229	1	3	21	908	5657	0.904088913282107
GO:0021591	ventricular system development	 10	1	1	0	10	911	5668	0
GO:0021670	lateral ventricle development	  6	0.590648335429865	1	1	5	910	5673	1.20545188437614
GO:0021680	cerebellar Purkinje cell layer development	  5	0.524912504930412	1	1	4	910	5674	1.44654226125137
GO:0021702	cerebellar Purkinje cell differentiation	  5	1	1	0	5	911	5673	0
GO:0021756	striatum development	 10	0.774429434347452	1	1	9	910	5669	0.723271130625686
GO:0021762	substantia nigra development	 25	0.691930609011909	1	3	22	908	5656	0.867925356750823
GO:0021766	hippocampus development	 38	0.619059057302281	1	5	33	906	5645	0.951672540296955
GO:0021772	olfactory bulb development	 10	0.774429434347452	1	1	9	910	5669	0.723271130625686
GO:0021794	thalamus development	  7	0.647297183435849	1	1	6	910	5672	1.03324447232241
GO:0021795	cerebral cortex cell migration	  7	1	1	0	7	911	5671	0
GO:0021799	cerebral cortex radially oriented cell migration	  5	0.524912504930412	1	1	4	910	5674	1.44654226125137
GO:0021819	layer formation in cerebral cortex	 13	0.554297337812073	1	2	11	909	5667	1.11272481634721
GO:0021854	hypothalamus development	  5	0.524912504930412	1	1	4	910	5674	1.44654226125137
GO:0021860	pyramidal neuron development	  5	1	1	0	5	911	5673	0
GO:0021879	forebrain neuron differentiation	  5	1	1	0	5	911	5673	0
GO:0021895	cerebral cortex neuron differentiation	  6	0.590648335429865	1	1	5	910	5673	1.20545188437614
GO:0021902	commitment of neuronal cell to specific neuron type in forebrain	  5	1	1	0	5	911	5673	0
GO:0021904	dorsal/ventral neural tube patterning	  5	1	1	0	5	911	5673	0
GO:0021915	neural tube development	 23	0.203944604492174	1	5	18	906	5660	1.57232854483845
GO:0021953	central nervous system neuron differentiation	  5	0.524912504930412	1	1	4	910	5674	1.44654226125137
GO:0021954	central nervous system neuron development	  9	0.738180574705634	1	1	8	910	5670	0.803634589584096
GO:0021983	pituitary gland development	  9	0.738180574705634	1	1	8	910	5670	0.803634589584096
GO:0021987	cerebral cortex development	 36	0.051875722969395	1	9	27	902	5651	1.80817782656421
GO:0022008	neurogenesis	 31	0.941131570135982	1	2	29	909	5649	0.466626535887539
GO:0022010	central nervous system myelination	 10	1	1	0	10	911	5668	0
GO:0022011	myelination in peripheral nervous system	  9	0.359581374002193	1	2	7	909	5671	1.60726917916819
GO:0022038	corpus callosum development	  7	1	1	0	7	911	5671	0
GO:0022407	regulation of cell-cell adhesion	  6	1	1	0	6	911	5672	0
GO:0022408	negative regulation of cell-cell adhesion	  7	1	1	0	7	911	5671	0
GO:0022409	positive regulation of cell-cell adhesion	  7	0.647297183435849	1	1	6	910	5672	1.03324447232241
GO:0022417	protein maturation by protein folding	  5	0.524912504930412	1	1	4	910	5674	1.44654226125137
GO:0022604	regulation of cell morphogenesis	 14	0.875749379780082	1	1	13	910	5665	0.516622236161204
GO:0022617	extracellular matrix disassembly	 22	1	1	0	22	911	5656	0
GO:0022624	proteasome accessory complex	  7	1	1	0	7	911	5671	0
GO:0022625	cytosolic large ribosomal subunit	  5	0.524912504930412	1	1	4	910	5674	1.44654226125137
GO:0022627	cytosolic small ribosomal subunit	  6	1	1	0	6	911	5672	0
GO:0022841	potassium ion leak channel activity	  5	0.524912504930412	1	1	4	910	5674	1.44654226125137
GO:0022851	GABA-gated chloride ion channel activity	  5	1	1	0	5	911	5673	0
GO:0022857	transmembrane transporter activity	 32	0.459558348788714	1	5	27	906	5651	1.13011114160263
GO:0022891	substrate-specific transmembrane transporter activity	  7	1	1	0	7	911	5671	0
GO:0022904	respiratory electron transport chain	  8	0.305579489538918	1	2	6	909	5672	1.80817782656422
GO:0023014	signal transduction by protein phosphorylation	 31	0.82259159109624	1	3	28	908	5650	0.699939803831309
GO:0023019	signal transduction involved in regulation of gene expression	  6	1	1	0	6	911	5672	0
GO:0023026	MHC class II protein complex binding	 11	0.186315240979503	1	3	8	908	5670	1.97255762897914
GO:0023041	neuronal signal transduction	  5	0.524912504930412	1	1	4	910	5674	1.44654226125137
GO:0030001	metal ion transport	 13	0.554297337812073	1	2	11	909	5667	1.11272481634721
GO:0030007	cellular potassium ion homeostasis	  9	1	1	0	9	911	5669	0
GO:0030008	TRAPP complex	  7	0.250755247393959	1	2	5	909	5673	2.06648894464482
GO:0030010	establishment of cell polarity	 14	0.596015503295557	1	2	12	909	5666	1.03324447232241
GO:0030014	CCR4-NOT complex	  9	0.359581374002193	1	2	7	909	5671	1.60726917916819
GO:0030015	CCR4-NOT core complex	  5	0.524912504930412	1	1	4	910	5674	1.44654226125137
GO:0030016	myofibril	 12	1	1	0	12	911	5666	0
GO:0030017	sarcomere	 10	0.774429434347452	1	1	9	910	5669	0.723271130625686
GO:0030018	Z disc	 54	0.996952919145837	1	2	52	909	5626	0.267878196528032
GO:0030027	lamellipodium	 75	0.339451864353185	1	12	63	899	5615	1.1572338090011
GO:0030030	cell projection organization	 70	0.508125480302639	1	10	60	901	5618	1.03324447232241
GO:0030032	lamellipodium assembly	 12	0.509611316519668	1	2	10	909	5668	1.20545188437614
GO:0030033	microvillus assembly	  7	1	1	0	7	911	5671	0
GO:0030036	actin cytoskeleton organization	 63	0.0457837192212205	1	14	49	897	5629	1.60726917916819
GO:0030041	actin filament polymerization	 13	0.263838199411443	1	3	10	908	5668	1.66908722452081
GO:0030042	actin filament depolymerization	  6	1	1	0	6	911	5672	0
GO:0030049	muscle filament sliding	  7	1	1	0	7	911	5671	0
GO:0030050	vesicle transport along actin filament	  5	0.524912504930412	1	1	4	910	5674	1.44654226125137
GO:0030056	hemidesmosome	  5	1	1	0	5	911	5673	0
GO:0030057	desmosome	  8	0.305579489538918	1	2	6	909	5672	1.80817782656422
GO:0030073	insulin secretion	 18	0.462686108033741	1	3	15	908	5663	1.20545188437614
GO:0030097	hemopoiesis	 41	0.687432825360142	1	5	36	906	5642	0.882037964177666
GO:0030099	myeloid cell differentiation	 12	1	1	0	12	911	5666	0
GO:0030100	regulation of endocytosis	 16	0.670477249908291	1	2	14	909	5664	0.904088913282108
GO:0030111	regulation of Wnt signaling pathway	 11	0.462079859473656	1	2	9	909	5669	1.31503841931943
GO:0030117	membrane coat	 16	0.907797453739348	1	1	15	910	5663	0.452044456641054
GO:0030118	clathrin coat	  5	0.524912504930412	1	1	4	910	5674	1.44654226125137
GO:0030122	AP-2 adaptor complex	 12	0.509611316519668	1	2	10	909	5668	1.20545188437614
GO:0030131	clathrin adaptor complex	 10	1	1	0	10	911	5668	0
GO:0030132	clathrin coat of coated pit	  5	0.524912504930412	1	1	4	910	5674	1.44654226125137
GO:0030133	transport vesicle	 49	0.826808965729871	1	5	44	906	5634	0.738031765944578
GO:0030134	COPII-coated ER to Golgi transport vesicle	 17	0.920576476962146	1	1	16	910	5662	0.425453606250404
GO:0030136	clathrin-coated vesicle	 28	0.181275299679347	1	6	22	905	5656	1.54986670848361
GO:0030137	COPI-coated vesicle	  6	1	1	0	6	911	5672	0
GO:0030139	endocytic vesicle	 28	0.915282449919722	1	2	26	909	5652	0.516622236161204
GO:0030140	trans-Golgi network transport vesicle	  9	0.738180574705634	1	1	8	910	5670	0.803634589584096
GO:0030141	secretory granule	 43	0.383808864829202	1	7	36	904	5642	1.17741811962321
GO:0030145	manganese ion binding	 30	0.401898545597323	1	5	25	906	5653	1.20545188437614
GO:0030148	sphingolipid biosynthetic process	 29	0.58353593328048	1	4	25	907	5653	0.997615352587153
GO:0030150	protein import into mitochondrial matrix	  8	0.305579489538918	1	2	6	909	5672	1.80817782656422
GO:0030155	regulation of cell adhesion	 18	0.462686108033741	1	3	15	908	5663	1.20545188437614
GO:0030159	receptor signaling complex scaffold activity	  7	1	1	0	7	911	5671	0
GO:0030162	regulation of proteolysis	  7	1	1	0	7	911	5671	0
GO:0030163	protein catabolic process	 15	0.344361377150163	1	3	12	908	5666	1.44654226125137
GO:0030165	PDZ domain binding	 45	0.886756904660023	1	4	41	907	5637	0.642907671667276
GO:0030168	platelet activation	 52	0.941935059332443	1	4	48	907	5630	0.556362408173605
GO:0030169	low-density lipoprotein particle binding	  5	1	1	0	5	911	5673	0
GO:0030170	pyridoxal phosphate binding	 22	0.0244427835700898	1	7	15	904	5663	2.301317233809
GO:0030173	integral component of Golgi membrane	 20	0.131823772311556	1	5	15	906	5663	1.80817782656422
GO:0030175	filopodium	 44	0.988631854846284	1	2	42	909	5636	0.328759604829857
GO:0030176	integral component of endoplasmic reticulum membrane	 41	0.19777317257507	1	8	33	903	5645	1.41126074268427
GO:0030177	positive regulation of Wnt signaling pathway	 18	0.230920507298425	1	4	14	907	5664	1.60726917916819
GO:0030178	negative regulation of Wnt signaling pathway	 19	0.760858269222929	1	2	17	909	5661	0.761338032237564
GO:0030182	neuron differentiation	 54	0.952413529074841	1	4	50	907	5628	0.535756393056064
GO:0030183	B cell differentiation	 15	0.892964940999907	1	1	14	910	5664	0.482180753750457
GO:0030193	regulation of blood coagulation	  7	1	1	0	7	911	5671	0
GO:0030195	negative regulation of blood coagulation	  7	1	1	0	7	911	5671	0
GO:0030198	extracellular matrix organization	 87	0.867516643613361	1	9	78	902	5600	0.748211514440365
GO:0030199	collagen fibril organization	 24	0.428813160555296	1	4	20	907	5658	1.20545188437614
GO:0030203	glycosaminoglycan metabolic process	 12	0.0719932411872323	1	4	8	907	5670	2.41090376875229
GO:0030206	chondroitin sulfate biosynthetic process	 13	0.0930371570174248	1	4	9	907	5669	2.22544963269442
GO:0030207	chondroitin sulfate catabolic process	  6	0.0380919907275585	1	3	3	908	5675	3.61635565312843
GO:0030208	dermatan sulfate biosynthetic process	  9	0.116572893917459	1	3	6	908	5672	2.41090376875229
GO:0030214	hyaluronan catabolic process	  6	1	1	0	6	911	5672	0
GO:0030215	semaphorin receptor binding	  7	1	1	0	7	911	5671	0
GO:0030216	keratinocyte differentiation	 16	0.670477249908291	1	2	14	909	5664	0.904088913282108
GO:0030217	T cell differentiation	 10	1	1	0	10	911	5668	0
GO:0030218	erythrocyte differentiation	 18	0.931586037139791	1	1	17	910	5661	0.401817294792048
GO:0030220	platelet formation	  7	0.647297183435849	1	1	6	910	5672	1.03324447232241
GO:0030224	monocyte differentiation	 10	1	1	0	10	911	5668	0
GO:0030225	macrophage differentiation	  7	0.647297183435849	1	1	6	910	5672	1.03324447232241
GO:0030234	enzyme regulator activity	  8	0.696113996849696	1	1	7	910	5671	0.904088913282108
GO:0030246	carbohydrate binding	 55	0.65296736456532	1	7	48	904	5630	0.9205268935236
GO:0030276	clathrin binding	 24	0.664264323067229	1	3	21	908	5657	0.904088913282107
GO:0030279	negative regulation of ossification	  9	0.738180574705634	1	1	8	910	5670	0.803634589584096
GO:0030282	bone mineralization	 12	1	1	0	12	911	5666	0
GO:0030285	integral component of synaptic vesicle membrane	 13	1	1	0	13	911	5665	0
GO:0030286	dynein complex	 16	0.670477249908291	1	2	14	909	5664	0.904088913282108
GO:0030295	protein kinase activator activity	 10	0.774429434347452	1	1	9	910	5669	0.723271130625686
GO:0030297	transmembrane receptor protein tyrosine kinase activator activity	  5	0.524912504930412	1	1	4	910	5674	1.44654226125137
GO:0030301	cholesterol transport	  6	1	1	0	6	911	5672	0
GO:0030307	positive regulation of cell growth	 36	0.753259008988217	1	4	32	907	5646	0.803634589584096
GO:0030308	negative regulation of cell growth	 55	0.347584212543492	1	9	46	902	5632	1.18353457738749
GO:0030315	T-tubule	 27	0.982158716145358	1	1	26	910	5652	0.267878196528032
GO:0030316	osteoclast differentiation	 10	0.411940837929264	1	2	8	909	5670	1.44654226125137
GO:0030317	flagellated sperm motility	 14	0.875749379780082	1	1	13	910	5665	0.516622236161204
GO:0030318	melanocyte differentiation	 13	0.554297337812073	1	2	11	909	5667	1.11272481634721
GO:0030322	stabilization of membrane potential	  5	0.524912504930412	1	1	4	910	5674	1.44654226125137
GO:0030324	lung development	 39	0.921150755893196	1	3	36	908	5642	0.556362408173605
GO:0030325	adrenal gland development	  7	0.250755247393959	1	2	5	909	5673	2.06648894464482
GO:0030326	embryonic limb morphogenesis	 20	0.785819229034214	1	2	18	909	5660	0.723271130625686
GO:0030330	DNA damage response, signal transduction by p53 class mediator	  7	1	1	0	7	911	5671	0
GO:0030331	estrogen receptor binding	 17	0.703333082174572	1	2	15	909	5663	0.850907212500807
GO:0030332	cyclin binding	 10	0.411940837929264	1	2	8	909	5670	1.44654226125137
GO:0030334	regulation of cell migration	 32	0.663761033636311	1	4	28	907	5650	0.904088913282108
GO:0030335	positive regulation of cell migration	 88	0.568108558489125	1	12	76	899	5602	0.986278814489572
GO:0030336	negative regulation of cell migration	 53	0.760242543249861	1	6	47	905	5631	0.818797506368701
GO:0030371	translation repressor activity	  7	0.250755247393959	1	2	5	909	5673	2.06648894464482
GO:0030374	ligand-dependent nuclear receptor transcription coactivator activity	 23	0.847425382793578	1	2	21	909	5657	0.628931417935379
GO:0030414	peptidase inhibitor activity	 29	0.986768971826501	1	1	28	910	5650	0.249403838146788
GO:0030422	production of siRNA involved in RNA interference	  5	0.524912504930412	1	1	4	910	5674	1.44654226125137
GO:0030426	growth cone	 74	0.135306770131527	1	14	60	897	5618	1.36835078767022
GO:0030431	sleep	  6	0.590648335429865	1	1	5	910	5673	1.20545188437614
GO:0030433	ubiquitin-dependent ERAD pathway	 30	0.227040830442229	1	6	24	905	5654	1.44654226125137
GO:0030449	regulation of complement activation	 17	1	1	0	17	911	5661	0
GO:0030488	tRNA methylation	 14	0.00766481299034421	0.780954774083801	6	8	905	5670	3.09973341696723
GO:0030490	maturation of SSU-rRNA	  5	0.524912504930412	1	1	4	910	5674	1.44654226125137
GO:0030496	midbody	 72	0.0648853003917484	1	15	57	896	5621	1.50681485547018
GO:0030500	regulation of bone mineralization	 10	0.411940837929264	1	2	8	909	5670	1.44654226125137
GO:0030501	positive regulation of bone mineralization	 16	0.907797453739348	1	1	15	910	5663	0.452044456641054
GO:0030502	negative regulation of bone mineralization	  7	0.647297183435849	1	1	6	910	5672	1.03324447232241
GO:0030506	ankyrin binding	  7	0.250755247393959	1	2	5	909	5673	2.06648894464482
GO:0030507	spectrin binding	 15	1	1	0	15	911	5663	0
GO:0030509	BMP signaling pathway	 40	0.179414753986984	1	8	32	903	5646	1.44654226125137
GO:0030511	positive regulation of transforming growth factor beta receptor signaling pathway	 13	0.0930371570174248	1	4	9	907	5669	2.22544963269442
GO:0030512	negative regulation of transforming growth factor beta receptor signaling pathway	 36	0.568883529889198	1	5	31	906	5647	1.00454323698012
GO:0030513	positive regulation of BMP signaling pathway	 17	0.703333082174572	1	2	15	909	5663	0.850907212500807
GO:0030514	negative regulation of BMP signaling pathway	 22	0.178553616091294	1	5	17	906	5661	1.64379802414929
GO:0030515	snoRNA binding	  8	1	1	0	8	911	5670	0
GO:0030516	regulation of axon extension	  7	0.250755247393959	1	2	5	909	5673	2.06648894464482
GO:0030517	negative regulation of axon extension	  7	0.647297183435849	1	1	6	910	5672	1.03324447232241
GO:0030518	intracellular steroid hormone receptor signaling pathway	  8	0.696113996849696	1	1	7	910	5671	0.904088913282108
GO:0030520	intracellular estrogen receptor signaling pathway	  6	1	1	0	6	911	5672	0
GO:0030521	androgen receptor signaling pathway	 24	0.864076388223246	1	2	22	909	5656	0.602725942188072
GO:0030522	intracellular receptor signaling pathway	 14	0.303988344911165	1	3	11	908	5667	1.54986670848361
GO:0030532	small nuclear ribonucleoprotein complex	  7	0.647297183435849	1	1	6	910	5672	1.03324447232241
GO:0030534	adult behavior	 17	0.703333082174572	1	2	15	909	5663	0.850907212500807
GO:0030539	male genitalia development	  5	0.524912504930412	1	1	4	910	5674	1.44654226125137
GO:0030544	Hsp70 protein binding	 16	0.670477249908291	1	2	14	909	5664	0.904088913282108
GO:0030552	cAMP binding	 13	0.554297337812073	1	2	11	909	5667	1.11272481634721
GO:0030553	cGMP binding	  5	1	1	0	5	911	5673	0
GO:0030574	collagen catabolic process	 23	0.634832927753238	1	3	20	908	5658	0.943397126903069
GO:0030593	neutrophil chemotaxis	 18	1	1	0	18	911	5660	0
GO:0030658	transport vesicle membrane	 25	0.257846566237795	1	5	20	906	5658	1.44654226125137
GO:0030659	cytoplasmic vesicle membrane	 84	0.95625331745804	1	7	77	904	5601	0.602725942188072
GO:0030660	Golgi-associated vesicle membrane	  9	0.116572893917459	1	3	6	908	5672	2.41090376875229
GO:0030665	clathrin-coated vesicle membrane	 25	0.879045586415537	1	2	23	909	5655	0.578616904500549
GO:0030666	endocytic vesicle membrane	 35	0.732772844643882	1	4	31	907	5647	0.826595577857927
GO:0030667	secretory granule membrane	 47	0.905974344950422	1	4	43	907	5635	0.615549898404839
GO:0030669	clathrin-coated endocytic vesicle membrane	 23	0.847425382793578	1	2	21	909	5657	0.628931417935379
GO:0030670	phagocytic vesicle membrane	 41	0.983253149158224	1	2	39	909	5639	0.352815185671066
GO:0030672	synaptic vesicle membrane	 44	0.581057099765452	1	6	38	905	5640	0.986278814489572
GO:0030673	axolemma	 10	1	1	0	10	911	5668	0
GO:0030674	protein binding, bridging	 31	0.638235698030361	1	4	27	907	5651	0.933253071775079
GO:0030676	Rac guanyl-nucleotide exchange factor activity	  9	0.738180574705634	1	1	8	910	5670	0.803634589584096
GO:0030687	preribosome, large subunit precursor	  6	0.590648335429865	1	1	5	910	5673	1.20545188437614
GO:0030695	GTPase regulator activity	 10	0.0382414370390818	1	4	6	907	5672	2.89308452250274
GO:0030705	cytoskeleton-dependent intracellular transport	 13	0.855768388602616	1	1	12	910	5666	0.556362408173605
GO:0030742	GTP-dependent protein binding	 11	0.186315240979503	1	3	8	908	5670	1.97255762897914
GO:0030816	positive regulation of cAMP metabolic process	  6	1	1	0	6	911	5672	0
GO:0030818	negative regulation of cAMP biosynthetic process	  6	1	1	0	6	911	5672	0
GO:0030819	positive regulation of cAMP biosynthetic process	 16	0.384511432262289	1	3	13	908	5665	1.35613336992316
GO:0030828	positive regulation of cGMP biosynthetic process	  5	1	1	0	5	911	5673	0
GO:0030833	regulation of actin filament polymerization	 10	1	1	0	10	911	5668	0
GO:0030837	negative regulation of actin filament polymerization	  9	0.738180574705634	1	1	8	910	5670	0.803634589584096
GO:0030838	positive regulation of actin filament polymerization	 19	0.262946555916241	1	4	15	907	5663	1.52267606447513
GO:0030850	prostate gland development	  5	0.524912504930412	1	1	4	910	5674	1.44654226125137
GO:0030855	epithelial cell differentiation	 29	0.58353593328048	1	4	25	907	5653	0.997615352587153
GO:0030856	regulation of epithelial cell differentiation	  5	0.524912504930412	1	1	4	910	5674	1.44654226125137
GO:0030857	negative regulation of epithelial cell differentiation	  5	0.143519565197953	1	2	3	909	5675	2.89308452250274
GO:0030863	cortical cytoskeleton	  9	0.359581374002193	1	2	7	909	5671	1.60726917916819
GO:0030864	cortical actin cytoskeleton	 19	0.262946555916241	1	4	15	907	5663	1.52267606447513
GO:0030866	cortical actin cytoskeleton organization	 13	1	1	0	13	911	5665	0
GO:0030877	beta-catenin destruction complex	  6	1	1	0	6	911	5672	0
GO:0030879	mammary gland development	 16	0.170377804997621	1	4	12	907	5666	1.80817782656422
GO:0030889	negative regulation of B cell proliferation	  8	1	1	0	8	911	5670	0
GO:0030890	positive regulation of B cell proliferation	 13	0.855768388602616	1	1	12	910	5666	0.556362408173605
GO:0030897	HOPS complex	  5	1	1	0	5	911	5673	0
GO:0030900	forebrain development	 36	0.379355854827396	1	6	30	905	5648	1.20545188437614
GO:0030901	midbrain development	 14	0.875749379780082	1	1	13	910	5665	0.516622236161204
GO:0030902	hindbrain development	 11	1	1	0	11	911	5667	0
GO:0030904	retromer complex	 11	0.462079859473656	1	2	9	909	5669	1.31503841931943
GO:0030911	TPR domain binding	  5	1	1	0	5	911	5673	0
GO:0030913	paranodal junction assembly	  6	1	1	0	6	911	5672	0
GO:0030914	STAGA complex	  5	0.524912504930412	1	1	4	910	5674	1.44654226125137
GO:0030948	negative regulation of vascular endothelial growth factor receptor signaling pathway	  5	0.143519565197953	1	2	3	909	5675	2.89308452250274
GO:0030949	positive regulation of vascular endothelial growth factor receptor signaling pathway	  5	1	1	0	5	911	5673	0
GO:0030955	potassium ion binding	  6	0.19623335243315	1	2	4	909	5674	2.41090376875229
GO:0030957	Tat protein binding	  6	0.590648335429865	1	1	5	910	5673	1.20545188437614
GO:0030968	endoplasmic reticulum unfolded protein response	 19	0.0104708041198931	0.822910375966763	7	12	904	5666	2.66468311283147
GO:0030970	retrograde protein transport, ER to cytosol	  5	0.524912504930412	1	1	4	910	5674	1.44654226125137
GO:0030971	receptor tyrosine kinase binding	 27	0.314618865714415	1	5	22	906	5656	1.33939098264016
GO:0030983	mismatched DNA binding	  5	0.524912504930412	1	1	4	910	5674	1.44654226125137
GO:0030992	intraciliary transport particle B	 10	1	1	0	10	911	5668	0
GO:0031000	response to caffeine	  5	1	1	0	5	911	5673	0
GO:0031005	filamin binding	  5	0.143519565197953	1	2	3	909	5675	2.89308452250274
GO:0031016	pancreas development	  9	0.359581374002193	1	2	7	909	5671	1.60726917916819
GO:0031018	endocrine pancreas development	  9	0.116572893917459	1	3	6	908	5672	2.41090376875229
GO:0031023	microtubule organizing center organization	  7	0.250755247393959	1	2	5	909	5673	2.06648894464482
GO:0031032	actomyosin structure organization	 12	1	1	0	12	911	5666	0
GO:0031045	dense core granule	 10	0.774429434347452	1	1	9	910	5669	0.723271130625686
GO:0031047	gene silencing by RNA	 23	0.395750956840956	1	4	19	907	5659	1.25786283587076
GO:0031053	primary miRNA processing	  5	0.524912504930412	1	1	4	910	5674	1.44654226125137
GO:0031054	pre-miRNA processing	  7	0.647297183435849	1	1	6	910	5672	1.03324447232241
GO:0031065	positive regulation of histone deacetylation	  7	0.0599286150311256	1	3	4	908	5674	3.09973341696723
GO:0031069	hair follicle morphogenesis	 11	0.462079859473656	1	2	9	909	5669	1.31503841931943
GO:0031072	heat shock protein binding	 26	0.717842783670638	1	3	23	908	5655	0.834543612260407
GO:0031076	embryonic camera-type eye development	  6	1	1	0	6	911	5672	0
GO:0031080	nuclear pore outer ring	  5	0.143519565197953	1	2	3	909	5675	2.89308452250274
GO:0031089	platelet dense granule lumen	  5	0.524912504930412	1	1	4	910	5674	1.44654226125137
GO:0031090	organelle membrane	 35	0.0170563138325251	1	10	25	901	5653	2.06648894464482
GO:0031091	platelet alpha granule	  7	1	1	0	7	911	5671	0
GO:0031092	platelet alpha granule membrane	 10	0.774429434347452	1	1	9	910	5669	0.723271130625686
GO:0031093	platelet alpha granule lumen	 33	0.854121486059169	1	3	30	908	5648	0.657519209659715
GO:0031095	platelet dense tubular network membrane	  6	0.590648335429865	1	1	5	910	5673	1.20545188437614
GO:0031098	stress-activated protein kinase signaling cascade	 12	0.832578307772574	1	1	11	910	5667	0.602725942188072
GO:0031100	animal organ regeneration	 22	0.0244427835700898	1	7	15	904	5663	2.301317233809
GO:0031103	axon regeneration	  8	1	1	0	8	911	5670	0
GO:0031110	regulation of microtubule polymerization or depolymerization	  6	1	1	0	6	911	5672	0
GO:0031115	negative regulation of microtubule polymerization	  5	0.524912504930412	1	1	4	910	5674	1.44654226125137
GO:0031116	positive regulation of microtubule polymerization	  8	1	1	0	8	911	5670	0
GO:0031122	cytoplasmic microtubule organization	 18	0.733413953942175	1	2	16	909	5662	0.803634589584096
GO:0031124	mRNA 3	 26	0.139727506940132	1	6	20	905	5658	1.66908722452081
GO:0031143	pseudopodium	  7	1	1	0	7	911	5671	0
GO:0031145	anaphase-promoting complex-dependent catabolic process	 27	0.74203057279193	1	3	24	908	5654	0.803634589584096
GO:0031146	SCF-dependent proteasomal ubiquitin-dependent protein catabolic process	 27	0.159915810494805	1	6	21	905	5657	1.60726917916819
GO:0031167	rRNA methylation	  5	0.524912504930412	1	1	4	910	5674	1.44654226125137
GO:0031175	neuron projection development	 70	0.508125480302639	1	10	60	901	5618	1.03324447232241
GO:0031201	SNARE complex	 33	0.161896669904934	1	7	26	904	5652	1.534211489206
GO:0031209	SCAR complex	  5	0.524912504930412	1	1	4	910	5674	1.44654226125137
GO:0031210	phosphatidylcholine binding	  7	0.647297183435849	1	1	6	910	5672	1.03324447232241
GO:0031214	biomineral tissue development	  8	1	1	0	8	911	5670	0
GO:0031224	intrinsic component of membrane	  6	0.19623335243315	1	2	4	909	5674	2.41090376875229
GO:0031225	anchored component of membrane	 52	0.981371466663216	1	3	49	908	5629	0.417271806130203
GO:0031226	intrinsic component of plasma membrane	 20	0.949242054403644	1	1	19	910	5659	0.361635565312843
GO:0031234	extrinsic component of cytoplasmic side of plasma membrane	 33	0.301378346214684	1	6	27	905	5651	1.31503841931943
GO:0031235	intrinsic component of the cytoplasmic side of the plasma membrane	  8	0.0862825209590832	1	3	5	908	5673	2.71226673984632
GO:0031252	cell leading edge	 29	0.785423643074026	1	3	26	908	5652	0.748211514440365
GO:0031253	cell projection membrane	  5	0.524912504930412	1	1	4	910	5674	1.44654226125137
GO:0031258	lamellipodium membrane	  8	0.696113996849696	1	1	7	910	5671	0.904088913282108
GO:0031267	small GTPase binding	  8	0.696113996849696	1	1	7	910	5671	0.904088913282108
GO:0031284	positive regulation of guanylate cyclase activity	  5	1	1	0	5	911	5673	0
GO:0031290	retinal ganglion cell axon guidance	  9	0.359581374002193	1	2	7	909	5671	1.60726917916819
GO:0031293	membrane protein intracellular domain proteolysis	  7	1	1	0	7	911	5671	0
GO:0031295	T cell costimulation	 23	0.847425382793578	1	2	21	909	5657	0.628931417935379
GO:0031297	replication fork processing	  8	1	1	0	8	911	5670	0
GO:0031305	integral component of mitochondrial inner membrane	 11	0.0112141673759239	0.822910375966763	5	6	906	5672	3.28759604829857
GO:0031307	integral component of mitochondrial outer membrane	 10	0.411940837929264	1	2	8	909	5670	1.44654226125137
GO:0031333	negative regulation of protein complex assembly	 11	0.805664391834832	1	1	10	910	5668	0.657519209659715
GO:0031334	positive regulation of protein complex assembly	 12	0.832578307772574	1	1	11	910	5667	0.602725942188072
GO:0031338	regulation of vesicle fusion	 14	0.875749379780082	1	1	13	910	5665	0.516622236161204
GO:0031340	positive regulation of vesicle fusion	  7	0.647297183435849	1	1	6	910	5672	1.03324447232241
GO:0031362	anchored component of external side of plasma membrane	  9	0.738180574705634	1	1	8	910	5670	0.803634589584096
GO:0031369	translation initiation factor binding	 11	1	1	0	11	911	5667	0
GO:0031396	regulation of protein ubiquitination	  8	0.696113996849696	1	1	7	910	5671	0.904088913282108
GO:0031397	negative regulation of protein ubiquitination	 26	0.493270603294985	1	4	22	907	5656	1.11272481634721
GO:0031398	positive regulation of protein ubiquitination	 29	0.58353593328048	1	4	25	907	5653	0.997615352587153
GO:0031402	sodium ion binding	  5	0.524912504930412	1	1	4	910	5674	1.44654226125137
GO:0031418	L-ascorbic acid binding	  8	1	1	0	8	911	5670	0
GO:0031424	keratinization	  9	0.359581374002193	1	2	7	909	5671	1.60726917916819
GO:0031430	M band	 11	0.805664391834832	1	1	10	910	5668	0.657519209659715
GO:0031434	mitogen-activated protein kinase kinase binding	  9	1	1	0	9	911	5669	0
GO:0031435	mitogen-activated protein kinase kinase kinase binding	 10	0.774429434347452	1	1	9	910	5669	0.723271130625686
GO:0031461	cullin-RING ubiquitin ligase complex	  9	1	1	0	9	911	5669	0
GO:0031462	Cul2-RING ubiquitin ligase complex	  6	0.590648335429865	1	1	5	910	5673	1.20545188437614
GO:0031463	Cul3-RING ubiquitin ligase complex	 23	0.634832927753238	1	3	20	908	5658	0.943397126903069
GO:0031464	Cul4A-RING E3 ubiquitin ligase complex	  5	1	1	0	5	911	5673	0
GO:0031489	myosin V binding	 11	0.186315240979503	1	3	8	908	5670	1.97255762897914
GO:0031490	chromatin DNA binding	 21	0.570749914782619	1	3	18	908	5660	1.03324447232241
GO:0031491	nucleosome binding	 10	0.411940837929264	1	2	8	909	5670	1.44654226125137
GO:0031492	nucleosomal DNA binding	 14	0.875749379780082	1	1	13	910	5665	0.516622236161204
GO:0031514	motile cilium	 28	0.343606597461169	1	5	23	906	5655	1.29155559040301
GO:0031519	PcG protein complex	 11	0.186315240979503	1	3	8	908	5670	1.97255762897914
GO:0031526	brush border membrane	 17	1	1	0	17	911	5661	0
GO:0031527	filopodium membrane	  8	1	1	0	8	911	5670	0
GO:0031528	microvillus membrane	  7	1	1	0	7	911	5671	0
GO:0031529	ruffle organization	  5	1	1	0	5	911	5673	0
GO:0031532	actin cytoskeleton reorganization	 25	0.879045586415537	1	2	23	909	5655	0.578616904500549
GO:0031572	G2 DNA damage checkpoint	  8	1	1	0	8	911	5670	0
GO:0031584	activation of phospholipase D activity	  5	0.143519565197953	1	2	3	909	5675	2.89308452250274
GO:0031588	nucleotide-activated protein kinase complex	  7	0.647297183435849	1	1	6	910	5672	1.03324447232241
GO:0031589	cell-substrate adhesion	 11	1	1	0	11	911	5667	0
GO:0031593	polyubiquitin modification-dependent protein binding	 13	0.554297337812073	1	2	11	909	5667	1.11272481634721
GO:0031594	neuromuscular junction	 35	0.994606883986491	1	1	34	910	5644	0.206648894464482
GO:0031623	receptor internalization	 29	0.924901620797181	1	2	27	909	5651	0.498807676293577
GO:0031624	ubiquitin conjugating enzyme binding	 21	0.956281251912897	1	1	20	910	5658	0.34441482410747
GO:0031629	synaptic vesicle fusion to presynaptic active zone membrane	  8	0.305579489538918	1	2	6	909	5672	1.80817782656422
GO:0031640	killing of cells of other organism	  7	1	1	0	7	911	5671	0
GO:0031641	regulation of myelination	  6	1	1	0	6	911	5672	0
GO:0031643	positive regulation of myelination	  7	0.647297183435849	1	1	6	910	5672	1.03324447232241
GO:0031647	regulation of protein stability	 23	0.847425382793578	1	2	21	909	5657	0.628931417935379
GO:0031648	protein destabilization	 14	0.0340775514464967	1	5	9	906	5669	2.58311118080602
GO:0031663	lipopolysaccharide-mediated signaling pathway	 15	1	1	0	15	911	5663	0
GO:0031667	response to nutrient levels	 20	0.785819229034214	1	2	18	909	5660	0.723271130625686
GO:0031668	cellular response to extracellular stimulus	 12	0.832578307772574	1	1	11	910	5667	0.602725942188072
GO:0031669	cellular response to nutrient levels	  6	1	1	0	6	911	5672	0
GO:0031672	A band	  5	1	1	0	5	911	5673	0
GO:0031674	I band	 11	1	1	0	11	911	5667	0
GO:0031681	G-protein beta-subunit binding	  5	1	1	0	5	911	5673	0
GO:0031683	G-protein beta/gamma-subunit complex binding	 10	0.774429434347452	1	1	9	910	5669	0.723271130625686
GO:0031702	type 1 angiotensin receptor binding	  8	1	1	0	8	911	5670	0
GO:0031748	D1 dopamine receptor binding	  5	0.524912504930412	1	1	4	910	5674	1.44654226125137
GO:0031901	early endosome membrane	 63	0.948174932751898	1	5	58	906	5620	0.574024706845783
GO:0031902	late endosome membrane	 51	0.97909628931721	1	3	48	908	5630	0.425453606250404
GO:0031904	endosome lumen	  6	0.590648335429865	1	1	5	910	5673	1.20545188437614
GO:0031915	positive regulation of synaptic plasticity	  5	0.143519565197953	1	2	3	909	5675	2.89308452250274
GO:0031929	TOR signaling	  6	0.19623335243315	1	2	4	909	5674	2.41090376875229
GO:0031932	TORC2 complex	  5	0.524912504930412	1	1	4	910	5674	1.44654226125137
GO:0031941	filamentous actin	 11	0.805664391834832	1	1	10	910	5668	0.657519209659715
GO:0031954	positive regulation of protein autophosphorylation	  6	1	1	0	6	911	5672	0
GO:0031966	mitochondrial membrane	 64	0.0255049526956056	1	15	49	896	5629	1.69516671240395
GO:0031982	vesicle	 75	0.832583900704501	1	8	67	903	5611	0.771489206000732
GO:0031985	Golgi cisterna	  7	0.647297183435849	1	1	6	910	5672	1.03324447232241
GO:0031994	insulin-like growth factor I binding	 10	0.411940837929264	1	2	8	909	5670	1.44654226125137
GO:0031995	insulin-like growth factor II binding	  7	0.647297183435849	1	1	6	910	5672	1.03324447232241
GO:0032000	positive regulation of fatty acid beta-oxidation	  5	0.143519565197953	1	2	3	909	5675	2.89308452250274
GO:0032006	regulation of TOR signaling	  5	0.143519565197953	1	2	3	909	5675	2.89308452250274
GO:0032007	negative regulation of TOR signaling	 16	0.170377804997621	1	4	12	907	5666	1.80817782656422
GO:0032008	positive regulation of TOR signaling	 12	0.509611316519668	1	2	10	909	5668	1.20545188437614
GO:0032012	regulation of ARF protein signal transduction	 10	1	1	0	10	911	5668	0
GO:0032024	positive regulation of insulin secretion	 18	0.0915910810089212	1	5	13	906	5665	2.00908647396024
GO:0032026	response to magnesium ion	  6	0.19623335243315	1	2	4	909	5674	2.41090376875229
GO:0032039	integrator complex	  5	1	1	0	5	911	5673	0
GO:0032040	small-subunit processome	  9	1	1	0	9	911	5669	0
GO:0032045	guanyl-nucleotide exchange factor complex	  8	0.305579489538918	1	2	6	909	5672	1.80817782656422
GO:0032051	clathrin light chain binding	  6	0.590648335429865	1	1	5	910	5673	1.20545188437614
GO:0032059	bleb	  5	0.524912504930412	1	1	4	910	5674	1.44654226125137
GO:0032060	bleb assembly	  8	1	1	0	8	911	5670	0
GO:0032088	negative regulation of NF-kappaB transcription factor activity	 30	0.611480146770197	1	4	26	907	5652	0.964361507500915
GO:0032091	negative regulation of protein binding	 30	0.804750698218897	1	3	27	908	5651	0.723271130625686
GO:0032092	positive regulation of protein binding	 31	0.430880175764085	1	5	26	906	5652	1.16656633971885
GO:0032094	response to food	  5	1	1	0	5	911	5673	0
GO:0032147	activation of protein kinase activity	 31	0.82259159109624	1	3	28	908	5650	0.699939803831309
GO:0032148	activation of protein kinase B activity	 13	0.263838199411443	1	3	10	908	5668	1.66908722452081
GO:0032154	cleavage furrow	 26	0.139727506940132	1	6	20	905	5658	1.66908722452081
GO:0032183	SUMO binding	  5	1	1	0	5	911	5673	0
GO:0032201	telomere maintenance via semi-conservative replication	  9	0.359581374002193	1	2	7	909	5671	1.60726917916819
GO:0032204	regulation of telomere maintenance	  6	0.590648335429865	1	1	5	910	5673	1.20545188437614
GO:0032211	negative regulation of telomere maintenance via telomerase	  9	1	1	0	9	911	5669	0
GO:0032212	positive regulation of telomere maintenance via telomerase	 18	0.462686108033741	1	3	15	908	5663	1.20545188437614
GO:0032228	regulation of synaptic transmission, GABAergic	  7	0.647297183435849	1	1	6	910	5672	1.03324447232241
GO:0032230	positive regulation of synaptic transmission, GABAergic	  6	1	1	0	6	911	5672	0
GO:0032233	positive regulation of actin filament bundle assembly	  5	0.524912504930412	1	1	4	910	5674	1.44654226125137
GO:0032259	methylation	 75	0.000346060344501955	0.177264945402662	22	53	889	5625	2.12159531650201
GO:0032266	phosphatidylinositol-3-phosphate binding	 15	0.634731522702541	1	2	13	909	5665	0.964361507500915
GO:0032270	positive regulation of cellular protein metabolic process	  6	1	1	0	6	911	5672	0
GO:0032281	AMPA glutamate receptor complex	 15	1	1	0	15	911	5663	0
GO:0032287	peripheral nervous system myelin maintenance	  5	0.524912504930412	1	1	4	910	5674	1.44654226125137
GO:0032330	regulation of chondrocyte differentiation	  6	0.590648335429865	1	1	5	910	5673	1.20545188437614
GO:0032331	negative regulation of chondrocyte differentiation	  5	0.524912504930412	1	1	4	910	5674	1.44654226125137
GO:0032332	positive regulation of chondrocyte differentiation	  7	0.0599286150311256	1	3	4	908	5674	3.09973341696723
GO:0032355	response to estradiol	 45	0.886756904660023	1	4	41	907	5637	0.642907671667276
GO:0032391	photoreceptor connecting cilium	 19	0.760858269222929	1	2	17	909	5661	0.761338032237564
GO:0032395	MHC class II receptor activity	  6	0.19623335243315	1	2	4	909	5674	2.41090376875229
GO:0032402	melanosome transport	 12	0.509611316519668	1	2	10	909	5668	1.20545188437614
GO:0032418	lysosome localization	  6	0.590648335429865	1	1	5	910	5673	1.20545188437614
GO:0032420	stereocilium	 13	0.554297337812073	1	2	11	909	5667	1.11272481634721
GO:0032432	actin filament bundle	  5	0.524912504930412	1	1	4	910	5674	1.44654226125137
GO:0032433	filopodium tip	 12	1	1	0	12	911	5666	0
GO:0032434	regulation of proteasomal ubiquitin-dependent protein catabolic process	  8	0.696113996849696	1	1	7	910	5671	0.904088913282108
GO:0032435	negative regulation of proteasomal ubiquitin-dependent protein catabolic process	  6	0.590648335429865	1	1	5	910	5673	1.20545188437614
GO:0032436	positive regulation of proteasomal ubiquitin-dependent protein catabolic process	 41	0.508440361117283	1	6	35	905	5643	1.0584455570132
GO:0032438	melanosome organization	  8	0.0862825209590832	1	3	5	908	5673	2.71226673984632
GO:0032452	histone demethylase activity	  9	0.359581374002193	1	2	7	909	5671	1.60726917916819
GO:0032454	histone demethylase activity (H3-K9 specific)	  5	0.524912504930412	1	1	4	910	5674	1.44654226125137
GO:0032456	endocytic recycling	 14	0.596015503295557	1	2	12	909	5666	1.03324447232241
GO:0032465	regulation of cytokinesis	 11	0.462079859473656	1	2	9	909	5669	1.31503841931943
GO:0032467	positive regulation of cytokinesis	 10	0.774429434347452	1	1	9	910	5669	0.723271130625686
GO:0032469	endoplasmic reticulum calcium ion homeostasis	  7	0.647297183435849	1	1	6	910	5672	1.03324447232241
GO:0032480	negative regulation of type I interferon production	 15	1	1	0	15	911	5663	0
GO:0032481	positive regulation of type I interferon production	 27	0.159915810494805	1	6	21	905	5657	1.60726917916819
GO:0032486	Rap protein signal transduction	  5	1	1	0	5	911	5673	0
GO:0032496	response to lipopolysaccharide	 85	0.999677989784548	1	3	82	908	5596	0.255272163750242
GO:0032502	developmental process	 10	0.150143518293906	1	3	7	908	5671	2.16981339187706
GO:0032508	DNA duplex unwinding	 14	1	1	0	14	911	5664	0
GO:0032515	negative regulation of phosphoprotein phosphatase activity	 10	0.774429434347452	1	1	9	910	5669	0.723271130625686
GO:0032516	positive regulation of phosphoprotein phosphatase activity	  7	0.647297183435849	1	1	6	910	5672	1.03324447232241
GO:0032526	response to retinoic acid	 19	0.941070913135173	1	1	18	910	5660	0.380669016118782
GO:0032543	mitochondrial translation	  9	0.738180574705634	1	1	8	910	5670	0.803634589584096
GO:0032570	response to progesterone	 18	1	1	0	18	911	5660	0
GO:0032580	Golgi cisterna membrane	 29	0.58353593328048	1	4	25	907	5653	0.997615352587153
GO:0032585	multivesicular body membrane	  5	1	1	0	5	911	5673	0
GO:0032587	ruffle membrane	 38	0.43167240933601	1	6	32	905	5646	1.14200704835635
GO:0032588	trans-Golgi network membrane	 46	0.176722062673542	1	9	37	902	5641	1.4150956903546
GO:0032590	dendrite membrane	 13	0.554297337812073	1	2	11	909	5667	1.11272481634721
GO:0032591	dendritic spine membrane	 10	1	1	0	10	911	5668	0
GO:0032689	negative regulation of interferon-gamma production	  9	0.738180574705634	1	1	8	910	5670	0.803634589584096
GO:0032715	negative regulation of interleukin-6 production	  8	0.696113996849696	1	1	7	910	5671	0.904088913282108
GO:0032720	negative regulation of tumor necrosis factor production	 11	0.462079859473656	1	2	9	909	5669	1.31503841931943
GO:0032722	positive regulation of chemokine production	  8	0.696113996849696	1	1	7	910	5671	0.904088913282108
GO:0032727	positive regulation of interferon-alpha production	  6	1	1	0	6	911	5672	0
GO:0032728	positive regulation of interferon-beta production	 18	0.462686108033741	1	3	15	908	5663	1.20545188437614
GO:0032729	positive regulation of interferon-gamma production	 12	1	1	0	12	911	5666	0
GO:0032733	positive regulation of interleukin-10 production	  8	1	1	0	8	911	5670	0
GO:0032735	positive regulation of interleukin-12 production	  8	0.696113996849696	1	1	7	910	5671	0.904088913282108
GO:0032743	positive regulation of interleukin-2 production	  5	1	1	0	5	911	5673	0
GO:0032753	positive regulation of interleukin-4 production	  5	1	1	0	5	911	5673	0
GO:0032755	positive regulation of interleukin-6 production	 19	0.500137274055772	1	3	16	908	5662	1.14200704835635
GO:0032757	positive regulation of interleukin-8 production	  9	0.738180574705634	1	1	8	910	5670	0.803634589584096
GO:0032760	positive regulation of tumor necrosis factor production	 17	0.703333082174572	1	2	15	909	5663	0.850907212500807
GO:0032780	negative regulation of ATPase activity	  6	1	1	0	6	911	5672	0
GO:0032781	positive regulation of ATPase activity	 22	0.603648322851636	1	3	19	908	5659	0.986278814489572
GO:0032784	regulation of DNA-templated transcription, elongation	  6	1	1	0	6	911	5672	0
GO:0032793	positive regulation of CREB transcription factor activity	  9	1	1	0	9	911	5669	0
GO:0032794	GTPase activating protein binding	  6	1	1	0	6	911	5672	0
GO:0032801	receptor catabolic process	  7	1	1	0	7	911	5671	0
GO:0032802	low-density lipoprotein particle receptor catabolic process	  7	0.647297183435849	1	1	6	910	5672	1.03324447232241
GO:0032808	lacrimal gland development	  6	0.19623335243315	1	2	4	909	5674	2.41090376875229
GO:0032809	neuronal cell body membrane	 17	0.920576476962146	1	1	16	910	5662	0.425453606250404
GO:0032835	glomerulus development	  6	1	1	0	6	911	5672	0
GO:0032839	dendrite cytoplasm	 15	0.344361377150163	1	3	12	908	5666	1.44654226125137
GO:0032868	response to insulin	 38	0.43167240933601	1	6	32	905	5646	1.14200704835635
GO:0032869	cellular response to insulin stimulus	 40	0.0416319932204501	1	10	30	901	5648	1.80817782656422
GO:0032870	cellular response to hormone stimulus	 22	0.962345164748973	1	1	21	910	5657	0.328759604829857
GO:0032874	positive regulation of stress-activated MAPK cascade	  9	1	1	0	9	911	5669	0
GO:0032880	regulation of protein localization	 29	0.203691418531707	1	6	23	905	5655	1.49642302888073
GO:0032886	regulation of microtubule-based process	  5	0.524912504930412	1	1	4	910	5674	1.44654226125137
GO:0032922	circadian regulation of gene expression	 27	0.314618865714415	1	5	22	906	5656	1.33939098264016
GO:0032924	activin receptor signaling pathway	  8	1	1	0	8	911	5670	0
GO:0032930	positive regulation of superoxide anion generation	  6	1	1	0	6	911	5672	0
GO:0032940	secretion by cell	  7	1	1	0	7	911	5671	0
GO:0032947	protein complex scaffold activity	 18	0.462686108033741	1	3	15	908	5663	1.20545188437614
GO:0032956	regulation of actin cytoskeleton organization	 21	0.808458104218592	1	2	19	909	5659	0.688829648214939
GO:0032967	positive regulation of collagen biosynthetic process	  9	1	1	0	9	911	5669	0
GO:0032968	positive regulation of transcription elongation from RNA polymerase II promoter	  7	1	1	0	7	911	5671	0
GO:0032981	mitochondrial respiratory chain complex I assembly	 20	0.0142273659703894	1	7	13	904	5665	2.5314489571899
GO:0032982	myosin filament	  5	1	1	0	5	911	5673	0
GO:0032993	protein-DNA complex	 16	0.0588514488278301	1	5	11	906	5667	2.26022228320527
GO:0033010	paranodal junction	  6	1	1	0	6	911	5672	0
GO:0033017	sarcoplasmic reticulum membrane	 22	0.962345164748973	1	1	21	910	5657	0.328759604829857
GO:0033077	T cell differentiation in thymus	 16	0.384511432262289	1	3	13	908	5665	1.35613336992316
GO:0033116	endoplasmic reticulum-Golgi intermediate compartment membrane	 31	0.941131570135982	1	2	29	909	5649	0.466626535887539
GO:0033130	acetylcholine receptor binding	  6	0.00431801180470798	0.682033737744821	4	2	907	5676	4.82180753750457
GO:0033135	regulation of peptidyl-serine phosphorylation	  5	0.143519565197953	1	2	3	909	5675	2.89308452250274
GO:0033137	negative regulation of peptidyl-serine phosphorylation	  9	0.359581374002193	1	2	7	909	5671	1.60726917916819
GO:0033138	positive regulation of peptidyl-serine phosphorylation	 39	0.161846713117336	1	8	31	903	5647	1.48363308846295
GO:0033146	regulation of intracellular estrogen receptor signaling pathway	 10	0.150143518293906	1	3	7	908	5671	2.16981339187706
GO:0033147	negative regulation of intracellular estrogen receptor signaling pathway	  6	0.19623335243315	1	2	4	909	5674	2.41090376875229
GO:0033151	V(D)J recombination	  5	0.524912504930412	1	1	4	910	5674	1.44654226125137
GO:0033153	T cell receptor V(D)J recombination	  5	0.143519565197953	1	2	3	909	5675	2.89308452250274
GO:0033160	positive regulation of protein import into nucleus, translocation	 10	1	1	0	10	911	5668	0
GO:0033169	histone H3-K9 demethylation	  5	0.524912504930412	1	1	4	910	5674	1.44654226125137
GO:0033179	proton-transporting V-type ATPase, V0 domain	  6	1	1	0	6	911	5672	0
GO:0033180	proton-transporting V-type ATPase, V1 domain	  5	1	1	0	5	911	5673	0
GO:0033189	response to vitamin A	  6	1	1	0	6	911	5672	0
GO:0033197	response to vitamin E	  7	0.0599286150311256	1	3	4	908	5674	3.09973341696723
GO:0033198	response to ATP	  8	0.696113996849696	1	1	7	910	5671	0.904088913282108
GO:0033209	tumor necrosis factor-mediated signaling pathway	 40	0.92909139324127	1	3	37	908	5641	0.542453347969265
GO:0033210	leptin-mediated signaling pathway	  5	0.143519565197953	1	2	3	909	5675	2.89308452250274
GO:0033268	node of Ranvier	 11	1	1	0	11	911	5667	0
GO:0033270	paranode region of axon	 10	1	1	0	10	911	5668	0
GO:0033276	transcription factor TFTC complex	  5	1	1	0	5	911	5673	0
GO:0033280	response to vitamin D	  6	1	1	0	6	911	5672	0
GO:0033290	eukaryotic 48S preinitiation complex	  5	0.524912504930412	1	1	4	910	5674	1.44654226125137
GO:0033327	Leydig cell differentiation	  6	0.590648335429865	1	1	5	910	5673	1.20545188437614
GO:0033344	cholesterol efflux	  5	1	1	0	5	911	5673	0
GO:0033365	protein localization to organelle	  7	0.647297183435849	1	1	6	910	5672	1.03324447232241
GO:0033391	chromatoid body	  5	0.524912504930412	1	1	4	910	5674	1.44654226125137
GO:0033572	transferrin transport	 20	0.131823772311556	1	5	15	906	5663	1.80817782656422
GO:0033574	response to testosterone	 15	0.634731522702541	1	2	13	909	5665	0.964361507500915
GO:0033598	mammary gland epithelial cell proliferation	  5	0.524912504930412	1	1	4	910	5674	1.44654226125137
GO:0033601	positive regulation of mammary gland epithelial cell proliferation	  5	0.524912504930412	1	1	4	910	5674	1.44654226125137
GO:0033613	activating transcription factor binding	 17	0.920576476962146	1	1	16	910	5662	0.425453606250404
GO:0033617	mitochondrial respiratory chain complex IV assembly	  6	0.590648335429865	1	1	5	910	5673	1.20545188437614
GO:0033622	integrin activation	  7	1	1	0	7	911	5671	0
GO:0033627	cell adhesion mediated by integrin	 10	1	1	0	10	911	5668	0
GO:0033628	regulation of cell adhesion mediated by integrin	  6	1	1	0	6	911	5672	0
GO:0033630	positive regulation of cell adhesion mediated by integrin	  8	1	1	0	8	911	5670	0
GO:0033673	negative regulation of kinase activity	  5	0.143519565197953	1	2	3	909	5675	2.89308452250274
GO:0033674	positive regulation of kinase activity	  5	0.524912504930412	1	1	4	910	5674	1.44654226125137
GO:0033683	nucleotide-excision repair, DNA incision	 20	0.131823772311556	1	5	15	906	5663	1.80817782656422
GO:0033689	negative regulation of osteoblast proliferation	  6	1	1	0	6	911	5672	0
GO:0033690	positive regulation of osteoblast proliferation	  7	1	1	0	7	911	5671	0
GO:0033762	response to glucagon	  6	0.590648335429865	1	1	5	910	5673	1.20545188437614
GO:0033962	cytoplasmic mRNA processing body assembly	  6	0.19623335243315	1	2	4	909	5674	2.41090376875229
GO:0033993	response to lipid	  6	1	1	0	6	911	5672	0
GO:0034045	pre-autophagosomal structure membrane	  9	1	1	0	9	911	5669	0
GO:0034058	endosomal vesicle fusion	  5	1	1	0	5	911	5673	0
GO:0034063	stress granule assembly	  7	0.0599286150311256	1	3	4	908	5674	3.09973341696723
GO:0034080	CENP-A containing nucleosome assembly	  6	0.19623335243315	1	2	4	909	5674	2.41090376875229
GO:0034097	response to cytokine	 31	0.941131570135982	1	2	29	909	5649	0.466626535887539
GO:0034098	VCP-NPL4-UFD1 AAA ATPase complex	  5	0.143519565197953	1	2	3	909	5675	2.89308452250274
GO:0034101	erythrocyte homeostasis	  7	0.647297183435849	1	1	6	910	5672	1.03324447232241
GO:0034113	heterotypic cell-cell adhesion	 11	0.805664391834832	1	1	10	910	5668	0.657519209659715
GO:0034142	toll-like receptor 4 signaling pathway	  9	1	1	0	9	911	5669	0
GO:0034162	toll-like receptor 9 signaling pathway	  7	1	1	0	7	911	5671	0
GO:0034185	apolipoprotein binding	  8	0.696113996849696	1	1	7	910	5671	0.904088913282108
GO:0034198	cellular response to amino acid starvation	 23	0.967568791201491	1	1	22	910	5656	0.31446570896769
GO:0034199	activation of protein kinase A activity	 10	0.774429434347452	1	1	9	910	5669	0.723271130625686
GO:0034214	protein hexamerization	  6	0.000265848371575281	0.177264945402662	5	1	906	5677	6.02725942188072
GO:0034236	protein kinase A catalytic subunit binding	 10	0.411940837929264	1	2	8	909	5670	1.44654226125137
GO:0034237	protein kinase A regulatory subunit binding	 11	0.805664391834832	1	1	10	910	5668	0.657519209659715
GO:0034260	negative regulation of GTPase activity	 24	0.230439938269259	1	5	19	906	5659	1.50681485547018
GO:0034314	Arp2/3 complex-mediated actin nucleation	  5	0.143519565197953	1	2	3	909	5675	2.89308452250274
GO:0034329	cell junction assembly	  6	1	1	0	6	911	5672	0
GO:0034332	adherens junction organization	 15	0.634731522702541	1	2	13	909	5665	0.964361507500915
GO:0034333	adherens junction assembly	  8	0.305579489538918	1	2	6	909	5672	1.80817782656422
GO:0034341	response to interferon-gamma	 12	0.509611316519668	1	2	10	909	5668	1.20545188437614
GO:0034351	negative regulation of glial cell apoptotic process	  5	1	1	0	5	911	5673	0
GO:0034356	NAD biosynthesis via nicotinamide riboside salvage pathway	  6	1	1	0	6	911	5672	0
GO:0034361	very-low-density lipoprotein particle	  7	0.647297183435849	1	1	6	910	5672	1.03324447232241
GO:0034362	low-density lipoprotein particle	  6	0.590648335429865	1	1	5	910	5673	1.20545188437614
GO:0034364	high-density lipoprotein particle	  5	0.524912504930412	1	1	4	910	5674	1.44654226125137
GO:0034375	high-density lipoprotein particle remodeling	  5	1	1	0	5	911	5673	0
GO:0034383	low-density lipoprotein particle clearance	 11	0.805664391834832	1	1	10	910	5668	0.657519209659715
GO:0034389	lipid particle organization	  9	0.738180574705634	1	1	8	910	5670	0.803634589584096
GO:0034394	protein localization to cell surface	 13	0.554297337812073	1	2	11	909	5667	1.11272481634721
GO:0034399	nuclear periphery	 12	0.224422574243593	1	3	9	908	5669	1.80817782656421
GO:0034405	response to fluid shear stress	  5	1	1	0	5	911	5673	0
GO:0034446	substrate adhesion-dependent cell spreading	 16	0.907797453739348	1	1	15	910	5663	0.452044456641054
GO:0034450	ubiquitin-ubiquitin ligase activity	  7	1	1	0	7	911	5671	0
GO:0034451	centriolar satellite	 14	1	1	0	14	911	5664	0
GO:0034452	dynactin binding	  5	0.143519565197953	1	2	3	909	5675	2.89308452250274
GO:0034453	microtubule anchoring	  8	0.696113996849696	1	1	7	910	5671	0.904088913282108
GO:0034464	BBSome	  7	1	1	0	7	911	5671	0
GO:0034497	protein localization to pre-autophagosomal structure	  5	1	1	0	5	911	5673	0
GO:0034498	early endosome to Golgi transport	  5	0.524912504930412	1	1	4	910	5674	1.44654226125137
GO:0034504	protein localization to nucleus	 12	0.832578307772574	1	1	11	910	5667	0.602725942188072
GO:0034551	mitochondrial respiratory chain complex III assembly	  5	0.0212050012661332	1	3	2	908	5676	4.33962678375412
GO:0034599	cellular response to oxidative stress	 41	0.336013808640909	1	7	34	904	5644	1.23485314984873
GO:0034605	cellular response to heat	 25	0.461378226139581	1	4	21	907	5657	1.1572338090011
GO:0034612	response to tumor necrosis factor	 14	0.596015503295557	1	2	12	909	5666	1.03324447232241
GO:0034613	cellular protein localization	 23	0.967568791201491	1	1	22	910	5656	0.31446570896769
GO:0034614	cellular response to reactive oxygen species	 15	0.344361377150163	1	3	12	908	5666	1.44654226125137
GO:0034616	response to laminar fluid shear stress	  7	0.250755247393959	1	2	5	909	5673	2.06648894464482
GO:0034625	fatty acid elongation, monounsaturated fatty acid	  5	0.143519565197953	1	2	3	909	5675	2.89308452250274
GO:0034626	fatty acid elongation, polyunsaturated fatty acid	  5	0.143519565197953	1	2	3	909	5675	2.89308452250274
GO:0034629	cellular protein complex localization	  6	0.19623335243315	1	2	4	909	5674	2.41090376875229
GO:0034641	cellular nitrogen compound metabolic process	 11	0.186315240979503	1	3	8	908	5670	1.97255762897914
GO:0034644	cellular response to UV	 17	0.199958412567424	1	4	13	907	5665	1.70181442500161
GO:0034656	nucleobase-containing small molecule catabolic process	  9	1	1	0	9	911	5669	0
GO:0034704	calcium channel complex	  6	1	1	0	6	911	5672	0
GO:0034705	potassium channel complex	  5	0.524912504930412	1	1	4	910	5674	1.44654226125137
GO:0034707	chloride channel complex	 19	1	1	0	19	911	5659	0
GO:0034713	type I transforming growth factor beta receptor binding	  8	0.696113996849696	1	1	7	910	5671	0.904088913282108
GO:0034765	regulation of ion transmembrane transport	 74	0.954221816816876	1	6	68	905	5610	0.586436051858664
GO:0034774	secretory granule lumen	 49	0.36468458382293	1	8	41	903	5637	1.18085082551132
GO:0034968	histone lysine methylation	 10	0.150143518293906	1	3	7	908	5671	2.16981339187706
GO:0034975	protein folding in endoplasmic reticulum	 12	0.224422574243593	1	3	9	908	5669	1.80817782656421
GO:0034976	response to endoplasmic reticulum stress	 38	0.619059057302281	1	5	33	906	5645	0.951672540296955
GO:0035019	somatic stem cell population maintenance	 28	0.554462782906824	1	4	24	907	5654	1.03324447232241
GO:0035023	regulation of Rho protein signal transduction	 37	0.594402919411983	1	5	32	906	5646	0.977393419764441
GO:0035024	negative regulation of Rho protein signal transduction	 10	0.411940837929264	1	2	8	909	5670	1.44654226125137
GO:0035025	positive regulation of Rho protein signal transduction	 10	0.774429434347452	1	1	9	910	5669	0.723271130625686
GO:0035032	phosphatidylinositol 3-kinase complex, class III	  5	1	1	0	5	911	5673	0
GO:0035035	histone acetyltransferase binding	 16	0.670477249908291	1	2	14	909	5664	0.904088913282108
GO:0035050	embryonic heart tube development	  6	0.0380919907275585	1	3	3	908	5675	3.61635565312843
GO:0035064	methylated histone binding	 20	0.131823772311556	1	5	15	906	5663	1.80817782656422
GO:0035066	positive regulation of histone acetylation	  8	1	1	0	8	911	5670	0
GO:0035068	micro-ribonucleoprotein complex	  7	0.647297183435849	1	1	6	910	5672	1.03324447232241
GO:0035091	phosphatidylinositol binding	 49	0.922244556495863	1	4	45	907	5633	0.590425412755662
GO:0035094	response to nicotine	 13	0.855768388602616	1	1	12	910	5666	0.556362408173605
GO:0035097	histone methyltransferase complex	  7	0.250755247393959	1	2	5	909	5673	2.06648894464482
GO:0035098	ESC/E(Z) complex	  7	0.647297183435849	1	1	6	910	5672	1.03324447232241
GO:0035108	limb morphogenesis	  8	0.305579489538918	1	2	6	909	5672	1.80817782656422
GO:0035115	embryonic forelimb morphogenesis	 11	0.462079859473656	1	2	9	909	5669	1.31503841931943
GO:0035116	embryonic hindlimb morphogenesis	  9	0.738180574705634	1	1	8	910	5670	0.803634589584096
GO:0035136	forelimb morphogenesis	  5	0.143519565197953	1	2	3	909	5675	2.89308452250274
GO:0035145	exon-exon junction complex	  6	0.590648335429865	1	1	5	910	5673	1.20545188437614
GO:0035148	tube formation	  6	0.590648335429865	1	1	5	910	5673	1.20545188437614
GO:0035162	embryonic hemopoiesis	  9	0.738180574705634	1	1	8	910	5670	0.803634589584096
GO:0035176	social behavior	 25	0.461378226139581	1	4	21	907	5657	1.1572338090011
GO:0035194	posttranscriptional gene silencing by RNA	  7	0.647297183435849	1	1	6	910	5672	1.03324447232241
GO:0035195	gene silencing by miRNA	  5	1	1	0	5	911	5673	0
GO:0035196	production of miRNAs involved in gene silencing by miRNA	  6	0.590648335429865	1	1	5	910	5673	1.20545188437614
GO:0035197	siRNA binding	  7	0.647297183435849	1	1	6	910	5672	1.03324447232241
GO:0035198	miRNA binding	  9	1	1	0	9	911	5669	0
GO:0035235	ionotropic glutamate receptor signaling pathway	 13	1	1	0	13	911	5665	0
GO:0035242	protein-arginine omega-N asymmetric methyltransferase activity	  6	0.19623335243315	1	2	4	909	5674	2.41090376875229
GO:0035246	peptidyl-arginine N-methylation	  5	0.524912504930412	1	1	4	910	5674	1.44654226125137
GO:0035249	synaptic transmission, glutamatergic	 13	1	1	0	13	911	5665	0
GO:0035253	ciliary rootlet	  6	1	1	0	6	911	5672	0
GO:0035254	glutamate receptor binding	  5	1	1	0	5	911	5673	0
GO:0035255	ionotropic glutamate receptor binding	 14	0.116620999245796	1	4	10	907	5668	2.06648894464482
GO:0035257	nuclear hormone receptor binding	 15	0.142496215955173	1	4	11	907	5667	1.92872301500183
GO:0035259	glucocorticoid receptor binding	 11	0.462079859473656	1	2	9	909	5669	1.31503841931943
GO:0035264	multicellular organism growth	 43	0.557432876463993	1	6	37	905	5641	1.00921553110561
GO:0035265	organ growth	  7	1	1	0	7	911	5671	0
GO:0035267	NuA4 histone acetyltransferase complex	  7	0.647297183435849	1	1	6	910	5672	1.03324447232241
GO:0035269	protein O-linked mannosylation	  6	1	1	0	6	911	5672	0
GO:0035278	miRNA mediated inhibition of translation	  9	0.738180574705634	1	1	8	910	5670	0.803634589584096
GO:0035280	miRNA loading onto RISC involved in gene silencing by miRNA	  5	0.524912504930412	1	1	4	910	5674	1.44654226125137
GO:0035307	positive regulation of protein dephosphorylation	  7	0.647297183435849	1	1	6	910	5672	1.03324447232241
GO:0035308	negative regulation of protein dephosphorylation	  6	0.590648335429865	1	1	5	910	5673	1.20545188437614
GO:0035326	enhancer binding	 10	0.774429434347452	1	1	9	910	5669	0.723271130625686
GO:0035327	transcriptionally active chromatin	 11	1	1	0	11	911	5667	0
GO:0035329	hippo signaling	 20	0.785819229034214	1	2	18	909	5660	0.723271130625686
GO:0035335	peptidyl-tyrosine dephosphorylation	 49	0.229288303651616	1	9	40	902	5638	1.32845717870024
GO:0035338	long-chain fatty-acyl-CoA biosynthetic process	 10	0.000877753527348291	0.260912236004279	6	4	905	5674	4.33962678375412
GO:0035371	microtubule plus-end	  7	1	1	0	7	911	5671	0
GO:0035413	positive regulation of catenin import into nucleus	  5	1	1	0	5	911	5673	0
GO:0035418	protein localization to synapse	  9	0.738180574705634	1	1	8	910	5670	0.803634589584096
GO:0035435	phosphate ion transmembrane transport	  5	0.143519565197953	1	2	3	909	5675	2.89308452250274
GO:0035455	response to interferon-alpha	  7	0.647297183435849	1	1	6	910	5672	1.03324447232241
GO:0035456	response to interferon-beta	  7	0.250755247393959	1	2	5	909	5673	2.06648894464482
GO:0035457	cellular response to interferon-alpha	  5	1	1	0	5	911	5673	0
GO:0035458	cellular response to interferon-beta	  5	0.524912504930412	1	1	4	910	5674	1.44654226125137
GO:0035493	SNARE complex assembly	  6	0.590648335429865	1	1	5	910	5673	1.20545188437614
GO:0035497	cAMP response element binding	  6	1	1	0	6	911	5672	0
GO:0035518	histone H2A monoubiquitination	  7	0.250755247393959	1	2	5	909	5673	2.06648894464482
GO:0035520	monoubiquitinated protein deubiquitination	  6	0.590648335429865	1	1	5	910	5673	1.20545188437614
GO:0035563	positive regulation of chromatin binding	  6	0.19623335243315	1	2	4	909	5674	2.41090376875229
GO:0035567	non-canonical Wnt signaling pathway	  7	0.647297183435849	1	1	6	910	5672	1.03324447232241
GO:0035577	azurophil granule membrane	 29	0.785423643074026	1	3	26	908	5652	0.748211514440365
GO:0035578	azurophil granule lumen	 41	0.103686277311128	1	9	32	902	5646	1.5876683355198
GO:0035579	specific granule membrane	 49	0.688534076233458	1	6	43	905	5635	0.885638119133493
GO:0035580	specific granule lumen	 26	0.892479153310945	1	2	24	909	5654	0.556362408173605
GO:0035584	calcium-mediated signaling using intracellular calcium source	 10	0.774429434347452	1	1	9	910	5669	0.723271130625686
GO:0035589	G-protein coupled purinergic nucleotide receptor signaling pathway	  5	1	1	0	5	911	5673	0
GO:0035591	signaling adaptor activity	  6	1	1	0	6	911	5672	0
GO:0035612	AP-2 adaptor complex binding	  6	0.590648335429865	1	1	5	910	5673	1.20545188437614
GO:0035613	RNA stem-loop binding	  7	1	1	0	7	911	5671	0
GO:0035615	clathrin adaptor activity	 11	0.805664391834832	1	1	10	910	5668	0.657519209659715
GO:0035631	CD40 receptor complex	  5	1	1	0	5	911	5673	0
GO:0035640	exploration behavior	  9	0.359581374002193	1	2	7	909	5671	1.60726917916819
GO:0035641	locomotory exploration behavior	 10	0.774429434347452	1	1	9	910	5669	0.723271130625686
GO:0035666	TRIF-dependent toll-like receptor signaling pathway	 10	1	1	0	10	911	5668	0
GO:0035690	cellular response to drug	 30	0.933483829552772	1	2	28	909	5650	0.482180753750457
GO:0035721	intraciliary retrograde transport	  6	0.19623335243315	1	2	4	909	5674	2.41090376875229
GO:0035722	interleukin-12-mediated signaling pathway	 27	0.74203057279193	1	3	24	908	5654	0.803634589584096
GO:0035725	sodium ion transmembrane transport	 36	0.753259008988217	1	4	32	907	5646	0.803634589584096
GO:0035729	cellular response to hepatocyte growth factor stimulus	  6	1	1	0	6	911	5672	0
GO:0035735	intraciliary transport involved in cilium assembly	 25	0.691930609011909	1	3	22	908	5656	0.867925356750823
GO:0035748	myelin sheath abaxonal region	  5	1	1	0	5	911	5673	0
GO:0035767	endothelial cell chemotaxis	  5	1	1	0	5	911	5673	0
GO:0035770	ribonucleoprotein granule	  5	1	1	0	5	911	5673	0
GO:0035774	positive regulation of insulin secretion involved in cellular response to glucose stimulus	 11	0.805664391834832	1	1	10	910	5668	0.657519209659715
GO:0035855	megakaryocyte development	 11	0.805664391834832	1	1	10	910	5668	0.657519209659715
GO:0035861	site of double-strand break	 11	0.805664391834832	1	1	10	910	5668	0.657519209659715
GO:0035865	cellular response to potassium ion	  5	1	1	0	5	911	5673	0
GO:0035869	ciliary transition zone	 17	0.199958412567424	1	4	13	907	5665	1.70181442500161
GO:0035871	protein K11-linked deubiquitination	  5	0.524912504930412	1	1	4	910	5674	1.44654226125137
GO:0035902	response to immobilization stress	 10	0.774429434347452	1	1	9	910	5669	0.723271130625686
GO:0035904	aorta development	  7	1	1	0	7	911	5671	0
GO:0035914	skeletal muscle cell differentiation	 16	0.907797453739348	1	1	15	910	5663	0.452044456641054
GO:0035924	cellular response to vascular endothelial growth factor stimulus	 12	1	1	0	12	911	5666	0
GO:0035925	mRNA 3	  8	0.305579489538918	1	2	6	909	5672	1.80817782656422
GO:0035970	peptidyl-threonine dephosphorylation	  9	0.359581374002193	1	2	7	909	5671	1.60726917916819
GO:0035987	endodermal cell differentiation	 14	0.875749379780082	1	1	13	910	5665	0.516622236161204
GO:0035988	chondrocyte proliferation	  5	1	1	0	5	911	5673	0
GO:0035994	response to muscle stretch	  7	1	1	0	7	911	5671	0
GO:0036002	pre-mRNA binding	  9	0.738180574705634	1	1	8	910	5670	0.803634589584096
GO:0036020	endolysosome membrane	  8	0.696113996849696	1	1	7	910	5671	0.904088913282108
GO:0036038	MKS complex	  6	0.590648335429865	1	1	5	910	5673	1.20545188437614
GO:0036064	ciliary basal body	 52	0.591729487674911	1	7	45	904	5633	0.973634214303808
GO:0036092	phosphatidylinositol-3-phosphate biosynthetic process	 24	0.664264323067229	1	3	21	908	5657	0.904088913282107
GO:0036109	alpha-linolenic acid metabolic process	  6	0.590648335429865	1	1	5	910	5673	1.20545188437614
GO:0036120	cellular response to platelet-derived growth factor stimulus	 10	0.774429434347452	1	1	9	910	5669	0.723271130625686
GO:0036122	BMP binding	  5	1	1	0	5	911	5673	0
GO:0036126	sperm flagellum	  8	1	1	0	8	911	5670	0
GO:0036148	phosphatidylglycerol acyl-chain remodeling	  6	1	1	0	6	911	5672	0
GO:0036149	phosphatidylinositol acyl-chain remodeling	  6	1	1	0	6	911	5672	0
GO:0036150	phosphatidylserine acyl-chain remodeling	  8	1	1	0	8	911	5670	0
GO:0036151	phosphatidylcholine acyl-chain remodeling	  9	1	1	0	9	911	5669	0
GO:0036152	phosphatidylethanolamine acyl-chain remodeling	  9	1	1	0	9	911	5669	0
GO:0036258	multivesicular body assembly	 12	1	1	0	12	911	5666	0
GO:0036295	cellular response to increased oxygen levels	  5	1	1	0	5	911	5673	0
GO:0036297	interstrand cross-link repair	 12	0.509611316519668	1	2	10	909	5668	1.20545188437614
GO:0036312	phosphatidylinositol 3-kinase regulatory subunit binding	  6	0.0380919907275585	1	3	3	908	5675	3.61635565312843
GO:0036342	post-anal tail morphogenesis	  7	0.647297183435849	1	1	6	910	5672	1.03324447232241
GO:0036376	sodium ion export from cell	  6	1	1	0	6	911	5672	0
GO:0036459	thiol-dependent ubiquitinyl hydrolase activity	 54	0.327055284146732	1	9	45	902	5633	1.20545188437614
GO:0036464	cytoplasmic ribonucleoprotein granule	 12	1	1	0	12	911	5666	0
GO:0036477	somatodendritic compartment	  6	0.0380919907275585	1	3	3	908	5675	3.61635565312843
GO:0036498	IRE1-mediated unfolded protein response	 24	0.230439938269259	1	5	19	906	5659	1.50681485547018
GO:0036499	PERK-mediated unfolded protein response	  5	1	1	0	5	911	5673	0
GO:0036503	ERAD pathway	  5	0.143519565197953	1	2	3	909	5675	2.89308452250274
GO:0036513	Derlin-1 retrotranslocation complex	  6	0.19623335243315	1	2	4	909	5674	2.41090376875229
GO:0038061	NIK/NF-kappaB signaling	 24	0.664264323067229	1	3	21	908	5657	0.904088913282107
GO:0038063	collagen-activated tyrosine kinase receptor signaling pathway	  6	1	1	0	6	911	5672	0
GO:0038083	peptidyl-tyrosine autophosphorylation	 18	0.462686108033741	1	3	15	908	5663	1.20545188437614
GO:0038095	Fc-epsilon receptor signaling pathway	 52	0.431447522867742	1	8	44	903	5634	1.11272481634721
GO:0038096	Fc-gamma receptor signaling pathway involved in phagocytosis	 34	0.711034261448715	1	4	30	907	5648	0.850907212500807
GO:0038111	interleukin-7-mediated signaling pathway	 40	0.483207207096351	1	6	34	905	5644	1.08490669593853
GO:0038128	ERBB2 signaling pathway	 20	0.949242054403644	1	1	19	910	5659	0.361635565312843
GO:0038180	nerve growth factor signaling pathway	  5	1	1	0	5	911	5673	0
GO:0039694	viral RNA genome replication	  5	0.0212050012661332	1	3	2	908	5676	4.33962678375412
GO:0039702	viral budding via host ESCRT complex	  7	1	1	0	7	911	5671	0
GO:0040007	growth	  7	1	1	0	7	911	5671	0
GO:0040008	regulation of growth	 38	0.619059057302281	1	5	33	906	5645	0.951672540296955
GO:0040011	locomotion	  6	1	1	0	6	911	5672	0
GO:0040014	regulation of multicellular organism growth	 11	0.805664391834832	1	1	10	910	5668	0.657519209659715
GO:0040015	negative regulation of multicellular organism growth	 10	0.774429434347452	1	1	9	910	5669	0.723271130625686
GO:0040018	positive regulation of multicellular organism growth	 14	0.596015503295557	1	2	12	909	5666	1.03324447232241
GO:0040029	regulation of gene expression, epigenetic	  7	0.647297183435849	1	1	6	910	5672	1.03324447232241
GO:0042026	protein refolding	 12	1	1	0	12	911	5666	0
GO:0042043	neurexin family protein binding	  7	1	1	0	7	911	5671	0
GO:0042056	chemoattractant activity	  8	0.305579489538918	1	2	6	909	5672	1.80817782656422
GO:0042059	negative regulation of epidermal growth factor receptor signaling pathway	 14	0.875749379780082	1	1	13	910	5665	0.516622236161204
GO:0042060	wound healing	 40	0.92909139324127	1	3	37	908	5641	0.542453347969265
GO:0042073	intraciliary transport	  9	0.738180574705634	1	1	8	910	5670	0.803634589584096
GO:0042098	T cell proliferation	 11	0.462079859473656	1	2	9	909	5669	1.31503841931943
GO:0042100	B cell proliferation	  8	0.696113996849696	1	1	7	910	5671	0.904088913282108
GO:0042102	positive regulation of T cell proliferation	 17	1	1	0	17	911	5661	0
GO:0042104	positive regulation of activated T cell proliferation	  9	1	1	0	9	911	5669	0
GO:0042110	T cell activation	 18	0.733413953942175	1	2	16	909	5662	0.803634589584096
GO:0042113	B cell activation	 11	1	1	0	11	911	5667	0
GO:0042116	macrophage activation	  6	1	1	0	6	911	5672	0
GO:0042117	monocyte activation	  5	1	1	0	5	911	5673	0
GO:0042118	endothelial cell activation	  7	0.250755247393959	1	2	5	909	5673	2.06648894464482
GO:0042127	regulation of cell proliferation	 92	0.951398822028161	1	8	84	903	5594	0.628931417935379
GO:0042129	regulation of T cell proliferation	  5	1	1	0	5	911	5673	0
GO:0042130	negative regulation of T cell proliferation	 18	0.931586037139791	1	1	17	910	5661	0.401817294792048
GO:0042135	neurotransmitter catabolic process	  7	0.250755247393959	1	2	5	909	5673	2.06648894464482
GO:0042136	neurotransmitter biosynthetic process	  6	0.590648335429865	1	1	5	910	5673	1.20545188437614
GO:0042147	retrograde transport, endosome to Golgi	 35	0.100527681908658	1	8	27	903	5651	1.65319115571585
GO:0042149	cellular response to glucose starvation	 17	1	1	0	17	911	5661	0
GO:0042157	lipoprotein metabolic process	  6	1	1	0	6	911	5672	0
GO:0042162	telomeric DNA binding	 10	0.411940837929264	1	2	8	909	5670	1.44654226125137
GO:0042169	SH2 domain binding	 13	0.855768388602616	1	1	12	910	5666	0.556362408173605
GO:0042176	regulation of protein catabolic process	  6	0.590648335429865	1	1	5	910	5673	1.20545188437614
GO:0042177	negative regulation of protein catabolic process	 10	1	1	0	10	911	5668	0
GO:0042178	xenobiotic catabolic process	  5	1	1	0	5	911	5673	0
GO:0042220	response to cocaine	 14	0.303988344911165	1	3	11	908	5667	1.54986670848361
GO:0042246	tissue regeneration	  8	1	1	0	8	911	5670	0
GO:0042254	ribosome biogenesis	 32	0.663761033636311	1	4	28	907	5650	0.904088913282108
GO:0042267	natural killer cell mediated cytotoxicity	  5	1	1	0	5	911	5673	0
GO:0042276	error-prone translesion synthesis	 12	0.832578307772574	1	1	11	910	5667	0.602725942188072
GO:0042277	peptide binding	 25	0.257846566237795	1	5	20	906	5658	1.44654226125137
GO:0042288	MHC class I protein binding	  8	0.0862825209590832	1	3	5	908	5673	2.71226673984632
GO:0042301	phosphate ion binding	  5	0.524912504930412	1	1	4	910	5674	1.44654226125137
GO:0042307	positive regulation of protein import into nucleus	  9	1	1	0	9	911	5669	0
GO:0042310	vasoconstriction	  5	1	1	0	5	911	5673	0
GO:0042311	vasodilation	 14	0.875749379780082	1	1	13	910	5665	0.516622236161204
GO:0042325	regulation of phosphorylation	  9	0.359581374002193	1	2	7	909	5671	1.60726917916819
GO:0042326	negative regulation of phosphorylation	  8	0.305579489538918	1	2	6	909	5672	1.80817782656422
GO:0042327	positive regulation of phosphorylation	 13	0.554297337812073	1	2	11	909	5667	1.11272481634721
GO:0042346	positive regulation of NF-kappaB import into nucleus	  7	1	1	0	7	911	5671	0
GO:0042347	negative regulation of NF-kappaB import into nucleus	  6	1	1	0	6	911	5672	0
GO:0042382	paraspeckles	  5	0.0212050012661332	1	3	2	908	5676	4.33962678375412
GO:0042383	sarcolemma	 51	0.935941738404171	1	4	47	907	5631	0.567271475000538
GO:0042391	regulation of membrane potential	 33	0.992725545157596	1	1	32	910	5646	0.219173069886572
GO:0042392	sphingosine-1-phosphate phosphatase activity	  5	1	1	0	5	911	5673	0
GO:0042393	histone binding	 51	0.085385346590235	1	11	40	900	5638	1.55999655625148
GO:0042405	nuclear inclusion body	  6	0.590648335429865	1	1	5	910	5673	1.20545188437614
GO:0042407	cristae formation	 13	0.000756841881117246	0.260912236004279	7	6	904	5672	3.89453685721523
GO:0042416	dopamine biosynthetic process	  5	0.143519565197953	1	2	3	909	5675	2.89308452250274
GO:0042417	dopamine metabolic process	  8	0.305579489538918	1	2	6	909	5672	1.80817782656422
GO:0042428	serotonin metabolic process	  5	1	1	0	5	911	5673	0
GO:0042462	eye photoreceptor cell development	  6	1	1	0	6	911	5672	0
GO:0042470	melanosome	 58	0.275448110225558	1	10	48	901	5630	1.24701919073394
GO:0042472	inner ear morphogenesis	 20	0.785819229034214	1	2	18	909	5660	0.723271130625686
GO:0042474	middle ear morphogenesis	  8	0.696113996849696	1	1	7	910	5671	0.904088913282108
GO:0042475	odontogenesis of dentin-containing tooth	 21	0.808458104218592	1	2	19	909	5659	0.688829648214939
GO:0042476	odontogenesis	 11	1	1	0	11	911	5667	0
GO:0042500	aspartic endopeptidase activity, intramembrane cleaving	  5	1	1	0	5	911	5673	0
GO:0042531	positive regulation of tyrosine phosphorylation of STAT protein	 20	0.949242054403644	1	1	19	910	5659	0.361635565312843
GO:0042532	negative regulation of tyrosine phosphorylation of STAT protein	  8	0.305579489538918	1	2	6	909	5672	1.80817782656422
GO:0042542	response to hydrogen peroxide	 23	0.847425382793578	1	2	21	909	5657	0.628931417935379
GO:0042551	neuron maturation	  5	0.524912504930412	1	1	4	910	5674	1.44654226125137
GO:0042552	myelination	 25	0.975944413999558	1	1	24	910	5654	0.289308452250274
GO:0042562	hormone binding	  5	1	1	0	5	911	5673	0
GO:0042572	retinol metabolic process	 13	0.855768388602616	1	1	12	910	5666	0.556362408173605
GO:0042573	retinoic acid metabolic process	  5	1	1	0	5	911	5673	0
GO:0042574	retinal metabolic process	  8	1	1	0	8	911	5670	0
GO:0042577	lipid phosphatase activity	  6	1	1	0	6	911	5672	0
GO:0042581	specific granule	  9	0.359581374002193	1	2	7	909	5671	1.60726917916819
GO:0042582	azurophil granule	  7	0.250755247393959	1	2	5	909	5673	2.06648894464482
GO:0042589	zymogen granule membrane	  6	0.590648335429865	1	1	5	910	5673	1.20545188437614
GO:0042592	homeostatic process	  6	0.19623335243315	1	2	4	909	5674	2.41090376875229
GO:0042593	glucose homeostasis	 39	0.457587888355617	1	6	33	905	5645	1.11272481634721
GO:0042594	response to starvation	 13	0.0930371570174248	1	4	9	907	5669	2.22544963269442
GO:0042605	peptide antigen binding	 11	0.805664391834832	1	1	10	910	5668	0.657519209659715
GO:0042613	MHC class II protein complex	  9	0.738180574705634	1	1	8	910	5670	0.803634589584096
GO:0042623	ATPase activity, coupled	  6	0.590648335429865	1	1	5	910	5673	1.20545188437614
GO:0042626	ATPase activity, coupled to transmembrane movement of substances	 16	0.384511432262289	1	3	13	908	5665	1.35613336992316
GO:0042629	mast cell granule	 10	0.411940837929264	1	2	8	909	5670	1.44654226125137
GO:0042632	cholesterol homeostasis	 17	0.703333082174572	1	2	15	909	5663	0.850907212500807
GO:0042641	actomyosin	  5	1	1	0	5	911	5673	0
GO:0042645	mitochondrial nucleoid	 17	0.424058507911188	1	3	14	908	5664	1.27636081875121
GO:0042692	muscle cell differentiation	  7	0.647297183435849	1	1	6	910	5672	1.03324447232241
GO:0042698	ovulation cycle	  7	0.647297183435849	1	1	6	910	5672	1.03324447232241
GO:0042711	maternal behavior	  8	0.696113996849696	1	1	7	910	5671	0.904088913282108
GO:0042730	fibrinolysis	  6	1	1	0	6	911	5672	0
GO:0042733	embryonic digit morphogenesis	 27	0.00806562898282956	0.780954774083801	9	18	902	5660	2.41090376875229
GO:0042734	presynaptic membrane	 43	0.86419812133057	1	4	39	907	5639	0.672810354070406
GO:0042742	defense response to bacterium	 38	0.996557939490336	1	1	37	910	5641	0.190334508059391
GO:0042744	hydrogen peroxide catabolic process	  8	0.305579489538918	1	2	6	909	5672	1.80817782656422
GO:0042752	regulation of circadian rhythm	 27	0.74203057279193	1	3	24	908	5654	0.803634589584096
GO:0042755	eating behavior	 10	1	1	0	10	911	5668	0
GO:0042761	very long-chain fatty acid biosynthetic process	  8	0.0862825209590832	1	3	5	908	5673	2.71226673984632
GO:0042769	DNA damage response, detection of DNA damage	 15	0.892964940999907	1	1	14	910	5664	0.482180753750457
GO:0042771	intrinsic apoptotic signaling pathway in response to DNA damage by p53 class mediator	 12	0.224422574243593	1	3	9	908	5669	1.80817782656421
GO:0042776	mitochondrial ATP synthesis coupled proton transport	  8	0.00194754482774139	0.462768071049249	5	3	906	5675	4.52044456641054
GO:0042787	protein ubiquitination involved in ubiquitin-dependent protein catabolic process	 70	0.770449577024145	1	8	62	903	5616	0.826595577857927
GO:0042788	polysomal ribosome	  5	0.524912504930412	1	1	4	910	5674	1.44654226125137
GO:0042789	mRNA transcription from RNA polymerase II promoter	  5	1	1	0	5	911	5673	0
GO:0042795	snRNA transcription from RNA polymerase II promoter	 29	0.58353593328048	1	4	25	907	5653	0.997615352587153
GO:0042800	histone methyltransferase activity (H3-K4 specific)	  5	0.524912504930412	1	1	4	910	5674	1.44654226125137
GO:0042809	vitamin D receptor binding	  8	0.305579489538918	1	2	6	909	5672	1.80817782656422
GO:0042813	Wnt-activated receptor activity	 11	0.805664391834832	1	1	10	910	5668	0.657519209659715
GO:0042826	histone deacetylase binding	 50	0.0759984289789709	1	11	39	900	5639	1.59119648737651
GO:0042832	defense response to protozoan	  6	1	1	0	6	911	5672	0
GO:0042921	glucocorticoid receptor signaling pathway	  6	1	1	0	6	911	5672	0
GO:0042953	lipoprotein transport	  5	1	1	0	5	911	5673	0
GO:0042974	retinoic acid receptor binding	  8	0.305579489538918	1	2	6	909	5672	1.80817782656422
GO:0042975	peroxisome proliferator activated receptor binding	  6	0.590648335429865	1	1	5	910	5673	1.20545188437614
GO:0042982	amyloid precursor protein metabolic process	  8	1	1	0	8	911	5670	0
GO:0042993	positive regulation of transcription factor import into nucleus	  8	1	1	0	8	911	5670	0
GO:0043001	Golgi to plasma membrane protein transport	 14	0.596015503295557	1	2	12	909	5666	1.03324447232241
GO:0043008	ATP-dependent protein binding	  6	0.590648335429865	1	1	5	910	5673	1.20545188437614
GO:0043010	camera-type eye development	 30	0.046235513128273	1	8	22	903	5656	1.92872301500183
GO:0043011	myeloid dendritic cell differentiation	  5	1	1	0	5	911	5673	0
GO:0043014	alpha-tubulin binding	 15	0.634731522702541	1	2	13	909	5665	0.964361507500915
GO:0043015	gamma-tubulin binding	 13	0.855768388602616	1	1	12	910	5666	0.556362408173605
GO:0043021	ribonucleoprotein complex binding	 10	0.411940837929264	1	2	8	909	5670	1.44654226125137
GO:0043022	ribosome binding	 23	0.203944604492174	1	5	18	906	5660	1.57232854483845
GO:0043023	ribosomal large subunit binding	  5	0.524912504930412	1	1	4	910	5674	1.44654226125137
GO:0043024	ribosomal small subunit binding	  6	0.19623335243315	1	2	4	909	5674	2.41090376875229
GO:0043027	cysteine-type endopeptidase inhibitor activity involved in apoptotic process	  9	0.359581374002193	1	2	7	909	5671	1.60726917916819
GO:0043029	T cell homeostasis	 13	0.554297337812073	1	2	11	909	5667	1.11272481634721
GO:0043032	positive regulation of macrophage activation	  6	1	1	0	6	911	5672	0
GO:0043034	costamere	 10	1	1	0	10	911	5668	0
GO:0043044	ATP-dependent chromatin remodeling	 15	0.892964940999907	1	1	14	910	5664	0.482180753750457
GO:0043083	synaptic cleft	  7	0.647297183435849	1	1	6	910	5672	1.03324447232241
GO:0043085	positive regulation of catalytic activity	 39	0.642804817441497	1	5	34	906	5644	0.927270680289341
GO:0043086	negative regulation of catalytic activity	 43	0.94870631182737	1	3	40	908	5638	0.504607765552804
GO:0043087	regulation of GTPase activity	 42	0.116661302727033	1	9	33	902	5645	1.54986670848361
GO:0043097	pyrimidine nucleoside salvage	  5	1	1	0	5	911	5673	0
GO:0043101	purine-containing compound salvage	  7	0.647297183435849	1	1	6	910	5672	1.03324447232241
GO:0043113	receptor clustering	 12	1	1	0	12	911	5666	0
GO:0043116	negative regulation of vascular permeability	  7	0.647297183435849	1	1	6	910	5672	1.03324447232241
GO:0043122	regulation of I-kappaB kinase/NF-kappaB signaling	  8	1	1	0	8	911	5670	0
GO:0043123	positive regulation of I-kappaB kinase/NF-kappaB signaling	 72	0.287965699611579	1	12	60	899	5618	1.20545188437614
GO:0043124	negative regulation of I-kappaB kinase/NF-kappaB signaling	 18	0.230920507298425	1	4	14	907	5664	1.60726917916819
GO:0043130	ubiquitin binding	 39	0.457587888355617	1	6	33	905	5645	1.11272481634721
GO:0043149	stress fiber assembly	  7	1	1	0	7	911	5671	0
GO:0043153	entrainment of circadian clock by photoperiod	  6	1	1	0	6	911	5672	0
GO:0043154	negative regulation of cysteine-type endopeptidase activity involved in apoptotic process	 31	0.82259159109624	1	3	28	908	5650	0.699939803831309
GO:0043161	proteasome-mediated ubiquitin-dependent protein catabolic process	 98	0.123876922794913	1	18	80	893	5598	1.32845717870024
GO:0043162	ubiquitin-dependent protein catabolic process via the multivesicular body sorting pathway	  9	0.738180574705634	1	1	8	910	5670	0.803634589584096
GO:0043169	cation binding	  9	0.738180574705634	1	1	8	910	5670	0.803634589584096
GO:0043171	peptide catabolic process	  5	1	1	0	5	911	5673	0
GO:0043194	axon initial segment	  9	0.359581374002193	1	2	7	909	5671	1.60726917916819
GO:0043195	terminal bouton	 36	0.379355854827396	1	6	30	905	5648	1.20545188437614
GO:0043197	dendritic spine	 75	0.909639979440116	1	7	68	904	5610	0.67505305525064
GO:0043198	dendritic shaft	 26	1	1	0	26	911	5652	0
GO:0043200	response to amino acid	 19	0.262946555916241	1	4	15	907	5663	1.52267606447513
GO:0043202	lysosomal lumen	 34	0.181150928150866	1	7	27	904	5651	1.48908762187641
GO:0043204	perikaryon	 62	0.772583141257567	1	7	55	904	5623	0.816596437803194
GO:0043218	compact myelin	  5	1	1	0	5	911	5673	0
GO:0043220	Schmidt-Lanterman incisure	  8	1	1	0	8	911	5670	0
GO:0043229	intracellular organelle	  7	1	1	0	7	911	5671	0
GO:0043235	receptor complex	 65	0.282267497315593	1	11	54	900	5624	1.22399729798193
GO:0043236	laminin binding	  9	1	1	0	9	911	5669	0
GO:0043248	proteasome assembly	  8	1	1	0	8	911	5670	0
GO:0043249	erythrocyte maturation	  5	0.524912504930412	1	1	4	910	5674	1.44654226125137
GO:0043252	sodium-independent organic anion transport	  8	1	1	0	8	911	5670	0
GO:0043254	regulation of protein complex assembly	  7	0.647297183435849	1	1	6	910	5672	1.03324447232241
GO:0043267	negative regulation of potassium ion transport	  6	0.590648335429865	1	1	5	910	5673	1.20545188437614
GO:0043268	positive regulation of potassium ion transport	  8	0.696113996849696	1	1	7	910	5671	0.904088913282108
GO:0043274	phospholipase binding	  8	0.305579489538918	1	2	6	909	5672	1.80817782656422
GO:0043277	apoptotic cell clearance	  7	1	1	0	7	911	5671	0
GO:0043278	response to morphine	  9	1	1	0	9	911	5669	0
GO:0043280	positive regulation of cysteine-type endopeptidase activity involved in apoptotic process	 21	0.570749914782619	1	3	18	908	5660	1.03324447232241
GO:0043292	contractile fiber	  7	1	1	0	7	911	5671	0
GO:0043295	glutathione binding	  5	0.524912504930412	1	1	4	910	5674	1.44654226125137
GO:0043296	apical junction complex	  6	0.590648335429865	1	1	5	910	5673	1.20545188437614
GO:0043303	mast cell degranulation	  6	0.19623335243315	1	2	4	909	5674	2.41090376875229
GO:0043304	regulation of mast cell degranulation	  5	0.524912504930412	1	1	4	910	5674	1.44654226125137
GO:0043305	negative regulation of mast cell degranulation	  5	1	1	0	5	911	5673	0
GO:0043306	positive regulation of mast cell degranulation	  6	1	1	0	6	911	5672	0
GO:0043325	phosphatidylinositol-3,4-bisphosphate binding	  8	0.305579489538918	1	2	6	909	5672	1.80817782656422
GO:0043330	response to exogenous dsRNA	  9	0.738180574705634	1	1	8	910	5670	0.803634589584096
GO:0043388	positive regulation of DNA binding	 13	0.554297337812073	1	2	11	909	5667	1.11272481634721
GO:0043392	negative regulation of DNA binding	 16	0.670477249908291	1	2	14	909	5664	0.904088913282108
GO:0043393	regulation of protein binding	 10	0.411940837929264	1	2	8	909	5670	1.44654226125137
GO:0043394	proteoglycan binding	  7	0.647297183435849	1	1	6	910	5672	1.03324447232241
GO:0043395	heparan sulfate proteoglycan binding	  5	1	1	0	5	911	5673	0
GO:0043401	steroid hormone mediated signaling pathway	 21	0.570749914782619	1	3	18	908	5660	1.03324447232241
GO:0043403	skeletal muscle tissue regeneration	  5	0.524912504930412	1	1	4	910	5674	1.44654226125137
GO:0043406	positive regulation of MAP kinase activity	 28	0.915282449919722	1	2	26	909	5652	0.516622236161204
GO:0043407	negative regulation of MAP kinase activity	 14	0.875749379780082	1	1	13	910	5665	0.516622236161204
GO:0043408	regulation of MAPK cascade	 15	0.634731522702541	1	2	13	909	5665	0.964361507500915
GO:0043409	negative regulation of MAPK cascade	  8	0.0862825209590832	1	3	5	908	5673	2.71226673984632
GO:0043410	positive regulation of MAPK cascade	 38	0.975434512664677	1	2	36	909	5642	0.380669016118782
GO:0043425	bHLH transcription factor binding	 11	0.0536855911323149	1	4	7	907	5671	2.63007683863886
GO:0043433	negative regulation of sequence-specific DNA binding transcription factor activity	 20	0.295727251817412	1	4	16	907	5662	1.44654226125137
GO:0043434	response to peptide hormone	 23	0.634832927753238	1	3	20	908	5658	0.943397126903069
GO:0043457	regulation of cellular respiration	  5	0.524912504930412	1	1	4	910	5674	1.44654226125137
GO:0043462	regulation of ATPase activity	  5	0.524912504930412	1	1	4	910	5674	1.44654226125137
GO:0043473	pigmentation	 17	0.424058507911188	1	3	14	908	5664	1.27636081875121
GO:0043484	regulation of RNA splicing	 19	0.500137274055772	1	3	16	908	5662	1.14200704835635
GO:0043488	regulation of mRNA stability	 46	0.299044281917277	1	8	38	903	5640	1.25786283587076
GO:0043491	protein kinase B signaling	 15	0.634731522702541	1	2	13	909	5665	0.964361507500915
GO:0043495	protein membrane anchor	  5	0.524912504930412	1	1	4	910	5674	1.44654226125137
GO:0043497	regulation of protein heterodimerization activity	  5	1	1	0	5	911	5673	0
GO:0043507	positive regulation of JUN kinase activity	 11	0.462079859473656	1	2	9	909	5669	1.31503841931943
GO:0043508	negative regulation of JUN kinase activity	  7	1	1	0	7	911	5671	0
GO:0043517	positive regulation of DNA damage response, signal transduction by p53 class mediator	  7	0.00897649165613564	0.780954774083801	4	3	907	5675	4.13297788928963
GO:0043518	negative regulation of DNA damage response, signal transduction by p53 class mediator	  5	0.143519565197953	1	2	3	909	5675	2.89308452250274
GO:0043523	regulation of neuron apoptotic process	  9	1	1	0	9	911	5669	0
GO:0043524	negative regulation of neuron apoptotic process	 74	0.954221816816876	1	6	68	905	5610	0.586436051858664
GO:0043525	positive regulation of neuron apoptotic process	 22	0.178553616091294	1	5	17	906	5661	1.64379802414929
GO:0043531	ADP binding	 15	0.142496215955173	1	4	11	907	5667	1.92872301500183
GO:0043536	positive regulation of blood vessel endothelial cell migration	  8	0.305579489538918	1	2	6	909	5672	1.80817782656422
GO:0043537	negative regulation of blood vessel endothelial cell migration	  7	1	1	0	7	911	5671	0
GO:0043539	protein serine/threonine kinase activator activity	 11	0.805664391834832	1	1	10	910	5668	0.657519209659715
GO:0043542	endothelial cell migration	 13	0.855768388602616	1	1	12	910	5666	0.556362408173605
GO:0043548	phosphatidylinositol 3-kinase binding	 15	0.344361377150163	1	3	12	908	5666	1.44654226125137
GO:0043552	positive regulation of phosphatidylinositol 3-kinase activity	 16	1	1	0	16	911	5662	0
GO:0043559	insulin binding	  5	0.143519565197953	1	2	3	909	5675	2.89308452250274
GO:0043560	insulin receptor substrate binding	 10	0.411940837929264	1	2	8	909	5670	1.44654226125137
GO:0043568	positive regulation of insulin-like growth factor receptor signaling pathway	  6	1	1	0	6	911	5672	0
GO:0043586	tongue development	  5	1	1	0	5	911	5673	0
GO:0043588	skin development	 21	0.808458104218592	1	2	19	909	5659	0.688829648214939
GO:0043621	protein self-association	 25	0.879045586415537	1	2	23	909	5655	0.578616904500549
GO:0043623	cellular protein complex assembly	  8	0.696113996849696	1	1	7	910	5671	0.904088913282108
GO:0043627	response to estrogen	 26	0.892479153310945	1	2	24	909	5654	0.556362408173605
GO:0043647	inositol phosphate metabolic process	 25	0.879045586415537	1	2	23	909	5655	0.578616904500549
GO:0043651	linoleic acid metabolic process	  6	0.590648335429865	1	1	5	910	5673	1.20545188437614
GO:0043657	host cell	 29	0.372755593071474	1	5	24	906	5654	1.24701919073394
GO:0043679	axon terminus	 36	0.379355854827396	1	6	30	905	5648	1.20545188437614
GO:0043923	positive regulation by host of viral transcription	 10	0.411940837929264	1	2	8	909	5670	1.44654226125137
GO:0043928	exonucleolytic nuclear-transcribed mRNA catabolic process involved in deadenylation-dependent decay	 11	0.186315240979503	1	3	8	908	5670	1.97255762897914
GO:0043931	ossification involved in bone maturation	  5	1	1	0	5	911	5673	0
GO:0043949	regulation of cAMP-mediated signaling	  5	1	1	0	5	911	5673	0
GO:0043966	histone H3 acetylation	 15	0.634731522702541	1	2	13	909	5665	0.964361507500915
GO:0043967	histone H4 acetylation	 11	0.462079859473656	1	2	9	909	5669	1.31503841931943
GO:0043968	histone H2A acetylation	  5	0.524912504930412	1	1	4	910	5674	1.44654226125137
GO:0043981	histone H4-K5 acetylation	  6	0.0380919907275585	1	3	3	908	5675	3.61635565312843
GO:0043982	histone H4-K8 acetylation	  6	0.0380919907275585	1	3	3	908	5675	3.61635565312843
GO:0043984	histone H4-K16 acetylation	  5	0.0212050012661332	1	3	2	908	5676	4.33962678375412
GO:0044070	regulation of anion transport	  6	1	1	0	6	911	5672	0
GO:0044130	negative regulation of growth of symbiont in host	  6	1	1	0	6	911	5672	0
GO:0044183	protein binding involved in protein folding	 15	0.0454641532950084	1	5	10	906	5668	2.41090376875229
GO:0044212	transcription regulatory region DNA binding	 98	0.189646280792438	1	17	81	894	5597	1.25465400210578
GO:0044224	juxtaparanode region of axon	  9	0.738180574705634	1	1	8	910	5670	0.803634589584096
GO:0044233	ER-mitochondrion membrane contact site	  5	0.524912504930412	1	1	4	910	5674	1.44654226125137
GO:0044257	cellular protein catabolic process	  5	0.524912504930412	1	1	4	910	5674	1.44654226125137
GO:0044267	cellular protein metabolic process	 71	0.784066282970878	1	8	63	903	5615	0.814953386620491
GO:0044291	cell-cell contact zone	 10	0.411940837929264	1	2	8	909	5670	1.44654226125137
GO:0044294	dendritic growth cone	  5	1	1	0	5	911	5673	0
GO:0044295	axonal growth cone	 15	0.634731522702541	1	2	13	909	5665	0.964361507500915
GO:0044297	cell body	 47	0.479200546225214	1	7	40	904	5638	1.07721232220847
GO:0044306	neuron projection terminus	 12	0.509611316519668	1	2	10	909	5668	1.20545188437614
GO:0044320	cellular response to leptin stimulus	  5	0.524912504930412	1	1	4	910	5674	1.44654226125137
GO:0044321	response to leptin	  8	0.0862825209590832	1	3	5	908	5673	2.71226673984632
GO:0044322	endoplasmic reticulum quality control compartment	 10	0.0382414370390818	1	4	6	907	5672	2.89308452250274
GO:0044325	ion channel binding	 71	0.784066282970878	1	8	63	903	5615	0.814953386620491
GO:0044327	dendritic spine head	  7	0.250755247393959	1	2	5	909	5673	2.06648894464482
GO:0044342	type B pancreatic cell proliferation	  5	1	1	0	5	911	5673	0
GO:0044344	cellular response to fibroblast growth factor stimulus	 19	0.760858269222929	1	2	17	909	5661	0.761338032237564
GO:0044389	ubiquitin-like protein ligase binding	  6	0.19623335243315	1	2	4	909	5674	2.41090376875229
GO:0044458	motile cilium assembly	  9	0.738180574705634	1	1	8	910	5670	0.803634589584096
GO:0044548	S100 protein binding	 11	0.462079859473656	1	2	9	909	5669	1.31503841931943
GO:0044754	autolysosome	  7	1	1	0	7	911	5671	0
GO:0044782	cilium organization	  5	0.524912504930412	1	1	4	910	5674	1.44654226125137
GO:0044804	autophagy of nucleus	  6	1	1	0	6	911	5672	0
GO:0044849	estrous cycle	  7	1	1	0	7	911	5671	0
GO:0044853	plasma membrane raft	  8	0.305579489538918	1	2	6	909	5672	1.80817782656422
GO:0045010	actin nucleation	  5	1	1	0	5	911	5673	0
GO:0045019	negative regulation of nitric oxide biosynthetic process	  5	1	1	0	5	911	5673	0
GO:0045022	early endosome to late endosome transport	  8	0.696113996849696	1	1	7	910	5671	0.904088913282108
GO:0045028	G-protein coupled purinergic nucleotide receptor activity	  5	1	1	0	5	911	5673	0
GO:0045047	protein targeting to ER	  5	0.524912504930412	1	1	4	910	5674	1.44654226125137
GO:0045055	regulated exocytosis	 10	1	1	0	10	911	5668	0
GO:0045056	transcytosis	  7	0.00897649165613564	0.780954774083801	4	3	907	5675	4.13297788928963
GO:0045060	negative thymic T cell selection	  5	1	1	0	5	911	5673	0
GO:0045070	positive regulation of viral genome replication	 10	0.774429434347452	1	1	9	910	5669	0.723271130625686
GO:0045071	negative regulation of viral genome replication	 24	1	1	0	24	911	5654	0
GO:0045088	regulation of innate immune response	  8	1	1	0	8	911	5670	0
GO:0045089	positive regulation of innate immune response	 10	0.411940837929264	1	2	8	909	5670	1.44654226125137
GO:0045104	intermediate filament cytoskeleton organization	  7	0.647297183435849	1	1	6	910	5672	1.03324447232241
GO:0045109	intermediate filament organization	  8	0.0862825209590832	1	3	5	908	5673	2.71226673984632
GO:0045111	intermediate filament cytoskeleton	 22	0.362393330345516	1	4	18	907	5660	1.31503841931943
GO:0045116	protein neddylation	  6	0.590648335429865	1	1	5	910	5673	1.20545188437614
GO:0045165	cell fate commitment	 13	0.855768388602616	1	1	12	910	5666	0.556362408173605
GO:0045171	intercellular bridge	 14	0.875749379780082	1	1	13	910	5665	0.516622236161204
GO:0045176	apical protein localization	  5	0.524912504930412	1	1	4	910	5674	1.44654226125137
GO:0045177	apical part of cell	 46	0.963168595062054	1	3	43	908	5635	0.471698563451534
GO:0045178	basal part of cell	  7	0.647297183435849	1	1	6	910	5672	1.03324447232241
GO:0045182	translation regulator activity	  5	0.524912504930412	1	1	4	910	5674	1.44654226125137
GO:0045184	establishment of protein localization	 19	0.262946555916241	1	4	15	907	5663	1.52267606447513
GO:0045190	isotype switching	  7	0.250755247393959	1	2	5	909	5673	2.06648894464482
GO:0045197	establishment or maintenance of epithelial cell apical/basal polarity	  6	1	1	0	6	911	5672	0
GO:0045199	maintenance of epithelial cell apical/basal polarity	  6	1	1	0	6	911	5672	0
GO:0045214	sarcomere organization	 13	0.855768388602616	1	1	12	910	5666	0.556362408173605
GO:0045216	cell-cell junction organization	  7	1	1	0	7	911	5671	0
GO:0045261	proton-transporting ATP synthase complex, catalytic core F(1)	  5	0.0212050012661332	1	3	2	908	5676	4.33962678375412
GO:0045295	gamma-catenin binding	  5	0.524912504930412	1	1	4	910	5674	1.44654226125137
GO:0045332	phospholipid translocation	 11	0.805664391834832	1	1	10	910	5668	0.657519209659715
GO:0045333	cellular respiration	 10	0.774429434347452	1	1	9	910	5669	0.723271130625686
GO:0045335	phagocytic vesicle	 31	0.941131570135982	1	2	29	909	5649	0.466626535887539
GO:0045429	positive regulation of nitric oxide biosynthetic process	 24	0.428813160555296	1	4	20	907	5658	1.20545188437614
GO:0045444	fat cell differentiation	 39	0.00490904410245537	0.682033737744821	12	27	899	5651	2.22544963269442
GO:0045445	myoblast differentiation	  6	0.590648335429865	1	1	5	910	5673	1.20545188437614
GO:0045446	endothelial cell differentiation	  6	1	1	0	6	911	5672	0
GO:0045453	bone resorption	  9	1	1	0	9	911	5669	0
GO:0045454	cell redox homeostasis	 33	0.301378346214684	1	6	27	905	5651	1.31503841931943
GO:0045471	response to ethanol	 42	0.0561111841194804	1	10	32	901	5646	1.72207412053735
GO:0045475	locomotor rhythm	  5	1	1	0	5	911	5673	0
GO:0045494	photoreceptor cell maintenance	 14	0.596015503295557	1	2	12	909	5666	1.03324447232241
GO:0045499	chemorepellent activity	  6	0.590648335429865	1	1	5	910	5673	1.20545188437614
GO:0045503	dynein light chain binding	 10	1	1	0	10	911	5668	0
GO:0045504	dynein heavy chain binding	  8	0.696113996849696	1	1	7	910	5671	0.904088913282108
GO:0045505	dynein intermediate chain binding	  8	0.696113996849696	1	1	7	910	5671	0.904088913282108
GO:0045540	regulation of cholesterol biosynthetic process	 21	0.00497137010971835	0.682033737744821	8	13	903	5665	2.75531859285976
GO:0045576	mast cell activation	  5	0.524912504930412	1	1	4	910	5674	1.44654226125137
GO:0045579	positive regulation of B cell differentiation	  5	1	1	0	5	911	5673	0
GO:0045591	positive regulation of regulatory T cell differentiation	  5	1	1	0	5	911	5673	0
GO:0045595	regulation of cell differentiation	 16	0.384511432262289	1	3	13	908	5665	1.35613336992316
GO:0045596	negative regulation of cell differentiation	 16	0.907797453739348	1	1	15	910	5663	0.452044456641054
GO:0045597	positive regulation of cell differentiation	 18	0.931586037139791	1	1	17	910	5661	0.401817294792048
GO:0045599	negative regulation of fat cell differentiation	 21	0.328967927753839	1	4	17	907	5661	1.37765929642988
GO:0045600	positive regulation of fat cell differentiation	 25	0.691930609011909	1	3	22	908	5656	0.867925356750823
GO:0045603	positive regulation of endothelial cell differentiation	  5	0.524912504930412	1	1	4	910	5674	1.44654226125137
GO:0045616	regulation of keratinocyte differentiation	  6	0.19623335243315	1	2	4	909	5674	2.41090376875229
GO:0045618	positive regulation of keratinocyte differentiation	  5	0.524912504930412	1	1	4	910	5674	1.44654226125137
GO:0045637	regulation of myeloid cell differentiation	  9	0.738180574705634	1	1	8	910	5670	0.803634589584096
GO:0045638	negative regulation of myeloid cell differentiation	 11	1	1	0	11	911	5667	0
GO:0045647	negative regulation of erythrocyte differentiation	  5	0.524912504930412	1	1	4	910	5674	1.44654226125137
GO:0045648	positive regulation of erythrocyte differentiation	 12	0.509611316519668	1	2	10	909	5668	1.20545188437614
GO:0045652	regulation of megakaryocyte differentiation	 25	0.120813426395119	1	6	19	905	5659	1.73585071350165
GO:0045662	negative regulation of myoblast differentiation	 10	0.411940837929264	1	2	8	909	5670	1.44654226125137
GO:0045663	positive regulation of myoblast differentiation	  7	0.250755247393959	1	2	5	909	5673	2.06648894464482
GO:0045664	regulation of neuron differentiation	 10	0.774429434347452	1	1	9	910	5669	0.723271130625686
GO:0045665	negative regulation of neuron differentiation	 28	0.915282449919722	1	2	26	909	5652	0.516622236161204
GO:0045666	positive regulation of neuron differentiation	 34	0.327141364371216	1	6	28	905	5650	1.27636081875121
GO:0045667	regulation of osteoblast differentiation	  5	0.524912504930412	1	1	4	910	5674	1.44654226125137
GO:0045668	negative regulation of osteoblast differentiation	 17	0.424058507911188	1	3	14	908	5664	1.27636081875121
GO:0045669	positive regulation of osteoblast differentiation	 34	0.867968636827923	1	3	31	908	5647	0.638180409375605
GO:0045670	regulation of osteoclast differentiation	  6	1	1	0	6	911	5672	0
GO:0045671	negative regulation of osteoclast differentiation	 10	0.411940837929264	1	2	8	909	5670	1.44654226125137
GO:0045672	positive regulation of osteoclast differentiation	  7	0.647297183435849	1	1	6	910	5672	1.03324447232241
GO:0045717	negative regulation of fatty acid biosynthetic process	  8	1	1	0	8	911	5670	0
GO:0045722	positive regulation of gluconeogenesis	  6	0.19623335243315	1	2	4	909	5674	2.41090376875229
GO:0045723	positive regulation of fatty acid biosynthetic process	  5	1	1	0	5	911	5673	0
GO:0045725	positive regulation of glycogen biosynthetic process	 10	0.150143518293906	1	3	7	908	5671	2.16981339187706
GO:0045727	positive regulation of translation	 25	0.0476838836623241	1	7	18	904	5660	2.02515916575192
GO:0045732	positive regulation of protein catabolic process	 26	0.285970151784858	1	5	21	906	5657	1.39090602043401
GO:0045736	negative regulation of cyclin-dependent protein serine/threonine kinase activity	 11	0.805664391834832	1	1	10	910	5668	0.657519209659715
GO:0045737	positive regulation of cyclin-dependent protein serine/threonine kinase activity	 15	0.0454641532950084	1	5	10	906	5668	2.41090376875229
GO:0045739	positive regulation of DNA repair	 12	0.509611316519668	1	2	10	909	5668	1.20545188437614
GO:0045740	positive regulation of DNA replication	 18	0.733413953942175	1	2	16	909	5662	0.803634589584096
GO:0045742	positive regulation of epidermal growth factor receptor signaling pathway	  9	0.359581374002193	1	2	7	909	5671	1.60726917916819
GO:0045744	negative regulation of G-protein coupled receptor protein signaling pathway	  6	1	1	0	6	911	5672	0
GO:0045746	negative regulation of Notch signaling pathway	 10	0.774429434347452	1	1	9	910	5669	0.723271130625686
GO:0045747	positive regulation of Notch signaling pathway	 16	1	1	0	16	911	5662	0
GO:0045765	regulation of angiogenesis	 18	0.931586037139791	1	1	17	910	5661	0.401817294792048
GO:0045766	positive regulation of angiogenesis	 56	0.672114467783812	1	7	49	904	5629	0.904088913282107
GO:0045773	positive regulation of axon extension	 18	0.733413953942175	1	2	16	909	5662	0.803634589584096
GO:0045776	negative regulation of blood pressure	  7	0.250755247393959	1	2	5	909	5673	2.06648894464482
GO:0045778	positive regulation of ossification	  8	0.305579489538918	1	2	6	909	5672	1.80817782656422
GO:0045779	negative regulation of bone resorption	  5	1	1	0	5	911	5673	0
GO:0045780	positive regulation of bone resorption	  8	1	1	0	8	911	5670	0
GO:0045785	positive regulation of cell adhesion	 20	0.536209630921365	1	3	17	908	5661	1.08490669593853
GO:0045786	negative regulation of cell cycle	 18	0.733413953942175	1	2	16	909	5662	0.803634589584096
GO:0045787	positive regulation of cell cycle	 21	0.328967927753839	1	4	17	907	5661	1.37765929642988
GO:0045793	positive regulation of cell size	  5	1	1	0	5	911	5673	0
GO:0045794	negative regulation of cell volume	  5	1	1	0	5	911	5673	0
GO:0045806	negative regulation of endocytosis	  6	1	1	0	6	911	5672	0
GO:0045807	positive regulation of endocytosis	 12	0.509611316519668	1	2	10	909	5668	1.20545188437614
GO:0045814	negative regulation of gene expression, epigenetic	  8	0.696113996849696	1	1	7	910	5671	0.904088913282108
GO:0045815	positive regulation of gene expression, epigenetic	 18	0.462686108033741	1	3	15	908	5663	1.20545188437614
GO:0045821	positive regulation of glycolytic process	  9	0.738180574705634	1	1	8	910	5670	0.803634589584096
GO:0045822	negative regulation of heart contraction	  5	1	1	0	5	911	5673	0
GO:0045830	positive regulation of isotype switching	  5	1	1	0	5	911	5673	0
GO:0045840	positive regulation of mitotic nuclear division	  8	0.696113996849696	1	1	7	910	5671	0.904088913282108
GO:0045859	regulation of protein kinase activity	 23	0.203944604492174	1	5	18	906	5660	1.57232854483845
GO:0045860	positive regulation of protein kinase activity	 29	0.785423643074026	1	3	26	908	5652	0.748211514440365
GO:0045861	negative regulation of proteolysis	  8	0.696113996849696	1	1	7	910	5671	0.904088913282108
GO:0045862	positive regulation of proteolysis	  6	0.590648335429865	1	1	5	910	5673	1.20545188437614
GO:0045879	negative regulation of smoothened signaling pathway	 10	0.774429434347452	1	1	9	910	5669	0.723271130625686
GO:0045880	positive regulation of smoothened signaling pathway	  7	0.647297183435849	1	1	6	910	5672	1.03324447232241
GO:0045907	positive regulation of vasoconstriction	  8	1	1	0	8	911	5670	0
GO:0045921	positive regulation of exocytosis	 16	0.907797453739348	1	1	15	910	5663	0.452044456641054
GO:0045926	negative regulation of growth	  9	1	1	0	9	911	5669	0
GO:0045930	negative regulation of mitotic cell cycle	 10	0.774429434347452	1	1	9	910	5669	0.723271130625686
GO:0045931	positive regulation of mitotic cell cycle	 13	0.554297337812073	1	2	11	909	5667	1.11272481634721
GO:0045943	positive regulation of transcription from RNA polymerase I promoter	  6	1	1	0	6	911	5672	0
GO:0045947	negative regulation of translational initiation	  7	1	1	0	7	911	5671	0
GO:0045948	positive regulation of translational initiation	  7	1	1	0	7	911	5671	0
GO:0045954	positive regulation of natural killer cell mediated cytotoxicity	  5	1	1	0	5	911	5673	0
GO:0045956	positive regulation of calcium ion-dependent exocytosis	 11	1	1	0	11	911	5667	0
GO:0045995	regulation of embryonic development	  5	0.143519565197953	1	2	3	909	5675	2.89308452250274
GO:0046007	negative regulation of activated T cell proliferation	  5	0.143519565197953	1	2	3	909	5675	2.89308452250274
GO:0046034	ATP metabolic process	 19	0.110822824981617	1	5	14	906	5664	1.90334508059391
GO:0046037	GMP metabolic process	  8	1	1	0	8	911	5670	0
GO:0046039	GTP metabolic process	 10	0.774429434347452	1	1	9	910	5669	0.723271130625686
GO:0046069	cGMP catabolic process	  5	1	1	0	5	911	5673	0
GO:0046323	glucose import	  6	1	1	0	6	911	5672	0
GO:0046324	regulation of glucose import	  5	0.524912504930412	1	1	4	910	5674	1.44654226125137
GO:0046326	positive regulation of glucose import	 14	0.303988344911165	1	3	11	908	5667	1.54986670848361
GO:0046328	regulation of JNK cascade	 12	0.832578307772574	1	1	11	910	5667	0.602725942188072
GO:0046329	negative regulation of JNK cascade	 11	0.805664391834832	1	1	10	910	5668	0.657519209659715
GO:0046330	positive regulation of JNK cascade	 24	0.864076388223246	1	2	22	909	5656	0.602725942188072
GO:0046332	SMAD binding	 30	0.227040830442229	1	6	24	905	5654	1.44654226125137
GO:0046426	negative regulation of JAK-STAT cascade	 20	0.785819229034214	1	2	18	909	5660	0.723271130625686
GO:0046427	positive regulation of JAK-STAT cascade	  5	1	1	0	5	911	5673	0
GO:0046470	phosphatidylcholine metabolic process	  5	1	1	0	5	911	5673	0
GO:0046474	glycerophospholipid biosynthetic process	  5	0.524912504930412	1	1	4	910	5674	1.44654226125137
GO:0046475	glycerophospholipid catabolic process	  6	0.19623335243315	1	2	4	909	5674	2.41090376875229
GO:0046488	phosphatidylinositol metabolic process	 15	0.892964940999907	1	1	14	910	5664	0.482180753750457
GO:0046513	ceramide biosynthetic process	 12	0.832578307772574	1	1	11	910	5667	0.602725942188072
GO:0046578	regulation of Ras protein signal transduction	  5	1	1	0	5	911	5673	0
GO:0046579	positive regulation of Ras protein signal transduction	 11	1	1	0	11	911	5667	0
GO:0046580	negative regulation of Ras protein signal transduction	 10	0.150143518293906	1	3	7	908	5671	2.16981339187706
GO:0046620	regulation of organ growth	  7	0.250755247393959	1	2	5	909	5673	2.06648894464482
GO:0046621	negative regulation of organ growth	  5	0.143519565197953	1	2	3	909	5675	2.89308452250274
GO:0046627	negative regulation of insulin receptor signaling pathway	 12	1	1	0	12	911	5666	0
GO:0046628	positive regulation of insulin receptor signaling pathway	  6	0.590648335429865	1	1	5	910	5673	1.20545188437614
GO:0046632	alpha-beta T cell differentiation	  5	0.524912504930412	1	1	4	910	5674	1.44654226125137
GO:0046638	positive regulation of alpha-beta T cell differentiation	  5	1	1	0	5	911	5673	0
GO:0046653	tetrahydrofolate metabolic process	  5	1	1	0	5	911	5673	0
GO:0046655	folic acid metabolic process	  7	0.250755247393959	1	2	5	909	5673	2.06648894464482
GO:0046658	anchored component of plasma membrane	  9	1	1	0	9	911	5669	0
GO:0046676	negative regulation of insulin secretion	 14	0.875749379780082	1	1	13	910	5665	0.516622236161204
GO:0046677	response to antibiotic	 13	0.855768388602616	1	1	12	910	5666	0.556362408173605
GO:0046685	response to arsenic-containing substance	  7	0.647297183435849	1	1	6	910	5672	1.03324447232241
GO:0046686	response to cadmium ion	 13	0.0930371570174248	1	4	9	907	5669	2.22544963269442
GO:0046688	response to copper ion	  6	0.590648335429865	1	1	5	910	5673	1.20545188437614
GO:0046696	lipopolysaccharide receptor complex	  5	1	1	0	5	911	5673	0
GO:0046697	decidualization	 10	0.774429434347452	1	1	9	910	5669	0.723271130625686
GO:0046710	GDP metabolic process	  8	1	1	0	8	911	5670	0
GO:0046716	muscle cell cellular homeostasis	  8	0.696113996849696	1	1	7	910	5671	0.904088913282108
GO:0046718	viral entry into host cell	 42	0.985275287038128	1	2	40	909	5638	0.34441482410747
GO:0046755	viral budding	  5	1	1	0	5	911	5673	0
GO:0046777	protein autophosphorylation	 82	0.342161999276587	1	13	69	898	5609	1.14664935343097
GO:0046785	microtubule polymerization	  5	0.524912504930412	1	1	4	910	5674	1.44654226125137
GO:0046825	regulation of protein export from nucleus	  5	0.524912504930412	1	1	4	910	5674	1.44654226125137
GO:0046827	positive regulation of protein export from nucleus	 12	0.224422574243593	1	3	9	908	5669	1.80817782656421
GO:0046834	lipid phosphorylation	  7	0.250755247393959	1	2	5	909	5673	2.06648894464482
GO:0046835	carbohydrate phosphorylation	  7	0.250755247393959	1	2	5	909	5673	2.06648894464482
GO:0046839	phospholipid dephosphorylation	  8	1	1	0	8	911	5670	0
GO:0046847	filopodium assembly	 10	0.411940837929264	1	2	8	909	5670	1.44654226125137
GO:0046854	phosphatidylinositol phosphorylation	 43	0.557432876463993	1	6	37	905	5641	1.00921553110561
GO:0046855	inositol phosphate dephosphorylation	  6	0.590648335429865	1	1	5	910	5673	1.20545188437614
GO:0046856	phosphatidylinositol dephosphorylation	 12	0.224422574243593	1	3	9	908	5669	1.80817782656421
GO:0046873	metal ion transmembrane transporter activity	  5	0.524912504930412	1	1	4	910	5674	1.44654226125137
GO:0046875	ephrin receptor binding	 16	0.907797453739348	1	1	15	910	5663	0.452044456641054
GO:0046887	positive regulation of hormone secretion	  6	1	1	0	6	911	5672	0
GO:0046889	positive regulation of lipid biosynthetic process	  5	1	1	0	5	911	5673	0
GO:0046902	regulation of mitochondrial membrane permeability	  7	0.647297183435849	1	1	6	910	5672	1.03324447232241
GO:0046903	secretion	  5	1	1	0	5	911	5673	0
GO:0046907	intracellular transport	 18	0.230920507298425	1	4	14	907	5664	1.60726917916819
GO:0046914	transition metal ion binding	  6	0.590648335429865	1	1	5	910	5673	1.20545188437614
GO:0046928	regulation of neurotransmitter secretion	 13	0.855768388602616	1	1	12	910	5666	0.556362408173605
GO:0046929	negative regulation of neurotransmitter secretion	  6	0.590648335429865	1	1	5	910	5673	1.20545188437614
GO:0046933	proton-transporting ATP synthase activity, rotational mechanism	 10	0.00689228204720671	0.768274064449573	5	5	906	5673	3.61635565312843
GO:0046934	phosphatidylinositol-4,5-bisphosphate 3-kinase activity	 26	0.493270603294985	1	4	22	907	5656	1.11272481634721
GO:0046949	fatty-acyl-CoA biosynthetic process	  5	0.0212050012661332	1	3	2	908	5676	4.33962678375412
GO:0046951	ketone body biosynthetic process	  5	0.524912504930412	1	1	4	910	5674	1.44654226125137
GO:0046961	proton-transporting ATPase activity, rotational mechanism	 14	0.596015503295557	1	2	12	909	5666	1.03324447232241
GO:0046965	retinoid X receptor binding	  6	0.0380919907275585	1	3	3	908	5675	3.61635565312843
GO:0046966	thyroid hormone receptor binding	 17	0.424058507911188	1	3	14	908	5664	1.27636081875121
GO:0046983	protein dimerization activity	 71	0.663218017693625	1	9	62	902	5616	0.916822559948053
GO:0047144	2-acylglycerol-3-phosphate O-acyltransferase activity	  5	1	1	0	5	911	5673	0
GO:0047372	acylglycerol lipase activity	  6	0.590648335429865	1	1	5	910	5673	1.20545188437614
GO:0047485	protein N-terminus binding	 45	0.431767890331025	1	7	38	904	5640	1.12508842541773
GO:0047496	vesicle transport along microtubule	  8	0.696113996849696	1	1	7	910	5671	0.904088913282108
GO:0047497	mitochondrion transport along microtubule	  5	0.524912504930412	1	1	4	910	5674	1.44654226125137
GO:0047555	3	  6	1	1	0	6	911	5672	0
GO:0048008	platelet-derived growth factor receptor signaling pathway	 15	1	1	0	15	911	5663	0
GO:0048009	insulin-like growth factor receptor signaling pathway	  8	0.305579489538918	1	2	6	909	5672	1.80817782656422
GO:0048010	vascular endothelial growth factor receptor signaling pathway	 35	0.880643242345177	1	3	32	908	5646	0.619946683393445
GO:0048011	neurotrophin TRK receptor signaling pathway	  5	1	1	0	5	911	5673	0
GO:0048013	ephrin receptor signaling pathway	 45	0.886756904660023	1	4	41	907	5637	0.642907671667276
GO:0048015	phosphatidylinositol-mediated signaling	 53	0.189087768304193	1	10	43	901	5635	1.3646625106145
GO:0048016	inositol phosphate-mediated signaling	  6	0.590648335429865	1	1	5	910	5673	1.20545188437614
GO:0048018	receptor ligand activity	  5	1	1	0	5	911	5673	0
GO:0048024	regulation of mRNA splicing, via spliceosome	  9	1	1	0	9	911	5669	0
GO:0048025	negative regulation of mRNA splicing, via spliceosome	 10	0.150143518293906	1	3	7	908	5671	2.16981339187706
GO:0048026	positive regulation of mRNA splicing, via spliceosome	  9	0.0257017750423318	1	4	5	907	5673	3.21453835833638
GO:0048037	cofactor binding	 11	0.805664391834832	1	1	10	910	5668	0.657519209659715
GO:0048038	quinone binding	  5	0.524912504930412	1	1	4	910	5674	1.44654226125137
GO:0048041	focal adhesion assembly	 15	0.634731522702541	1	2	13	909	5665	0.964361507500915
GO:0048066	developmental pigmentation	  7	0.647297183435849	1	1	6	910	5672	1.03324447232241
GO:0048103	somatic stem cell division	  5	0.524912504930412	1	1	4	910	5674	1.44654226125137
GO:0048146	positive regulation of fibroblast proliferation	 23	0.847425382793578	1	2	21	909	5657	0.628931417935379
GO:0048147	negative regulation of fibroblast proliferation	 17	0.703333082174572	1	2	15	909	5663	0.850907212500807
GO:0048148	behavioral response to cocaine	  8	0.305579489538918	1	2	6	909	5672	1.80817782656422
GO:0048167	regulation of synaptic plasticity	 22	1	1	0	22	911	5656	0
GO:0048168	regulation of neuronal synaptic plasticity	 13	0.855768388602616	1	1	12	910	5666	0.556362408173605
GO:0048169	regulation of long-term neuronal synaptic plasticity	 16	0.670477249908291	1	2	14	909	5664	0.904088913282108
GO:0048172	regulation of short-term neuronal synaptic plasticity	 10	0.411940837929264	1	2	8	909	5670	1.44654226125137
GO:0048185	activin binding	  7	0.250755247393959	1	2	5	909	5673	2.06648894464482
GO:0048193	Golgi vesicle transport	 10	0.411940837929264	1	2	8	909	5670	1.44654226125137
GO:0048208	COPII vesicle coating	 32	0.663761033636311	1	4	28	907	5650	0.904088913282108
GO:0048246	macrophage chemotaxis	  7	0.647297183435849	1	1	6	910	5672	1.03324447232241
GO:0048260	positive regulation of receptor-mediated endocytosis	 11	0.186315240979503	1	3	8	908	5670	1.97255762897914
GO:0048265	response to pain	  8	1	1	0	8	911	5670	0
GO:0048268	clathrin coat assembly	 12	0.832578307772574	1	1	11	910	5667	0.602725942188072
GO:0048278	vesicle docking	 12	0.224422574243593	1	3	9	908	5669	1.80817782656421
GO:0048280	vesicle fusion with Golgi apparatus	  6	0.19623335243315	1	2	4	909	5674	2.41090376875229
GO:0048286	lung alveolus development	 14	0.875749379780082	1	1	13	910	5665	0.516622236161204
GO:0048306	calcium-dependent protein binding	 28	0.181275299679347	1	6	22	905	5656	1.54986670848361
GO:0048312	intracellular distribution of mitochondria	  5	0.143519565197953	1	2	3	909	5675	2.89308452250274
GO:0048333	mesodermal cell differentiation	  7	1	1	0	7	911	5671	0
GO:0048365	Rac GTPase binding	 26	0.285970151784858	1	5	21	906	5657	1.39090602043401
GO:0048384	retinoic acid receptor signaling pathway	  6	1	1	0	6	911	5672	0
GO:0048407	platelet-derived growth factor binding	  5	1	1	0	5	911	5673	0
GO:0048468	cell development	 12	0.832578307772574	1	1	11	910	5667	0.602725942188072
GO:0048469	cell maturation	 17	0.920576476962146	1	1	16	910	5662	0.425453606250404
GO:0048477	oogenesis	  5	0.524912504930412	1	1	4	910	5674	1.44654226125137
GO:0048484	enteric nervous system development	  5	1	1	0	5	911	5673	0
GO:0048487	beta-tubulin binding	 19	0.262946555916241	1	4	15	907	5663	1.52267606447513
GO:0048488	synaptic vesicle endocytosis	 14	0.596015503295557	1	2	12	909	5666	1.03324447232241
GO:0048489	synaptic vesicle transport	  6	0.590648335429865	1	1	5	910	5673	1.20545188437614
GO:0048511	rhythmic process	 66	0.193796706240744	1	12	54	899	5624	1.31503841931943
GO:0048513	animal organ development	  5	0.143519565197953	1	2	3	909	5675	2.89308452250274
GO:0048514	blood vessel morphogenesis	 17	0.703333082174572	1	2	15	909	5663	0.850907212500807
GO:0048524	positive regulation of viral process	  5	1	1	0	5	911	5673	0
GO:0048536	spleen development	 14	0.303988344911165	1	3	11	908	5667	1.54986670848361
GO:0048538	thymus development	 18	0.733413953942175	1	2	16	909	5662	0.803634589584096
GO:0048545	response to steroid hormone	 15	0.634731522702541	1	2	13	909	5665	0.964361507500915
GO:0048546	digestive tract morphogenesis	  7	1	1	0	7	911	5671	0
GO:0048557	embryonic digestive tract morphogenesis	  8	0.305579489538918	1	2	6	909	5672	1.80817782656422
GO:0048565	digestive tract development	 15	1	1	0	15	911	5663	0
GO:0048566	embryonic digestive tract development	 10	0.774429434347452	1	1	9	910	5669	0.723271130625686
GO:0048568	embryonic organ development	 19	0.500137274055772	1	3	16	908	5662	1.14200704835635
GO:0048589	developmental growth	 11	0.186315240979503	1	3	8	908	5670	1.97255762897914
GO:0048593	camera-type eye morphogenesis	 13	0.263838199411443	1	3	10	908	5668	1.66908722452081
GO:0048596	embryonic camera-type eye morphogenesis	  6	0.590648335429865	1	1	5	910	5673	1.20545188437614
GO:0048598	embryonic morphogenesis	  8	1	1	0	8	911	5670	0
GO:0048660	regulation of smooth muscle cell proliferation	  6	0.19623335243315	1	2	4	909	5674	2.41090376875229
GO:0048661	positive regulation of smooth muscle cell proliferation	 35	0.732772844643882	1	4	31	907	5647	0.826595577857927
GO:0048662	negative regulation of smooth muscle cell proliferation	 13	0.554297337812073	1	2	11	909	5667	1.11272481634721
GO:0048663	neuron fate commitment	 13	0.554297337812073	1	2	11	909	5667	1.11272481634721
GO:0048666	neuron development	 33	0.161896669904934	1	7	26	904	5652	1.534211489206
GO:0048671	negative regulation of collateral sprouting	  5	1	1	0	5	911	5673	0
GO:0048675	axon extension	 16	1	1	0	16	911	5662	0
GO:0048678	response to axon injury	 14	0.875749379780082	1	1	13	910	5665	0.516622236161204
GO:0048681	negative regulation of axon regeneration	  5	0.524912504930412	1	1	4	910	5674	1.44654226125137
GO:0048699	generation of neurons	  8	0.696113996849696	1	1	7	910	5671	0.904088913282108
GO:0048701	embryonic cranial skeleton morphogenesis	 11	0.462079859473656	1	2	9	909	5669	1.31503841931943
GO:0048703	embryonic viscerocranium morphogenesis	  5	0.524912504930412	1	1	4	910	5674	1.44654226125137
GO:0048704	embryonic skeletal system morphogenesis	 12	1	1	0	12	911	5666	0
GO:0048705	skeletal system morphogenesis	 21	0.808458104218592	1	2	19	909	5659	0.688829648214939
GO:0048706	embryonic skeletal system development	  8	0.305579489538918	1	2	6	909	5672	1.80817782656422
GO:0048709	oligodendrocyte differentiation	 18	0.931586037139791	1	1	17	910	5661	0.401817294792048
GO:0048712	negative regulation of astrocyte differentiation	  6	0.19623335243315	1	2	4	909	5674	2.41090376875229
GO:0048714	positive regulation of oligodendrocyte differentiation	  6	1	1	0	6	911	5672	0
GO:0048715	negative regulation of oligodendrocyte differentiation	  6	0.590648335429865	1	1	5	910	5673	1.20545188437614
GO:0048738	cardiac muscle tissue development	  7	1	1	0	7	911	5671	0
GO:0048741	skeletal muscle fiber development	  7	0.647297183435849	1	1	6	910	5672	1.03324447232241
GO:0048745	smooth muscle tissue development	  9	0.738180574705634	1	1	8	910	5670	0.803634589584096
GO:0048747	muscle fiber development	  6	0.590648335429865	1	1	5	910	5673	1.20545188437614
GO:0048754	branching morphogenesis of an epithelial tube	  6	1	1	0	6	911	5672	0
GO:0048762	mesenchymal cell differentiation	  5	0.143519565197953	1	2	3	909	5675	2.89308452250274
GO:0048786	presynaptic active zone	 24	0.664264323067229	1	3	21	908	5657	0.904088913282107
GO:0048791	calcium ion-regulated exocytosis of neurotransmitter	 19	0.760858269222929	1	2	17	909	5661	0.761338032237564
GO:0048812	neuron projection morphogenesis	 28	0.915282449919722	1	2	26	909	5652	0.516622236161204
GO:0048813	dendrite morphogenesis	 29	1	1	0	29	911	5649	0
GO:0048814	regulation of dendrite morphogenesis	 10	1	1	0	10	911	5668	0
GO:0048821	erythrocyte development	 10	0.774429434347452	1	1	9	910	5669	0.723271130625686
GO:0048839	inner ear development	 28	0.915282449919722	1	2	26	909	5652	0.516622236161204
GO:0048844	artery morphogenesis	 11	0.0536855911323149	1	4	7	907	5671	2.63007683863886
GO:0048854	brain morphogenesis	  7	0.250755247393959	1	2	5	909	5673	2.06648894464482
GO:0048863	stem cell differentiation	  9	1	1	0	9	911	5669	0
GO:0048870	cell motility	 15	0.634731522702541	1	2	13	909	5665	0.964361507500915
GO:0048872	homeostasis of number of cells	  7	1	1	0	7	911	5671	0
GO:0048873	homeostasis of number of cells within a tissue	 11	0.462079859473656	1	2	9	909	5669	1.31503841931943
GO:0050072	m7G(5	  5	1	1	0	5	911	5673	0
GO:0050321	tau-protein kinase activity	  7	0.647297183435849	1	1	6	910	5672	1.03324447232241
GO:0050427	3	  5	0.524912504930412	1	1	4	910	5674	1.44654226125137
GO:0050431	transforming growth factor beta binding	 11	0.805664391834832	1	1	10	910	5668	0.657519209659715
GO:0050434	positive regulation of viral transcription	 10	0.774429434347452	1	1	9	910	5669	0.723271130625686
GO:0050435	amyloid-beta metabolic process	  7	0.647297183435849	1	1	6	910	5672	1.03324447232241
GO:0050482	arachidonic acid secretion	  6	1	1	0	6	911	5672	0
GO:0050660	flavin adenine dinucleotide binding	 26	0.285970151784858	1	5	21	906	5657	1.39090602043401
GO:0050661	NADP binding	 17	0.0742408303957595	1	5	12	906	5666	2.12726803125202
GO:0050662	coenzyme binding	  7	1	1	0	7	911	5671	0
GO:0050663	cytokine secretion	  5	0.524912504930412	1	1	4	910	5674	1.44654226125137
GO:0050673	epithelial cell proliferation	  6	1	1	0	6	911	5672	0
GO:0050679	positive regulation of epithelial cell proliferation	 23	0.847425382793578	1	2	21	909	5657	0.628931417935379
GO:0050680	negative regulation of epithelial cell proliferation	 32	0.839022338419681	1	3	29	908	5649	0.678066684961581
GO:0050681	androgen receptor binding	 22	0.362393330345516	1	4	18	907	5660	1.31503841931943
GO:0050690	regulation of defense response to virus by virus	 14	1	1	0	14	911	5664	0
GO:0050693	LBD domain binding	  5	1	1	0	5	911	5673	0
GO:0050699	WW domain binding	 11	0.186315240979503	1	3	8	908	5670	1.97255762897914
GO:0050707	regulation of cytokine secretion	  5	0.524912504930412	1	1	4	910	5674	1.44654226125137
GO:0050708	regulation of protein secretion	  6	0.590648335429865	1	1	5	910	5673	1.20545188437614
GO:0050709	negative regulation of protein secretion	  7	1	1	0	7	911	5671	0
GO:0050710	negative regulation of cytokine secretion	  5	1	1	0	5	911	5673	0
GO:0050714	positive regulation of protein secretion	 18	0.733413953942175	1	2	16	909	5662	0.803634589584096
GO:0050715	positive regulation of cytokine secretion	 11	0.805664391834832	1	1	10	910	5668	0.657519209659715
GO:0050718	positive regulation of interleukin-1 beta secretion	  9	0.738180574705634	1	1	8	910	5670	0.803634589584096
GO:0050727	regulation of inflammatory response	 26	0.979283024427103	1	1	25	910	5653	0.278181204086802
GO:0050728	negative regulation of inflammatory response	 28	0.984635614894456	1	1	27	910	5651	0.258311118080602
GO:0050729	positive regulation of inflammatory response	 30	0.988606390525596	1	1	29	910	5649	0.241090376875229
GO:0050730	regulation of peptidyl-tyrosine phosphorylation	  9	0.738180574705634	1	1	8	910	5670	0.803634589584096
GO:0050731	positive regulation of peptidyl-tyrosine phosphorylation	 39	0.457587888355617	1	6	33	905	5645	1.11272481634721
GO:0050732	negative regulation of peptidyl-tyrosine phosphorylation	  8	1	1	0	8	911	5670	0
GO:0050750	low-density lipoprotein particle receptor binding	 12	0.509611316519668	1	2	10	909	5668	1.20545188437614
GO:0050764	regulation of phagocytosis	  5	1	1	0	5	911	5673	0
GO:0050765	negative regulation of phagocytosis	  6	1	1	0	6	911	5672	0
GO:0050766	positive regulation of phagocytosis	 15	1	1	0	15	911	5663	0
GO:0050767	regulation of neurogenesis	 14	0.596015503295557	1	2	12	909	5666	1.03324447232241
GO:0050768	negative regulation of neurogenesis	  7	0.647297183435849	1	1	6	910	5672	1.03324447232241
GO:0050769	positive regulation of neurogenesis	 13	0.0246444305692994	1	5	8	906	5670	2.78181204086802
GO:0050770	regulation of axonogenesis	 14	0.875749379780082	1	1	13	910	5665	0.516622236161204
GO:0050771	negative regulation of axonogenesis	 12	1	1	0	12	911	5666	0
GO:0050772	positive regulation of axonogenesis	 16	0.907797453739348	1	1	15	910	5663	0.452044456641054
GO:0050773	regulation of dendrite development	  6	0.590648335429865	1	1	5	910	5673	1.20545188437614
GO:0050775	positive regulation of dendrite morphogenesis	 12	0.224422574243593	1	3	9	908	5669	1.80817782656421
GO:0050776	regulation of immune response	 43	0.998372320519341	1	1	42	910	5636	0.168202588517601
GO:0050777	negative regulation of immune response	  6	1	1	0	6	911	5672	0
GO:0050786	RAGE receptor binding	  8	0.696113996849696	1	1	7	910	5671	0.904088913282108
GO:0050790	regulation of catalytic activity	 58	0.409991004150996	1	9	49	902	5629	1.12231727166055
GO:0050796	regulation of insulin secretion	 31	0.251194068730157	1	6	25	905	5653	1.39987960766262
GO:0050804	modulation of chemical synaptic transmission	 15	0.634731522702541	1	2	13	909	5665	0.964361507500915
GO:0050806	positive regulation of synaptic transmission	 10	0.774429434347452	1	1	9	910	5669	0.723271130625686
GO:0050808	synapse organization	 26	0.979283024427103	1	1	25	910	5653	0.278181204086802
GO:0050811	GABA receptor binding	 10	0.411940837929264	1	2	8	909	5670	1.44654226125137
GO:0050821	protein stabilization	 73	0.809496906155495	1	8	65	903	5613	0.792625896576094
GO:0050829	defense response to Gram-negative bacterium	 18	0.733413953942175	1	2	16	909	5662	0.803634589584096
GO:0050830	defense response to Gram-positive bacterium	 19	0.941070913135173	1	1	18	910	5660	0.380669016118782
GO:0050832	defense response to fungus	 11	0.805664391834832	1	1	10	910	5668	0.657519209659715
GO:0050839	cell adhesion molecule binding	 31	0.941131570135982	1	2	29	909	5649	0.466626535887539
GO:0050840	extracellular matrix binding	 15	0.892964940999907	1	1	14	910	5664	0.482180753750457
GO:0050848	regulation of calcium-mediated signaling	  6	1	1	0	6	911	5672	0
GO:0050852	T cell receptor signaling pathway	 54	0.633170008036815	1	7	47	904	5631	0.937573687848112
GO:0050853	B cell receptor signaling pathway	 11	1	1	0	11	911	5667	0
GO:0050860	negative regulation of T cell receptor signaling pathway	  8	0.696113996849696	1	1	7	910	5671	0.904088913282108
GO:0050861	positive regulation of B cell receptor signaling pathway	  5	1	1	0	5	911	5673	0
GO:0050868	negative regulation of T cell activation	  6	1	1	0	6	911	5672	0
GO:0050869	negative regulation of B cell activation	  5	1	1	0	5	911	5673	0
GO:0050870	positive regulation of T cell activation	 12	1	1	0	12	911	5666	0
GO:0050872	white fat cell differentiation	  8	0.305579489538918	1	2	6	909	5672	1.80817782656422
GO:0050873	brown fat cell differentiation	 17	0.920576476962146	1	1	16	910	5662	0.425453606250404
GO:0050880	regulation of blood vessel size	  9	0.738180574705634	1	1	8	910	5670	0.803634589584096
GO:0050884	neuromuscular process controlling posture	  7	1	1	0	7	911	5671	0
GO:0050885	neuromuscular process controlling balance	 22	0.362393330345516	1	4	18	907	5660	1.31503841931943
GO:0050890	cognition	 22	0.0725169732750274	1	6	16	905	5662	1.97255762897914
GO:0050896	response to stimulus	 33	0.688030862024796	1	4	29	907	5649	0.876692279546286
GO:0050900	leukocyte migration	 74	1	1	0	74	911	5604	0
GO:0050901	leukocyte tethering or rolling	  5	1	1	0	5	911	5673	0
GO:0050905	neuromuscular process	 11	1	1	0	11	911	5667	0
GO:0050918	positive chemotaxis	 11	0.462079859473656	1	2	9	909	5669	1.31503841931943
GO:0050919	negative chemotaxis	 12	1	1	0	12	911	5666	0
GO:0050927	positive regulation of positive chemotaxis	  6	0.590648335429865	1	1	5	910	5673	1.20545188437614
GO:0050930	induction of positive chemotaxis	  6	0.0380919907275585	1	3	3	908	5675	3.61635565312843
GO:0050965	detection of temperature stimulus involved in sensory perception of pain	  5	0.524912504930412	1	1	4	910	5674	1.44654226125137
GO:0050966	detection of mechanical stimulus involved in sensory perception of pain	  6	0.590648335429865	1	1	5	910	5673	1.20545188437614
GO:0050982	detection of mechanical stimulus	  6	0.590648335429865	1	1	5	910	5673	1.20545188437614
GO:0050998	nitric-oxide synthase binding	  9	0.738180574705634	1	1	8	910	5670	0.803634589584096
GO:0050999	regulation of nitric-oxide synthase activity	 16	0.384511432262289	1	3	13	908	5665	1.35613336992316
GO:0051000	positive regulation of nitric-oxide synthase activity	  5	1	1	0	5	911	5673	0
GO:0051004	regulation of lipoprotein lipase activity	  6	0.590648335429865	1	1	5	910	5673	1.20545188437614
GO:0051011	microtubule minus-end binding	  5	0.524912504930412	1	1	4	910	5674	1.44654226125137
GO:0051015	actin filament binding	 66	0.825752652269511	1	7	59	904	5619	0.767105744603
GO:0051016	barbed-end actin filament capping	  5	0.524912504930412	1	1	4	910	5674	1.44654226125137
GO:0051017	actin filament bundle assembly	 16	1	1	0	16	911	5662	0
GO:0051018	protein kinase A binding	 10	0.411940837929264	1	2	8	909	5670	1.44654226125137
GO:0051019	mitogen-activated protein kinase binding	  9	0.359581374002193	1	2	7	909	5671	1.60726917916819
GO:0051020	GTPase binding	 22	0.828939082355288	1	2	20	909	5658	0.657519209659715
GO:0051028	mRNA transport	 51	0.409191609838484	1	8	43	903	5635	1.13454295000108
GO:0051044	positive regulation of membrane protein ectodomain proteolysis	  7	1	1	0	7	911	5671	0
GO:0051056	regulation of small GTPase mediated signal transduction	 68	0.33615268162604	1	11	57	900	5621	1.16999741718861
GO:0051059	NF-kappaB binding	  8	0.696113996849696	1	1	7	910	5671	0.904088913282108
GO:0051082	unfolded protein binding	 51	0.085385346590235	1	11	40	900	5638	1.55999655625148
GO:0051085	chaperone mediated protein folding requiring cofactor	  5	0.524912504930412	1	1	4	910	5674	1.44654226125137
GO:0051087	chaperone binding	 45	0.604024670447671	1	6	39	905	5639	0.964361507500915
GO:0051090	regulation of sequence-specific DNA binding transcription factor activity	 17	0.424058507911188	1	3	14	908	5664	1.27636081875121
GO:0051091	positive regulation of sequence-specific DNA binding transcription factor activity	 48	0.970575823490813	1	3	45	908	5633	0.452044456641054
GO:0051092	positive regulation of NF-kappaB transcription factor activity	 60	0.601314652386293	1	8	52	903	5626	0.964361507500915
GO:0051117	ATPase binding	 34	0.711034261448715	1	4	30	907	5648	0.850907212500807
GO:0051123	RNA polymerase II transcriptional preinitiation complex assembly	 10	1	1	0	10	911	5668	0
GO:0051131	chaperone-mediated protein complex assembly	 11	0.462079859473656	1	2	9	909	5669	1.31503841931943
GO:0051145	smooth muscle cell differentiation	  5	1	1	0	5	911	5673	0
GO:0051149	positive regulation of muscle cell differentiation	 10	1	1	0	10	911	5668	0
GO:0051168	nuclear export	  8	0.696113996849696	1	1	7	910	5671	0.904088913282108
GO:0051170	nuclear import	  6	0.19623335243315	1	2	4	909	5674	2.41090376875229
GO:0051209	release of sequestered calcium ion into cytosol	 20	0.785819229034214	1	2	18	909	5660	0.723271130625686
GO:0051213	dioxygenase activity	 34	0.711034261448715	1	4	30	907	5648	0.850907212500807
GO:0051216	cartilage development	 29	0.58353593328048	1	4	25	907	5653	0.997615352587153
GO:0051219	phosphoprotein binding	 16	0.384511432262289	1	3	13	908	5665	1.35613336992316
GO:0051225	spindle assembly	 13	0.855768388602616	1	1	12	910	5666	0.556362408173605
GO:0051233	spindle midzone	  6	0.590648335429865	1	1	5	910	5673	1.20545188437614
GO:0051259	protein oligomerization	 38	0.0299373410043172	1	10	28	901	5650	1.90334508059391
GO:0051260	protein homooligomerization	 92	0.905491374275	1	9	83	902	5595	0.707547845177302
GO:0051262	protein tetramerization	 16	0.384511432262289	1	3	13	908	5665	1.35613336992316
GO:0051272	positive regulation of cellular component movement	  6	1	1	0	6	911	5672	0
GO:0051276	chromosome organization	 13	0.263838199411443	1	3	10	908	5668	1.66908722452081
GO:0051279	regulation of release of sequestered calcium ion into cytosol	  8	1	1	0	8	911	5670	0
GO:0051281	positive regulation of release of sequestered calcium ion into cytosol	 11	0.462079859473656	1	2	9	909	5669	1.31503841931943
GO:0051287	NAD binding	 21	0.000201594451909951	0.177264945402662	10	11	901	5667	3.4441482410747
GO:0051289	protein homotetramerization	 37	0.772514292573216	1	4	33	907	5645	0.781914735811553
GO:0051290	protein heterotetramerization	 13	0.554297337812073	1	2	11	909	5667	1.11272481634721
GO:0051291	protein heterooligomerization	 30	0.933483829552772	1	2	28	909	5650	0.482180753750457
GO:0051292	nuclear pore complex assembly	  7	1	1	0	7	911	5671	0
GO:0051298	centrosome duplication	 11	0.805664391834832	1	1	10	910	5668	0.657519209659715
GO:0051321	meiotic cell cycle	 21	0.018855363900725	1	7	14	904	5664	2.41090376875229
GO:0051371	muscle alpha-actinin binding	  7	0.647297183435849	1	1	6	910	5672	1.03324447232241
GO:0051384	response to glucocorticoid	 30	0.611480146770197	1	4	26	907	5652	0.964361507500915
GO:0051393	alpha-actinin binding	  8	0.696113996849696	1	1	7	910	5671	0.904088913282108
GO:0051402	neuron apoptotic process	 22	0.603648322851636	1	3	19	908	5659	0.986278814489572
GO:0051403	stress-activated MAPK cascade	 13	0.554297337812073	1	2	11	909	5667	1.11272481634721
GO:0051412	response to corticosterone	  6	0.19623335243315	1	2	4	909	5674	2.41090376875229
GO:0051415	interphase microtubule nucleation by interphase microtubule organizing center	  5	0.524912504930412	1	1	4	910	5674	1.44654226125137
GO:0051436	negative regulation of ubiquitin-protein ligase activity involved in mitotic cell cycle	 24	0.664264323067229	1	3	21	908	5657	0.904088913282107
GO:0051437	positive regulation of ubiquitin-protein ligase activity involved in regulation of mitotic cell cycle transition	 27	0.524340470700302	1	4	23	907	5655	1.07151278611213
GO:0051439	regulation of ubiquitin-protein ligase activity involved in mitotic cell cycle	  8	0.696113996849696	1	1	7	910	5671	0.904088913282108
GO:0051443	positive regulation of ubiquitin-protein transferase activity	  8	0.305579489538918	1	2	6	909	5672	1.80817782656422
GO:0051453	regulation of intracellular pH	 11	0.0536855911323149	1	4	7	907	5671	2.63007683863886
GO:0051480	regulation of cytosolic calcium ion concentration	 17	0.703333082174572	1	2	15	909	5663	0.850907212500807
GO:0051481	negative regulation of cytosolic calcium ion concentration	  5	1	1	0	5	911	5673	0
GO:0051482	positive regulation of cytosolic calcium ion concentration involved in phospholipase C-activating G-protein coupled signaling pathway	 10	1	1	0	10	911	5668	0
GO:0051489	regulation of filopodium assembly	  8	0.696113996849696	1	1	7	910	5671	0.904088913282108
GO:0051491	positive regulation of filopodium assembly	 19	0.500137274055772	1	3	16	908	5662	1.14200704835635
GO:0051492	regulation of stress fiber assembly	  7	0.647297183435849	1	1	6	910	5672	1.03324447232241
GO:0051493	regulation of cytoskeleton organization	 11	1	1	0	11	911	5667	0
GO:0051496	positive regulation of stress fiber assembly	 21	0.956281251912897	1	1	20	910	5658	0.34441482410747
GO:0051497	negative regulation of stress fiber assembly	  9	0.359581374002193	1	2	7	909	5671	1.60726917916819
GO:0051536	iron-sulfur cluster binding	 21	0.0594058306282263	1	6	15	905	5663	2.06648894464482
GO:0051537	2 iron, 2 sulfur cluster binding	  8	0.0862825209590832	1	3	5	908	5673	2.71226673984632
GO:0051539	4 iron, 4 sulfur cluster binding	 12	0.509611316519668	1	2	10	909	5668	1.20545188437614
GO:0051561	positive regulation of mitochondrial calcium ion concentration	  5	1	1	0	5	911	5673	0
GO:0051568	histone H3-K4 methylation	  6	0.590648335429865	1	1	5	910	5673	1.20545188437614
GO:0051571	positive regulation of histone H3-K4 methylation	  5	0.143519565197953	1	2	3	909	5675	2.89308452250274
GO:0051591	response to cAMP	 20	0.785819229034214	1	2	18	909	5660	0.723271130625686
GO:0051592	response to calcium ion	 31	0.638235698030361	1	4	27	907	5651	0.933253071775079
GO:0051602	response to electrical stimulus	 15	0.892964940999907	1	1	14	910	5664	0.482180753750457
GO:0051603	proteolysis involved in cellular protein catabolic process	 14	0.303988344911165	1	3	11	908	5667	1.54986670848361
GO:0051604	protein maturation	  7	1	1	0	7	911	5671	0
GO:0051607	defense response to virus	 82	0.818093086799891	1	9	73	902	5605	0.793834167759899
GO:0051642	centrosome localization	  7	1	1	0	7	911	5671	0
GO:0051693	actin filament capping	  8	0.696113996849696	1	1	7	910	5671	0.904088913282108
GO:0051721	protein phosphatase 2A binding	 14	0.596015503295557	1	2	12	909	5666	1.03324447232241
GO:0051726	regulation of cell cycle	 61	0.332099002906674	1	10	51	901	5627	1.1856903780749
GO:0051764	actin crosslink formation	  6	1	1	0	6	911	5672	0
GO:0051770	positive regulation of nitric-oxide synthase biosynthetic process	  8	1	1	0	8	911	5670	0
GO:0051775	response to redox state	  6	1	1	0	6	911	5672	0
GO:0051781	positive regulation of cell division	 19	0.941070913135173	1	1	18	910	5660	0.380669016118782
GO:0051787	misfolded protein binding	  5	0.143519565197953	1	2	3	909	5675	2.89308452250274
GO:0051865	protein autoubiquitination	 27	0.0690684444987743	1	7	20	904	5658	1.87514737569622
GO:0051879	Hsp90 protein binding	 14	0.596015503295557	1	2	12	909	5666	1.03324447232241
GO:0051881	regulation of mitochondrial membrane potential	 13	0.855768388602616	1	1	12	910	5666	0.556362408173605
GO:0051893	regulation of focal adhesion assembly	  8	0.305579489538918	1	2	6	909	5672	1.80817782656422
GO:0051894	positive regulation of focal adhesion assembly	 10	1	1	0	10	911	5668	0
GO:0051895	negative regulation of focal adhesion assembly	  9	0.738180574705634	1	1	8	910	5670	0.803634589584096
GO:0051896	regulation of protein kinase B signaling	  6	0.19623335243315	1	2	4	909	5674	2.41090376875229
GO:0051897	positive regulation of protein kinase B signaling	 36	0.892223627195809	1	3	33	908	5645	0.602725942188072
GO:0051898	negative regulation of protein kinase B signaling	 12	0.224422574243593	1	3	9	908	5669	1.80817782656421
GO:0051899	membrane depolarization	 12	0.832578307772574	1	1	11	910	5667	0.602725942188072
GO:0051901	positive regulation of mitochondrial depolarization	  6	1	1	0	6	911	5672	0
GO:0051924	regulation of calcium ion transport	 13	0.263838199411443	1	3	10	908	5668	1.66908722452081
GO:0051926	negative regulation of calcium ion transport	  6	1	1	0	6	911	5672	0
GO:0051928	positive regulation of calcium ion transport	  9	1	1	0	9	911	5669	0
GO:0051930	regulation of sensory perception of pain	 10	1	1	0	10	911	5668	0
GO:0051932	synaptic transmission, GABAergic	  5	1	1	0	5	911	5673	0
GO:0051959	dynein light intermediate chain binding	 10	0.774429434347452	1	1	9	910	5669	0.723271130625686
GO:0051964	negative regulation of synapse assembly	  5	1	1	0	5	911	5673	0
GO:0051965	positive regulation of synapse assembly	 38	0.912404932620371	1	3	35	908	5643	0.571003524178173
GO:0051966	regulation of synaptic transmission, glutamatergic	 13	1	1	0	13	911	5665	0
GO:0051968	positive regulation of synaptic transmission, glutamatergic	 13	0.554297337812073	1	2	11	909	5667	1.11272481634721
GO:0051973	positive regulation of telomerase activity	 21	0.808458104218592	1	2	19	909	5659	0.688829648214939
GO:0051983	regulation of chromosome segregation	  5	1	1	0	5	911	5673	0
GO:0052629	phosphatidylinositol-3,5-bisphosphate 3-phosphatase activity	  9	0.738180574705634	1	1	8	910	5670	0.803634589584096
GO:0052689	carboxylic ester hydrolase activity	 20	0.949242054403644	1	1	19	910	5659	0.361635565312843
GO:0055007	cardiac muscle cell differentiation	 14	0.875749379780082	1	1	13	910	5665	0.516622236161204
GO:0055010	ventricular cardiac muscle tissue morphogenesis	 12	0.224422574243593	1	3	9	908	5669	1.80817782656421
GO:0055037	recycling endosome	 53	0.874832235599814	1	5	48	906	5630	0.682331255307251
GO:0055038	recycling endosome membrane	 31	0.638235698030361	1	4	27	907	5651	0.933253071775079
GO:0055072	iron ion homeostasis	 21	0.956281251912897	1	1	20	910	5658	0.34441482410747
GO:0055074	calcium ion homeostasis	  8	1	1	0	8	911	5670	0
GO:0055088	lipid homeostasis	  8	0.696113996849696	1	1	7	910	5671	0.904088913282108
GO:0055089	fatty acid homeostasis	  6	0.19623335243315	1	2	4	909	5674	2.41090376875229
GO:0055093	response to hyperoxia	  6	1	1	0	6	911	5672	0
GO:0055117	regulation of cardiac muscle contraction	  5	0.524912504930412	1	1	4	910	5674	1.44654226125137
GO:0055119	relaxation of cardiac muscle	 10	1	1	0	10	911	5668	0
GO:0060009	Sertoli cell development	  6	0.590648335429865	1	1	5	910	5673	1.20545188437614
GO:0060013	righting reflex	  5	0.524912504930412	1	1	4	910	5674	1.44654226125137
GO:0060020	Bergmann glial cell differentiation	  5	0.524912504930412	1	1	4	910	5674	1.44654226125137
GO:0060021	palate development	 39	0.807455053346476	1	4	35	907	5643	0.741816544231473
GO:0060038	cardiac muscle cell proliferation	 10	0.0382414370390818	1	4	6	907	5672	2.89308452250274
GO:0060041	retina development in camera-type eye	 30	0.804750698218897	1	3	27	908	5651	0.723271130625686
GO:0060042	retina morphogenesis in camera-type eye	  7	1	1	0	7	911	5671	0
GO:0060044	negative regulation of cardiac muscle cell proliferation	  7	1	1	0	7	911	5671	0
GO:0060045	positive regulation of cardiac muscle cell proliferation	  8	0.305579489538918	1	2	6	909	5672	1.80817782656422
GO:0060048	cardiac muscle contraction	 14	1	1	0	14	911	5664	0
GO:0060055	angiogenesis involved in wound healing	  5	1	1	0	5	911	5673	0
GO:0060059	embryonic retina morphogenesis in camera-type eye	  5	0.524912504930412	1	1	4	910	5674	1.44654226125137
GO:0060070	canonical Wnt signaling pathway	 27	0.159915810494805	1	6	21	905	5657	1.60726917916819
GO:0060071	Wnt signaling pathway, planar cell polarity pathway	 39	0.289137274728175	1	7	32	904	5646	1.29817895240508
GO:0060074	synapse maturation	  5	0.143519565197953	1	2	3	909	5675	2.89308452250274
GO:0060075	regulation of resting membrane potential	  6	1	1	0	6	911	5672	0
GO:0060076	excitatory synapse	 18	1	1	0	18	911	5660	0
GO:0060077	inhibitory synapse	  6	0.590648335429865	1	1	5	910	5673	1.20545188437614
GO:0060078	regulation of postsynaptic membrane potential	 21	0.956281251912897	1	1	20	910	5658	0.34441482410747
GO:0060079	excitatory postsynaptic potential	 25	0.879045586415537	1	2	23	909	5655	0.578616904500549
GO:0060119	inner ear receptor cell development	  6	1	1	0	6	911	5672	0
GO:0060122	inner ear receptor stereocilium organization	 13	1	1	0	13	911	5665	0
GO:0060137	maternal process involved in parturition	  6	1	1	0	6	911	5672	0
GO:0060170	ciliary membrane	 22	0.828939082355288	1	2	20	909	5658	0.657519209659715
GO:0060173	limb development	 19	0.0377421978853749	1	6	13	905	5665	2.28401409671269
GO:0060213	positive regulation of nuclear-transcribed mRNA poly(A) tail shortening	  8	0.305579489538918	1	2	6	909	5672	1.80817782656422
GO:0060216	definitive hemopoiesis	  8	0.0862825209590832	1	3	5	908	5673	2.71226673984632
GO:0060236	regulation of mitotic spindle organization	  6	0.590648335429865	1	1	5	910	5673	1.20545188437614
GO:0060252	positive regulation of glial cell proliferation	  6	0.590648335429865	1	1	5	910	5673	1.20545188437614
GO:0060253	negative regulation of glial cell proliferation	  5	0.143519565197953	1	2	3	909	5675	2.89308452250274
GO:0060271	cilium assembly	 85	0.189650364661098	1	15	70	896	5608	1.27636081875121
GO:0060285	cilium-dependent cell motility	  5	1	1	0	5	911	5673	0
GO:0060291	long-term synaptic potentiation	 34	0.515505366345407	1	5	29	906	5649	1.06363401562601
GO:0060292	long term synaptic depression	  9	0.738180574705634	1	1	8	910	5670	0.803634589584096
GO:0060296	regulation of cilium beat frequency involved in ciliary motility	  5	0.524912504930412	1	1	4	910	5674	1.44654226125137
GO:0060306	regulation of membrane repolarization	  5	0.524912504930412	1	1	4	910	5674	1.44654226125137
GO:0060307	regulation of ventricular cardiac muscle cell membrane repolarization	  7	0.647297183435849	1	1	6	910	5672	1.03324447232241
GO:0060314	regulation of ryanodine-sensitive calcium-release channel activity	  9	1	1	0	9	911	5669	0
GO:0060315	negative regulation of ryanodine-sensitive calcium-release channel activity	  6	0.590648335429865	1	1	5	910	5673	1.20545188437614
GO:0060317	cardiac epithelial to mesenchymal transition	  6	0.590648335429865	1	1	5	910	5673	1.20545188437614
GO:0060324	face development	  8	0.696113996849696	1	1	7	910	5671	0.904088913282108
GO:0060325	face morphogenesis	 20	0.536209630921365	1	3	17	908	5661	1.08490669593853
GO:0060326	cell chemotaxis	 27	0.904515039752466	1	2	25	909	5653	0.535756393056064
GO:0060333	interferon-gamma-mediated signaling pathway	 37	0.405559436943373	1	6	31	905	5647	1.17287210371733
GO:0060334	regulation of interferon-gamma-mediated signaling pathway	  9	0.738180574705634	1	1	8	910	5670	0.803634589584096
GO:0060337	type I interferon signaling pathway	 37	0.772514292573216	1	4	33	907	5645	0.781914735811553
GO:0060338	regulation of type I interferon-mediated signaling pathway	  9	0.0257017750423318	1	4	5	907	5673	3.21453835833638
GO:0060340	positive regulation of type I interferon-mediated signaling pathway	  5	1	1	0	5	911	5673	0
GO:0060347	heart trabecula formation	  6	0.590648335429865	1	1	5	910	5673	1.20545188437614
GO:0060348	bone development	 22	0.603648322851636	1	3	19	908	5659	0.986278814489572
GO:0060349	bone morphogenesis	 11	0.462079859473656	1	2	9	909	5669	1.31503841931943
GO:0060384	innervation	 10	0.774429434347452	1	1	9	910	5669	0.723271130625686
GO:0060389	pathway-restricted SMAD protein phosphorylation	  8	0.305579489538918	1	2	6	909	5672	1.80817782656422
GO:0060391	positive regulation of SMAD protein import into nucleus	  8	0.305579489538918	1	2	6	909	5672	1.80817782656422
GO:0060394	negative regulation of pathway-restricted SMAD protein phosphorylation	  6	0.590648335429865	1	1	5	910	5673	1.20545188437614
GO:0060395	SMAD protein signal transduction	 26	0.717842783670638	1	3	23	908	5655	0.834543612260407
GO:0060396	growth hormone receptor signaling pathway	  5	1	1	0	5	911	5673	0
GO:0060397	JAK-STAT cascade involved in growth hormone signaling pathway	  5	1	1	0	5	911	5673	0
GO:0060402	calcium ion transport into cytosol	 10	0.774429434347452	1	1	9	910	5669	0.723271130625686
GO:0060412	ventricular septum morphogenesis	 18	0.462686108033741	1	3	15	908	5663	1.20545188437614
GO:0060413	atrial septum morphogenesis	  5	1	1	0	5	911	5673	0
GO:0060416	response to growth hormone	  7	1	1	0	7	911	5671	0
GO:0060425	lung morphogenesis	 10	1	1	0	10	911	5668	0
GO:0060441	epithelial tube branching involved in lung morphogenesis	  6	0.590648335429865	1	1	5	910	5673	1.20545188437614
GO:0060487	lung epithelial cell differentiation	  5	0.143519565197953	1	2	3	909	5675	2.89308452250274
GO:0060546	negative regulation of necroptotic process	  6	0.590648335429865	1	1	5	910	5673	1.20545188437614
GO:0060548	negative regulation of cell death	 33	0.854121486059169	1	3	30	908	5648	0.657519209659715
GO:0060586	multicellular organismal iron ion homeostasis	  5	1	1	0	5	911	5673	0
GO:0060612	adipose tissue development	 10	0.774429434347452	1	1	9	910	5669	0.723271130625686
GO:0060627	regulation of vesicle-mediated transport	  5	1	1	0	5	911	5673	0
GO:0060644	mammary gland epithelial cell differentiation	  7	0.647297183435849	1	1	6	910	5672	1.03324447232241
GO:0060674	placenta blood vessel development	  7	0.647297183435849	1	1	6	910	5672	1.03324447232241
GO:0060716	labyrinthine layer blood vessel development	  6	1	1	0	6	911	5672	0
GO:0060749	mammary gland alveolus development	  7	0.647297183435849	1	1	6	910	5672	1.03324447232241
GO:0060765	regulation of androgen receptor signaling pathway	  7	0.250755247393959	1	2	5	909	5673	2.06648894464482
GO:0060766	negative regulation of androgen receptor signaling pathway	  8	0.0862825209590832	1	3	5	908	5673	2.71226673984632
GO:0060828	regulation of canonical Wnt signaling pathway	 13	1	1	0	13	911	5665	0
GO:0060831	smoothened signaling pathway involved in dorsal/ventral neural tube patterning	  6	0.590648335429865	1	1	5	910	5673	1.20545188437614
GO:0060840	artery development	  5	1	1	0	5	911	5673	0
GO:0060964	regulation of gene silencing by miRNA	 30	0.933483829552772	1	2	28	909	5650	0.482180753750457
GO:0060976	coronary vasculature development	  8	0.696113996849696	1	1	7	910	5671	0.904088913282108
GO:0060996	dendritic spine development	  8	0.305579489538918	1	2	6	909	5672	1.80817782656422
GO:0060997	dendritic spine morphogenesis	  8	0.696113996849696	1	1	7	910	5671	0.904088913282108
GO:0060999	positive regulation of dendritic spine development	 15	1	1	0	15	911	5663	0
GO:0061001	regulation of dendritic spine morphogenesis	 10	0.774429434347452	1	1	9	910	5669	0.723271130625686
GO:0061002	negative regulation of dendritic spine morphogenesis	  5	0.524912504930412	1	1	4	910	5674	1.44654226125137
GO:0061003	positive regulation of dendritic spine morphogenesis	 16	0.0160121031228009	1	6	10	905	5668	2.71226673984632
GO:0061014	positive regulation of mRNA catabolic process	  8	1	1	0	8	911	5670	0
GO:0061025	membrane fusion	 23	0.00929965957506069	0.78980680248194	8	15	903	5663	2.51572567174152
GO:0061028	establishment of endothelial barrier	 10	1	1	0	10	911	5668	0
GO:0061029	eyelid development in camera-type eye	  6	1	1	0	6	911	5672	0
GO:0061036	positive regulation of cartilage development	  8	0.0862825209590832	1	3	5	908	5673	2.71226673984632
GO:0061045	negative regulation of wound healing	  9	0.738180574705634	1	1	8	910	5670	0.803634589584096
GO:0061049	cell growth involved in cardiac muscle cell development	  5	1	1	0	5	911	5673	0
GO:0061051	positive regulation of cell growth involved in cardiac muscle cell development	  5	1	1	0	5	911	5673	0
GO:0061053	somite development	  6	0.590648335429865	1	1	5	910	5673	1.20545188437614
GO:0061077	chaperone-mediated protein folding	 22	0.178553616091294	1	5	17	906	5661	1.64379802414929
GO:0061088	regulation of sequestering of zinc ion	  6	0.590648335429865	1	1	5	910	5673	1.20545188437614
GO:0061098	positive regulation of protein tyrosine kinase activity	 15	0.634731522702541	1	2	13	909	5665	0.964361507500915
GO:0061099	negative regulation of protein tyrosine kinase activity	  9	1	1	0	9	911	5669	0
GO:0061157	mRNA destabilization	  5	0.143519565197953	1	2	3	909	5675	2.89308452250274
GO:0061158	3	  7	0.647297183435849	1	1	6	910	5672	1.03324447232241
GO:0061178	regulation of insulin secretion involved in cellular response to glucose stimulus	 12	0.509611316519668	1	2	10	909	5668	1.20545188437614
GO:0061179	negative regulation of insulin secretion involved in cellular response to glucose stimulus	  5	1	1	0	5	911	5673	0
GO:0061202	clathrin-sculpted gamma-aminobutyric acid transport vesicle membrane	  7	0.647297183435849	1	1	6	910	5672	1.03324447232241
GO:0061298	retina vasculature development in camera-type eye	  6	1	1	0	6	911	5672	0
GO:0061337	cardiac conduction	 24	0.428813160555296	1	4	20	907	5658	1.20545188437614
GO:0061351	neural precursor cell proliferation	  6	0.590648335429865	1	1	5	910	5673	1.20545188437614
GO:0061418	regulation of transcription from RNA polymerase II promoter in response to hypoxia	 25	0.257846566237795	1	5	20	906	5658	1.44654226125137
GO:0061512	protein localization to cilium	 10	0.00689228204720671	0.768274064449573	5	5	906	5673	3.61635565312843
GO:0061564	axon development	  8	0.696113996849696	1	1	7	910	5671	0.904088913282108
GO:0061578	Lys63-specific deubiquitinase activity	  5	0.524912504930412	1	1	4	910	5674	1.44654226125137
GO:0061621	canonical glycolysis	 15	0.344361377150163	1	3	12	908	5666	1.44654226125137
GO:0061631	ubiquitin conjugating enzyme activity	 14	0.116620999245796	1	4	10	907	5668	2.06648894464482
GO:0061635	regulation of protein complex stability	  5	0.143519565197953	1	2	3	909	5675	2.89308452250274
GO:0061844	antimicrobial humoral immune response mediated by antimicrobial peptide	 11	0.805664391834832	1	1	10	910	5668	0.657519209659715
GO:0065009	regulation of molecular function	 33	0.161896669904934	1	7	26	904	5652	1.534211489206
GO:0070006	metalloaminopeptidase activity	  5	1	1	0	5	911	5673	0
GO:0070016	armadillo repeat domain binding	  5	0.524912504930412	1	1	4	910	5674	1.44654226125137
GO:0070034	telomerase RNA binding	 11	0.462079859473656	1	2	9	909	5669	1.31503841931943
GO:0070059	intrinsic apoptotic signaling pathway in response to endoplasmic reticulum stress	 12	0.0719932411872323	1	4	8	907	5670	2.41090376875229
GO:0070063	RNA polymerase binding	  9	0.116572893917459	1	3	6	908	5672	2.41090376875229
GO:0070064	proline-rich region binding	  8	0.305579489538918	1	2	6	909	5672	1.80817782656422
GO:0070072	vacuolar proton-transporting V-type ATPase complex assembly	  7	0.647297183435849	1	1	6	910	5672	1.03324447232241
GO:0070098	chemokine-mediated signaling pathway	 15	0.634731522702541	1	2	13	909	5665	0.964361507500915
GO:0070102	interleukin-6-mediated signaling pathway	  7	0.250755247393959	1	2	5	909	5673	2.06648894464482
GO:0070125	mitochondrial translational elongation	 25	0.879045586415537	1	2	23	909	5655	0.578616904500549
GO:0070126	mitochondrial translational termination	 24	0.864076388223246	1	2	22	909	5656	0.602725942188072
GO:0070131	positive regulation of mitochondrial translation	  5	0.524912504930412	1	1	4	910	5674	1.44654226125137
GO:0070182	DNA polymerase binding	  6	1	1	0	6	911	5672	0
GO:0070198	protein localization to chromosome, telomeric region	  5	0.143519565197953	1	2	3	909	5675	2.89308452250274
GO:0070207	protein homotrimerization	 12	0.509611316519668	1	2	10	909	5668	1.20545188437614
GO:0070208	protein heterotrimerization	  7	1	1	0	7	911	5671	0
GO:0070266	necroptotic process	  9	0.738180574705634	1	1	8	910	5670	0.803634589584096
GO:0070268	cornification	  9	0.359581374002193	1	2	7	909	5671	1.60726917916819
GO:0070273	phosphatidylinositol-4-phosphate binding	  8	0.305579489538918	1	2	6	909	5672	1.80817782656422
GO:0070300	phosphatidic acid binding	 10	0.150143518293906	1	3	7	908	5671	2.16981339187706
GO:0070301	cellular response to hydrogen peroxide	 31	0.638235698030361	1	4	27	907	5651	0.933253071775079
GO:0070306	lens fiber cell differentiation	  5	0.143519565197953	1	2	3	909	5675	2.89308452250274
GO:0070328	triglyceride homeostasis	  6	0.590648335429865	1	1	5	910	5673	1.20545188437614
GO:0070371	ERK1 and ERK2 cascade	 12	0.509611316519668	1	2	10	909	5668	1.20545188437614
GO:0070372	regulation of ERK1 and ERK2 cascade	 12	0.509611316519668	1	2	10	909	5668	1.20545188437614
GO:0070373	negative regulation of ERK1 and ERK2 cascade	 29	0.58353593328048	1	4	25	907	5653	0.997615352587153
GO:0070374	positive regulation of ERK1 and ERK2 cascade	 65	0.984899378635015	1	4	61	907	5617	0.445089926538884
GO:0070382	exocytic vesicle	  8	0.696113996849696	1	1	7	910	5671	0.904088913282108
GO:0070402	NADPH binding	  9	0.738180574705634	1	1	8	910	5670	0.803634589584096
GO:0070403	NAD+ binding	  6	0.590648335429865	1	1	5	910	5673	1.20545188437614
GO:0070410	co-SMAD binding	  9	1	1	0	9	911	5669	0
GO:0070411	I-SMAD binding	  8	0.305579489538918	1	2	6	909	5672	1.80817782656422
GO:0070412	R-SMAD binding	 12	0.832578307772574	1	1	11	910	5667	0.602725942188072
GO:0070423	nucleotide-binding oligomerization domain containing signaling pathway	 10	0.411940837929264	1	2	8	909	5670	1.44654226125137
GO:0070469	respiratory chain	 12	0.0719932411872323	1	4	8	907	5670	2.41090376875229
GO:0070491	repressing transcription factor binding	 17	0.199958412567424	1	4	13	907	5665	1.70181442500161
GO:0070498	interleukin-1-mediated signaling pathway	  8	0.696113996849696	1	1	7	910	5671	0.904088913282108
GO:0070507	regulation of microtubule cytoskeleton organization	  9	0.738180574705634	1	1	8	910	5670	0.803634589584096
GO:0070509	calcium ion import	  9	1	1	0	9	911	5669	0
GO:0070527	platelet aggregation	 19	0.941070913135173	1	1	18	910	5660	0.380669016118782
GO:0070528	protein kinase C signaling	  5	1	1	0	5	911	5673	0
GO:0070530	K63-linked polyubiquitin modification-dependent protein binding	 10	0.411940837929264	1	2	8	909	5670	1.44654226125137
GO:0070534	protein K63-linked ubiquitination	 14	0.116620999245796	1	4	10	907	5668	2.06648894464482
GO:0070536	protein K63-linked deubiquitination	 13	0.554297337812073	1	2	11	909	5667	1.11272481634721
GO:0070542	response to fatty acid	  8	0.696113996849696	1	1	7	910	5671	0.904088913282108
GO:0070555	response to interleukin-1	 17	0.703333082174572	1	2	15	909	5663	0.850907212500807
GO:0070577	lysine-acetylated histone binding	 10	0.411940837929264	1	2	8	909	5670	1.44654226125137
GO:0070578	RISC-loading complex	  6	0.590648335429865	1	1	5	910	5673	1.20545188437614
GO:0070584	mitochondrion morphogenesis	  9	0.116572893917459	1	3	6	908	5672	2.41090376875229
GO:0070585	protein localization to mitochondrion	  5	0.0212050012661332	1	3	2	908	5676	4.33962678375412
GO:0070588	calcium ion transmembrane transport	 60	0.451675703314035	1	9	51	902	5627	1.08490669593853
GO:0070603	SWI/SNF superfamily-type complex	  7	0.250755247393959	1	2	5	909	5673	2.06648894464482
GO:0070613	regulation of protein processing	  6	0.19623335243315	1	2	4	909	5674	2.41090376875229
GO:0070628	proteasome binding	  7	1	1	0	7	911	5671	0
GO:0070679	inositol 1,4,5 trisphosphate binding	  5	0.143519565197953	1	2	3	909	5675	2.89308452250274
GO:0070723	response to cholesterol	  5	0.524912504930412	1	1	4	910	5674	1.44654226125137
GO:0070742	C2H2 zinc finger domain binding	  6	0.19623335243315	1	2	4	909	5674	2.41090376875229
GO:0070821	tertiary granule membrane	 38	0.912404932620371	1	3	35	908	5643	0.571003524178173
GO:0070830	bicellular tight junction assembly	 13	1	1	0	13	911	5665	0
GO:0070840	dynein complex binding	 13	0.0246444305692994	1	5	8	906	5670	2.78181204086802
GO:0070848	response to growth factor	  7	1	1	0	7	911	5671	0
GO:0070886	positive regulation of calcineurin-NFAT signaling cascade	  5	1	1	0	5	911	5673	0
GO:0070888	E-box binding	 17	0.703333082174572	1	2	15	909	5663	0.850907212500807
GO:0070911	global genome nucleotide-excision repair	 20	0.131823772311556	1	5	15	906	5663	1.80817782656422
GO:0070914	UV-damage excision repair	  5	0.524912504930412	1	1	4	910	5674	1.44654226125137
GO:0070932	histone H3 deacetylation	  9	0.359581374002193	1	2	7	909	5671	1.60726917916819
GO:0070933	histone H4 deacetylation	  5	1	1	0	5	911	5673	0
GO:0070935	3	  6	1	1	0	6	911	5672	0
GO:0070936	protein K48-linked ubiquitination	 27	0.159915810494805	1	6	21	905	5657	1.60726917916819
GO:0070971	endoplasmic reticulum exit site	  7	0.647297183435849	1	1	6	910	5672	1.03324447232241
GO:0070979	protein K11-linked ubiquitination	 14	0.303988344911165	1	3	11	908	5667	1.54986670848361
GO:0070986	left/right axis specification	  5	1	1	0	5	911	5673	0
GO:0070987	error-free translesion synthesis	  9	0.359581374002193	1	2	7	909	5671	1.60726917916819
GO:0070997	neuron death	  5	0.143519565197953	1	2	3	909	5675	2.89308452250274
GO:0071004	U2-type prespliceosome	 11	0.462079859473656	1	2	9	909	5669	1.31503841931943
GO:0071011	precatalytic spliceosome	  5	0.143519565197953	1	2	3	909	5675	2.89308452250274
GO:0071013	catalytic step 2 spliceosome	 34	0.327141364371216	1	6	28	905	5650	1.27636081875121
GO:0071044	histone mRNA catabolic process	  7	1	1	0	7	911	5671	0
GO:0071108	protein K48-linked deubiquitination	 13	0.0930371570174248	1	4	9	907	5669	2.22544963269442
GO:0071141	SMAD protein complex	  5	0.524912504930412	1	1	4	910	5674	1.44654226125137
GO:0071157	negative regulation of cell cycle arrest	  6	0.590648335429865	1	1	5	910	5673	1.20545188437614
GO:0071158	positive regulation of cell cycle arrest	  9	0.738180574705634	1	1	8	910	5670	0.803634589584096
GO:0071205	protein localization to juxtaparanode region of axon	  5	1	1	0	5	911	5673	0
GO:0071222	cellular response to lipopolysaccharide	 50	0.976557786322326	1	3	47	908	5631	0.433962678375412
GO:0071230	cellular response to amino acid stimulus	 30	1	1	0	30	911	5648	0
GO:0071243	cellular response to arsenic-containing substance	  8	0.305579489538918	1	2	6	909	5672	1.80817782656422
GO:0071257	cellular response to electrical stimulus	  5	1	1	0	5	911	5673	0
GO:0071260	cellular response to mechanical stimulus	 39	0.807455053346476	1	4	35	907	5643	0.741816544231473
GO:0071276	cellular response to cadmium ion	 19	0.760858269222929	1	2	17	909	5661	0.761338032237564
GO:0071277	cellular response to calcium ion	 35	0.964139218484941	1	2	33	909	5645	0.413297788928963
GO:0071280	cellular response to copper ion	  8	0.305579489538918	1	2	6	909	5672	1.80817782656422
GO:0071281	cellular response to iron ion	  5	1	1	0	5	911	5673	0
GO:0071285	cellular response to lithium ion	  5	0.524912504930412	1	1	4	910	5674	1.44654226125137
GO:0071294	cellular response to zinc ion	 11	1	1	0	11	911	5667	0
GO:0071300	cellular response to retinoic acid	 24	0.428813160555296	1	4	20	907	5658	1.20545188437614
GO:0071305	cellular response to vitamin D	  7	0.647297183435849	1	1	6	910	5672	1.03324447232241
GO:0071310	cellular response to organic substance	 20	0.536209630921365	1	3	17	908	5661	1.08490669593853
GO:0071313	cellular response to caffeine	  5	1	1	0	5	911	5673	0
GO:0071318	cellular response to ATP	  7	0.647297183435849	1	1	6	910	5672	1.03324447232241
GO:0071320	cellular response to cAMP	 22	0.962345164748973	1	1	21	910	5657	0.328759604829857
GO:0071333	cellular response to glucose stimulus	 22	0.603648322851636	1	3	19	908	5659	0.986278814489572
GO:0071339	MLL1 complex	  8	0.305579489538918	1	2	6	909	5672	1.80817782656422
GO:0071345	cellular response to cytokine stimulus	 14	0.875749379780082	1	1	13	910	5665	0.516622236161204
GO:0071346	cellular response to interferon-gamma	 17	0.703333082174572	1	2	15	909	5663	0.850907212500807
GO:0071347	cellular response to interleukin-1	 25	0.691930609011909	1	3	22	908	5656	0.867925356750823
GO:0071353	cellular response to interleukin-4	  8	0.305579489538918	1	2	6	909	5672	1.80817782656422
GO:0071354	cellular response to interleukin-6	 10	0.774429434347452	1	1	9	910	5669	0.723271130625686
GO:0071356	cellular response to tumor necrosis factor	 47	0.905974344950422	1	4	43	907	5635	0.615549898404839
GO:0071360	cellular response to exogenous dsRNA	  7	1	1	0	7	911	5671	0
GO:0071361	cellular response to ethanol	  7	1	1	0	7	911	5671	0
GO:0071363	cellular response to growth factor stimulus	 25	0.691930609011909	1	3	22	908	5656	0.867925356750823
GO:0071364	cellular response to epidermal growth factor stimulus	 25	0.461378226139581	1	4	21	907	5657	1.1572338090011
GO:0071372	cellular response to follicle-stimulating hormone stimulus	  7	0.647297183435849	1	1	6	910	5672	1.03324447232241
GO:0071375	cellular response to peptide hormone stimulus	  5	0.524912504930412	1	1	4	910	5674	1.44654226125137
GO:0071377	cellular response to glucagon stimulus	 20	0.785819229034214	1	2	18	909	5660	0.723271130625686
GO:0071380	cellular response to prostaglandin E stimulus	  8	0.305579489538918	1	2	6	909	5672	1.80817782656422
GO:0071383	cellular response to steroid hormone stimulus	  8	1	1	0	8	911	5670	0
GO:0071385	cellular response to glucocorticoid stimulus	  8	0.305579489538918	1	2	6	909	5672	1.80817782656422
GO:0071392	cellular response to estradiol stimulus	 20	0.949242054403644	1	1	19	910	5659	0.361635565312843
GO:0071394	cellular response to testosterone stimulus	  7	0.647297183435849	1	1	6	910	5672	1.03324447232241
GO:0071397	cellular response to cholesterol	  8	0.696113996849696	1	1	7	910	5671	0.904088913282108
GO:0071398	cellular response to fatty acid	 10	1	1	0	10	911	5668	0
GO:0071404	cellular response to low-density lipoprotein particle stimulus	  8	1	1	0	8	911	5670	0
GO:0071407	cellular response to organic cyclic compound	 41	0.983253149158224	1	2	39	909	5639	0.352815185671066
GO:0071420	cellular response to histamine	  5	1	1	0	5	911	5673	0
GO:0071425	hematopoietic stem cell proliferation	  9	1	1	0	9	911	5669	0
GO:0071437	invadopodium	  6	0.590648335429865	1	1	5	910	5673	1.20545188437614
GO:0071447	cellular response to hydroperoxide	  6	1	1	0	6	911	5672	0
GO:0071456	cellular response to hypoxia	 48	0.502526164340484	1	7	41	904	5637	1.05477039882913
GO:0071479	cellular response to ionizing radiation	 14	0.875749379780082	1	1	13	910	5665	0.516622236161204
GO:0071480	cellular response to gamma radiation	 12	0.224422574243593	1	3	9	908	5669	1.80817782656421
GO:0071481	cellular response to X-ray	  9	0.738180574705634	1	1	8	910	5670	0.803634589584096
GO:0071498	cellular response to fluid shear stress	  6	0.590648335429865	1	1	5	910	5673	1.20545188437614
GO:0071526	semaphorin-plexin signaling pathway	  9	1	1	0	9	911	5669	0
GO:0071539	protein localization to centrosome	  8	0.696113996849696	1	1	7	910	5671	0.904088913282108
GO:0071542	dopaminergic neuron differentiation	  5	0.524912504930412	1	1	4	910	5674	1.44654226125137
GO:0071549	cellular response to dexamethasone stimulus	 20	0.785819229034214	1	2	18	909	5660	0.723271130625686
GO:0071556	integral component of lumenal side of endoplasmic reticulum membrane	 15	0.634731522702541	1	2	13	909	5665	0.964361507500915
GO:0071559	response to transforming growth factor beta	  5	0.143519565197953	1	2	3	909	5675	2.89308452250274
GO:0071560	cellular response to transforming growth factor beta stimulus	 29	0.372755593071474	1	5	24	906	5654	1.24701919073394
GO:0071564	npBAF complex	  7	0.647297183435849	1	1	6	910	5672	1.03324447232241
GO:0071565	nBAF complex	  8	0.0862825209590832	1	3	5	908	5673	2.71226673984632
GO:0071577	zinc II ion transmembrane transport	  8	0.305579489538918	1	2	6	909	5672	1.80817782656422
GO:0071625	vocalization behavior	 10	0.774429434347452	1	1	9	910	5669	0.723271130625686
GO:0071679	commissural neuron axon guidance	  5	1	1	0	5	911	5673	0
GO:0071682	endocytic vesicle lumen	  8	1	1	0	8	911	5670	0
GO:0071711	basement membrane organization	  5	1	1	0	5	911	5673	0
GO:0071732	cellular response to nitric oxide	  7	0.250755247393959	1	2	5	909	5673	2.06648894464482
GO:0071773	cellular response to BMP stimulus	 14	0.596015503295557	1	2	12	909	5666	1.03324447232241
GO:0071782	endoplasmic reticulum tubular network	  7	0.0599286150311256	1	3	4	908	5674	3.09973341696723
GO:0071805	potassium ion transmembrane transport	 56	0.805498478058859	1	6	50	905	5628	0.774933354241806
GO:0071806	protein transmembrane transport	  5	1	1	0	5	911	5673	0
GO:0071837	HMG box domain binding	  7	0.647297183435849	1	1	6	910	5672	1.03324447232241
GO:0071850	mitotic cell cycle arrest	  6	1	1	0	6	911	5672	0
GO:0071870	cellular response to catecholamine stimulus	  5	0.143519565197953	1	2	3	909	5675	2.89308452250274
GO:0071872	cellular response to epinephrine stimulus	  6	0.590648335429865	1	1	5	910	5673	1.20545188437614
GO:0071880	adenylate cyclase-activating adrenergic receptor signaling pathway	  5	0.524912504930412	1	1	4	910	5674	1.44654226125137
GO:0071889	14-3-3 protein binding	 15	0.344361377150163	1	3	12	908	5666	1.44654226125137
GO:0071897	DNA biosynthetic process	 11	0.805664391834832	1	1	10	910	5668	0.657519209659715
GO:0071901	negative regulation of protein serine/threonine kinase activity	 14	0.875749379780082	1	1	13	910	5665	0.516622236161204
GO:0071902	positive regulation of protein serine/threonine kinase activity	 19	0.500137274055772	1	3	16	908	5662	1.14200704835635
GO:0071944	cell periphery	 28	0.984635614894456	1	1	27	910	5651	0.258311118080602
GO:0071949	FAD binding	 10	0.411940837929264	1	2	8	909	5670	1.44654226125137
GO:0071985	multivesicular body sorting pathway	  8	1	1	0	8	911	5670	0
GO:0072001	renal system development	  9	0.738180574705634	1	1	8	910	5670	0.803634589584096
GO:0072089	stem cell proliferation	  5	1	1	0	5	911	5673	0
GO:0072112	glomerular visceral epithelial cell differentiation	  5	1	1	0	5	911	5673	0
GO:0072332	intrinsic apoptotic signaling pathway by p53 class mediator	 16	0.670477249908291	1	2	14	909	5664	0.904088913282108
GO:0072358	cardiovascular system development	  9	0.738180574705634	1	1	8	910	5670	0.803634589584096
GO:0072383	plus-end-directed vesicle transport along microtubule	  7	0.250755247393959	1	2	5	909	5673	2.06648894464482
GO:0072520	seminiferous tubule development	  5	0.524912504930412	1	1	4	910	5674	1.44654226125137
GO:0072546	ER membrane protein complex	  5	1	1	0	5	911	5673	0
GO:0072562	blood microparticle	 36	0.995356522175125	1	1	35	910	5643	0.200908647396024
GO:0072583	clathrin-dependent endocytosis	 17	0.424058507911188	1	3	14	908	5664	1.27636081875121
GO:0072593	reactive oxygen species metabolic process	 19	0.760858269222929	1	2	17	909	5661	0.761338032237564
GO:0072657	protein localization to membrane	  6	0.19623335243315	1	2	4	909	5674	2.41090376875229
GO:0072659	protein localization to plasma membrane	 68	0.99954087245295	1	2	66	909	5612	0.212726803125202
GO:0072686	mitotic spindle	 24	0.972068460896197	1	1	23	910	5655	0.301362971094036
GO:0075522	IRES-dependent viral translational initiation	  7	1	1	0	7	911	5671	0
GO:0075713	establishment of integrated proviral latency	  5	0.524912504930412	1	1	4	910	5674	1.44654226125137
GO:0075733	intracellular transport of virus	 27	0.314618865714415	1	5	22	906	5656	1.33939098264016
GO:0080008	Cul4-RING E3 ubiquitin ligase complex	 10	1	1	0	10	911	5668	0
GO:0080025	phosphatidylinositol-3,5-bisphosphate binding	  9	0.359581374002193	1	2	7	909	5671	1.60726917916819
GO:0080182	histone H3-K4 trimethylation	  7	0.250755247393959	1	2	5	909	5673	2.06648894464482
GO:0086002	cardiac muscle cell action potential involved in contraction	 11	0.805664391834832	1	1	10	910	5668	0.657519209659715
GO:0086004	regulation of cardiac muscle cell contraction	  9	1	1	0	9	911	5669	0
GO:0086005	ventricular cardiac muscle cell action potential	  6	1	1	0	6	911	5672	0
GO:0086009	membrane repolarization	  7	1	1	0	7	911	5671	0
GO:0086010	membrane depolarization during action potential	 12	1	1	0	12	911	5666	0
GO:0086012	membrane depolarization during cardiac muscle cell action potential	 10	1	1	0	10	911	5668	0
GO:0086013	membrane repolarization during cardiac muscle cell action potential	  6	0.590648335429865	1	1	5	910	5673	1.20545188437614
GO:0086064	cell communication by electrical coupling involved in cardiac conduction	 10	1	1	0	10	911	5668	0
GO:0086091	regulation of heart rate by cardiac conduction	 19	0.760858269222929	1	2	17	909	5661	0.761338032237564
GO:0089711	L-glutamate transmembrane transport	 11	1	1	0	11	911	5667	0
GO:0090023	positive regulation of neutrophil chemotaxis	 14	1	1	0	14	911	5664	0
GO:0090026	positive regulation of monocyte chemotaxis	  8	0.696113996849696	1	1	7	910	5671	0.904088913282108
GO:0090084	negative regulation of inclusion body assembly	  9	1	1	0	9	911	5669	0
GO:0090090	negative regulation of canonical Wnt signaling pathway	 66	0.709878981110806	1	8	58	903	5620	0.876692279546286
GO:0090102	cochlea development	 12	0.509611316519668	1	2	10	909	5668	1.20545188437614
GO:0090103	cochlea morphogenesis	  6	0.590648335429865	1	1	5	910	5673	1.20545188437614
GO:0090110	cargo loading into COPII-coated vesicle	  5	1	1	0	5	911	5673	0
GO:0090129	positive regulation of synapse maturation	  8	0.696113996849696	1	1	7	910	5671	0.904088913282108
GO:0090140	regulation of mitochondrial fission	  6	0.0380919907275585	1	3	3	908	5675	3.61635565312843
GO:0090141	positive regulation of mitochondrial fission	  8	0.0862825209590832	1	3	5	908	5673	2.71226673984632
GO:0090150	establishment of protein localization to membrane	  6	0.590648335429865	1	1	5	910	5673	1.20545188437614
GO:0090161	Golgi ribbon formation	  8	0.305579489538918	1	2	6	909	5672	1.80817782656422
GO:0090162	establishment of epithelial cell polarity	  7	0.647297183435849	1	1	6	910	5672	1.03324447232241
GO:0090181	regulation of cholesterol metabolic process	  6	1	1	0	6	911	5672	0
GO:0090190	positive regulation of branching involved in ureteric bud morphogenesis	  7	0.647297183435849	1	1	6	910	5672	1.03324447232241
GO:0090197	positive regulation of chemokine secretion	  6	1	1	0	6	911	5672	0
GO:0090200	positive regulation of release of cytochrome c from mitochondria	 15	0.0454641532950084	1	5	10	906	5668	2.41090376875229
GO:0090201	negative regulation of release of cytochrome c from mitochondria	  6	0.0380919907275585	1	3	3	908	5675	3.61635565312843
GO:0090263	positive regulation of canonical Wnt signaling pathway	 40	0.665604476062232	1	5	35	906	5643	0.904088913282108
GO:0090279	regulation of calcium ion import	  5	1	1	0	5	911	5673	0
GO:0090280	positive regulation of calcium ion import	  7	0.647297183435849	1	1	6	910	5672	1.03324447232241
GO:0090303	positive regulation of wound healing	  8	1	1	0	8	911	5670	0
GO:0090305	nucleic acid phosphodiester bond hydrolysis	 43	0.557432876463993	1	6	37	905	5641	1.00921553110561
GO:0090307	mitotic spindle assembly	 16	0.670477249908291	1	2	14	909	5664	0.904088913282108
GO:0090314	positive regulation of protein targeting to membrane	 18	0.230920507298425	1	4	14	907	5664	1.60726917916819
GO:0090316	positive regulation of intracellular protein transport	 16	0.670477249908291	1	2	14	909	5664	0.904088913282108
GO:0090331	negative regulation of platelet aggregation	  5	0.524912504930412	1	1	4	910	5674	1.44654226125137
GO:0090383	phagosome acidification	 14	0.303988344911165	1	3	11	908	5667	1.54986670848361
GO:0090398	cellular senescence	 10	0.774429434347452	1	1	9	910	5669	0.723271130625686
GO:0090501	RNA phosphodiester bond hydrolysis	 16	0.384511432262289	1	3	13	908	5665	1.35613336992316
GO:0090502	RNA phosphodiester bond hydrolysis, endonucleolytic	 19	0.760858269222929	1	2	17	909	5661	0.761338032237564
GO:0090503	RNA phosphodiester bond hydrolysis, exonucleolytic	 18	0.931586037139791	1	1	17	910	5661	0.401817294792048
GO:0090557	establishment of endothelial intestinal barrier	  5	1	1	0	5	911	5673	0
GO:0090575	RNA polymerase II transcription factor complex	 15	0.634731522702541	1	2	13	909	5665	0.964361507500915
GO:0090630	activation of GTPase activity	 31	0.430880175764085	1	5	26	906	5652	1.16656633971885
GO:0090647	modulation of age-related behavioral decline	  5	0.524912504930412	1	1	4	910	5674	1.44654226125137
GO:0090662	ATP hydrolysis coupled transmembrane transport	  6	1	1	0	6	911	5672	0
GO:0097009	energy homeostasis	 10	0.774429434347452	1	1	9	910	5669	0.723271130625686
GO:0097038	perinuclear endoplasmic reticulum	  6	0.19623335243315	1	2	4	909	5674	2.41090376875229
GO:0097060	synaptic membrane	 16	1	1	0	16	911	5662	0
GO:0097067	cellular response to thyroid hormone stimulus	 10	0.774429434347452	1	1	9	910	5669	0.723271130625686
GO:0097104	postsynaptic membrane assembly	  6	0.590648335429865	1	1	5	910	5673	1.20545188437614
GO:0097105	presynaptic membrane assembly	  7	0.647297183435849	1	1	6	910	5672	1.03324447232241
GO:0097110	scaffold protein binding	 25	0.879045586415537	1	2	23	909	5655	0.578616904500549
GO:0097114	NMDA glutamate receptor clustering	  5	0.524912504930412	1	1	4	910	5674	1.44654226125137
GO:0097120	receptor localization to synapse	  7	0.647297183435849	1	1	6	910	5672	1.03324447232241
GO:0097150	neuronal stem cell population maintenance	  9	0.738180574705634	1	1	8	910	5670	0.803634589584096
GO:0097157	pre-mRNA intronic binding	  5	0.0212050012661332	1	3	2	908	5676	4.33962678375412
GO:0097186	amelogenesis	  5	1	1	0	5	911	5673	0
GO:0097190	apoptotic signaling pathway	 23	0.847425382793578	1	2	21	909	5657	0.628931417935379
GO:0097191	extrinsic apoptotic signaling pathway	 16	0.670477249908291	1	2	14	909	5664	0.904088913282108
GO:0097192	extrinsic apoptotic signaling pathway in absence of ligand	 16	0.907797453739348	1	1	15	910	5663	0.452044456641054
GO:0097193	intrinsic apoptotic signaling pathway	 14	0.875749379780082	1	1	13	910	5665	0.516622236161204
GO:0097194	execution phase of apoptosis	 15	0.344361377150163	1	3	12	908	5666	1.44654226125137
GO:0097228	sperm principal piece	  8	0.696113996849696	1	1	7	910	5671	0.904088913282108
GO:0097242	amyloid-beta clearance	  5	1	1	0	5	911	5673	0
GO:0097320	plasma membrane tubulation	  6	0.590648335429865	1	1	5	910	5673	1.20545188437614
GO:0097352	autophagosome maturation	 11	0.186315240979503	1	3	8	908	5670	1.97255762897914
GO:0097421	liver regeneration	 15	0.344361377150163	1	3	12	908	5666	1.44654226125137
GO:0097431	mitotic spindle pole	 11	0.462079859473656	1	2	9	909	5669	1.31503841931943
GO:0097435	supramolecular fiber organization	  9	0.738180574705634	1	1	8	910	5670	0.803634589584096
GO:0097440	apical dendrite	  7	1	1	0	7	911	5671	0
GO:0097449	astrocyte projection	  6	0.590648335429865	1	1	5	910	5673	1.20545188437614
GO:0097470	ribbon synapse	  5	0.143519565197953	1	2	3	909	5675	2.89308452250274
GO:0097484	dendrite extension	  6	1	1	0	6	911	5672	0
GO:0097503	sialylation	  8	0.696113996849696	1	1	7	910	5671	0.904088913282108
GO:0097542	ciliary tip	 24	0.864076388223246	1	2	22	909	5656	0.602725942188072
GO:0097546	ciliary base	 16	0.670477249908291	1	2	14	909	5664	0.904088913282108
GO:0097711	ciliary basal body-plasma membrane docking	 49	0.826808965729871	1	5	44	906	5634	0.738031765944578
GO:0097718	disordered domain specific binding	 19	0.941070913135173	1	1	18	910	5660	0.380669016118782
GO:0097730	non-motile cilium	 12	0.509611316519668	1	2	10	909	5668	1.20545188437614
GO:0097755	positive regulation of blood vessel diameter	 10	0.774429434347452	1	1	9	910	5669	0.723271130625686
GO:0098505	G-rich strand telomeric DNA binding	  5	0.524912504930412	1	1	4	910	5674	1.44654226125137
GO:0098574	cytoplasmic side of lysosomal membrane	  5	0.524912504930412	1	1	4	910	5674	1.44654226125137
GO:0098586	cellular response to virus	  7	0.647297183435849	1	1	6	910	5672	1.03324447232241
GO:0098609	cell-cell adhesion	 54	0.884904238196582	1	5	49	906	5629	0.66969549132008
GO:0098641	cadherin binding involved in cell-cell adhesion	  9	0.738180574705634	1	1	8	910	5670	0.803634589584096
GO:0098655	cation transmembrane transport	 21	0.808458104218592	1	2	19	909	5659	0.688829648214939
GO:0098656	anion transmembrane transport	 12	0.832578307772574	1	1	11	910	5667	0.602725942188072
GO:0098742	cell-cell adhesion via plasma-membrane adhesion molecules	  7	1	1	0	7	911	5671	0
GO:0098780	response to mitochondrial depolarisation	  5	1	1	0	5	911	5673	0
GO:0098793	presynapse	 41	0.687432825360142	1	5	36	906	5642	0.882037964177666
GO:0098794	postsynapse	 24	0.230439938269259	1	5	19	906	5659	1.50681485547018
GO:0098869	cellular oxidant detoxification	 27	0.74203057279193	1	3	24	908	5654	0.803634589584096
GO:0098909	regulation of cardiac muscle cell action potential involved in regulation of contraction	  5	1	1	0	5	911	5673	0
GO:0098911	regulation of ventricular cardiac muscle cell action potential	  6	1	1	0	6	911	5672	0
GO:0099132	ATP hydrolysis coupled cation transmembrane transport	 18	0.0915910810089212	1	5	13	906	5665	2.00908647396024
GO:0099565	chemical synaptic transmission, postsynaptic	  5	1	1	0	5	911	5673	0
GO:0099738	cell cortex region	  5	1	1	0	5	911	5673	0
GO:0101003	ficolin-1-rich granule membrane	 23	0.847425382793578	1	2	21	909	5657	0.628931417935379
GO:0102336	3-oxo-arachidoyl-CoA synthase activity	  5	0.143519565197953	1	2	3	909	5675	2.89308452250274
GO:0102337	3-oxo-cerotoyl-CoA synthase activity	  5	0.143519565197953	1	2	3	909	5675	2.89308452250274
GO:0102338	3-oxo-lignoceronyl-CoA synthase activity	  5	0.143519565197953	1	2	3	909	5675	2.89308452250274
GO:0106003	amyloid-beta complex	  5	0.143519565197953	1	2	3	909	5675	2.89308452250274
GO:1900006	positive regulation of dendrite development	  9	0.738180574705634	1	1	8	910	5670	0.803634589584096
GO:1900025	negative regulation of substrate adhesion-dependent cell spreading	  6	1	1	0	6	911	5672	0
GO:1900026	positive regulation of substrate adhesion-dependent cell spreading	 16	1	1	0	16	911	5662	0
GO:1900027	regulation of ruffle assembly	  5	0.524912504930412	1	1	4	910	5674	1.44654226125137
GO:1900034	regulation of cellular response to heat	 50	0.247982927656921	1	9	41	902	5637	1.30188803512623
GO:1900087	positive regulation of G1/S transition of mitotic cell cycle	 11	0.805664391834832	1	1	10	910	5668	0.657519209659715
GO:1900119	positive regulation of execution phase of apoptosis	  5	0.524912504930412	1	1	4	910	5674	1.44654226125137
GO:1900122	positive regulation of receptor binding	  5	0.524912504930412	1	1	4	910	5674	1.44654226125137
GO:1900153	positive regulation of nuclear-transcribed mRNA catabolic process, deadenylation-dependent decay	 10	0.150143518293906	1	3	7	908	5671	2.16981339187706
GO:1900181	negative regulation of protein localization to nucleus	  6	0.19623335243315	1	2	4	909	5674	2.41090376875229
GO:1900182	positive regulation of protein localization to nucleus	  6	0.590648335429865	1	1	5	910	5673	1.20545188437614
GO:1900271	regulation of long-term synaptic potentiation	  5	0.524912504930412	1	1	4	910	5674	1.44654226125137
GO:1900272	negative regulation of long-term synaptic potentiation	  5	0.524912504930412	1	1	4	910	5674	1.44654226125137
GO:1900273	positive regulation of long-term synaptic potentiation	  9	1	1	0	9	911	5669	0
GO:1900740	positive regulation of protein insertion into mitochondrial membrane involved in apoptotic signaling pathway	 15	0.142496215955173	1	4	11	907	5667	1.92872301500183
GO:1900745	positive regulation of p38MAPK cascade	  6	0.19623335243315	1	2	4	909	5674	2.41090376875229
GO:1901016	regulation of potassium ion transmembrane transporter activity	  6	0.19623335243315	1	2	4	909	5674	2.41090376875229
GO:1901017	negative regulation of potassium ion transmembrane transporter activity	  5	1	1	0	5	911	5673	0
GO:1901018	positive regulation of potassium ion transmembrane transporter activity	  6	1	1	0	6	911	5672	0
GO:1901185	negative regulation of ERBB signaling pathway	  8	0.696113996849696	1	1	7	910	5671	0.904088913282108
GO:1901214	regulation of neuron death	  6	0.19623335243315	1	2	4	909	5674	2.41090376875229
GO:1901215	negative regulation of neuron death	 25	0.691930609011909	1	3	22	908	5656	0.867925356750823
GO:1901216	positive regulation of neuron death	 15	0.344361377150163	1	3	12	908	5666	1.44654226125137
GO:1901224	positive regulation of NIK/NF-kappaB signaling	 12	0.224422574243593	1	3	9	908	5669	1.80817782656421
GO:1901379	regulation of potassium ion transmembrane transport	 12	0.0719932411872323	1	4	8	907	5670	2.41090376875229
GO:1901380	negative regulation of potassium ion transmembrane transport	  5	1	1	0	5	911	5673	0
GO:1901381	positive regulation of potassium ion transmembrane transport	  7	1	1	0	7	911	5671	0
GO:1901385	regulation of voltage-gated calcium channel activity	  6	1	1	0	6	911	5672	0
GO:1901409	positive regulation of phosphorylation of RNA polymerase II C-terminal domain	  6	0.0380919907275585	1	3	3	908	5675	3.61635565312843
GO:1901522	positive regulation of transcription from RNA polymerase II promoter involved in cellular response to chemical stimulus	  6	0.590648335429865	1	1	5	910	5673	1.20545188437614
GO:1901653	cellular response to peptide	  7	0.250755247393959	1	2	5	909	5673	2.06648894464482
GO:1901673	regulation of mitotic spindle assembly	  9	1	1	0	9	911	5669	0
GO:1901687	glutathione derivative biosynthetic process	 10	0.411940837929264	1	2	8	909	5670	1.44654226125137
GO:1901796	regulation of signal transduction by p53 class mediator	 47	0.320673106350033	1	8	39	903	5639	1.23109979680968
GO:1901800	positive regulation of proteasomal protein catabolic process	  7	0.647297183435849	1	1	6	910	5672	1.03324447232241
GO:1901998	toxin transport	 14	0.875749379780082	1	1	13	910	5665	0.516622236161204
GO:1902017	regulation of cilium assembly	  8	0.696113996849696	1	1	7	910	5671	0.904088913282108
GO:1902036	regulation of hematopoietic stem cell differentiation	 28	0.764538707578142	1	3	25	908	5653	0.774933354241806
GO:1902041	regulation of extrinsic apoptotic signaling pathway via death domain receptors	  7	1	1	0	7	911	5671	0
GO:1902042	negative regulation of extrinsic apoptotic signaling pathway via death domain receptors	 13	1	1	0	13	911	5665	0
GO:1902043	positive regulation of extrinsic apoptotic signaling pathway via death domain receptors	  9	0.116572893917459	1	3	6	908	5672	2.41090376875229
GO:1902065	response to L-glutamate	  5	0.524912504930412	1	1	4	910	5674	1.44654226125137
GO:1902166	negative regulation of intrinsic apoptotic signaling pathway in response to DNA damage by p53 class mediator	  6	0.590648335429865	1	1	5	910	5673	1.20545188437614
GO:1902176	negative regulation of oxidative stress-induced intrinsic apoptotic signaling pathway	  6	0.19623335243315	1	2	4	909	5674	2.41090376875229
GO:1902236	negative regulation of endoplasmic reticulum stress-induced intrinsic apoptotic signaling pathway	  5	0.524912504930412	1	1	4	910	5674	1.44654226125137
GO:1902237	positive regulation of endoplasmic reticulum stress-induced intrinsic apoptotic signaling pathway	  6	0.19623335243315	1	2	4	909	5674	2.41090376875229
GO:1902476	chloride transmembrane transport	 36	0.995356522175125	1	1	35	910	5643	0.200908647396024
GO:1902600	hydrogen ion transmembrane transport	 18	0.0291301788015386	1	6	12	905	5666	2.41090376875229
GO:1902711	GABA-A receptor complex	 10	1	1	0	10	911	5668	0
GO:1902741	positive regulation of interferon-alpha secretion	  5	0.524912504930412	1	1	4	910	5674	1.44654226125137
GO:1902895	positive regulation of pri-miRNA transcription from RNA polymerase II promoter	  8	1	1	0	8	911	5670	0
GO:1902902	negative regulation of autophagosome assembly	  6	1	1	0	6	911	5672	0
GO:1903076	regulation of protein localization to plasma membrane	 11	0.805664391834832	1	1	10	910	5668	0.657519209659715
GO:1903077	negative regulation of protein localization to plasma membrane	 12	0.224422574243593	1	3	9	908	5669	1.80817782656421
GO:1903078	positive regulation of protein localization to plasma membrane	 25	0.257846566237795	1	5	20	906	5658	1.44654226125137
GO:1903146	regulation of autophagy of mitochondrion	 12	0.509611316519668	1	2	10	909	5668	1.20545188437614
GO:1903204	negative regulation of oxidative stress-induced neuron death	  6	0.590648335429865	1	1	5	910	5673	1.20545188437614
GO:1903206	negative regulation of hydrogen peroxide-induced cell death	  6	1	1	0	6	911	5672	0
GO:1903265	positive regulation of tumor necrosis factor-mediated signaling pathway	  5	1	1	0	5	911	5673	0
GO:1903351	cellular response to dopamine	  5	1	1	0	5	911	5673	0
GO:1903364	positive regulation of cellular protein catabolic process	  7	1	1	0	7	911	5671	0
GO:1903506	regulation of nucleic acid-templated transcription	 12	0.509611316519668	1	2	10	909	5668	1.20545188437614
GO:1903507	negative regulation of nucleic acid-templated transcription	 17	0.424058507911188	1	3	14	908	5664	1.27636081875121
GO:1903543	positive regulation of exosomal secretion	  6	1	1	0	6	911	5672	0
GO:1903561	extracellular vesicle	 34	0.181150928150866	1	7	27	904	5651	1.48908762187641
GO:1903608	protein localization to cytoplasmic stress granule	  5	1	1	0	5	911	5673	0
GO:1903672	positive regulation of sprouting angiogenesis	  6	1	1	0	6	911	5672	0
GO:1903779	regulation of cardiac conduction	 31	0.941131570135982	1	2	29	909	5649	0.466626535887539
GO:1903829	positive regulation of cellular protein localization	  5	1	1	0	5	911	5673	0
GO:1903830	magnesium ion transmembrane transport	  6	1	1	0	6	911	5672	0
GO:1903861	positive regulation of dendrite extension	 12	0.224422574243593	1	3	9	908	5669	1.80817782656421
GO:1903955	positive regulation of protein targeting to mitochondrion	 34	1	1	0	34	911	5644	0
GO:1903959	regulation of anion transmembrane transport	  5	1	1	0	5	911	5673	0
GO:1904115	axon cytoplasm	 20	0.295727251817412	1	4	16	907	5662	1.44654226125137
GO:1904262	negative regulation of TORC1 signaling	  5	1	1	0	5	911	5673	0
GO:1904263	positive regulation of TORC1 signaling	  5	1	1	0	5	911	5673	0
GO:1904322	cellular response to forskolin	  7	1	1	0	7	911	5671	0
GO:1904355	positive regulation of telomere capping	  8	1	1	0	8	911	5670	0
GO:1904380	endoplasmic reticulum mannose trimming	  6	0.19623335243315	1	2	4	909	5674	2.41090376875229
GO:1904646	cellular response to amyloid-beta	  8	0.696113996849696	1	1	7	910	5671	0.904088913282108
GO:1904659	glucose transmembrane transport	  9	0.738180574705634	1	1	8	910	5670	0.803634589584096
GO:1904706	negative regulation of vascular smooth muscle cell proliferation	  5	1	1	0	5	911	5673	0
GO:1904707	positive regulation of vascular smooth muscle cell proliferation	  6	0.590648335429865	1	1	5	910	5673	1.20545188437614
GO:1904724	tertiary granule lumen	 28	0.915282449919722	1	2	26	909	5652	0.516622236161204
GO:1904754	positive regulation of vascular associated smooth muscle cell migration	  8	0.305579489538918	1	2	6	909	5672	1.80817782656422
GO:1904813	ficolin-1-rich granule lumen	 57	0.155839514188892	1	11	46	900	5632	1.39578639243553
GO:1904837	beta-catenin-TCF complex assembly	 16	0.170377804997621	1	4	12	907	5666	1.80817782656422
GO:1904886	beta-catenin destruction complex disassembly	  9	0.738180574705634	1	1	8	910	5670	0.803634589584096
GO:1905007	positive regulation of epithelial to mesenchymal transition involved in endocardial cushion formation	  5	1	1	0	5	911	5673	0
GO:1905515	non-motile cilium assembly	 22	0.603648322851636	1	3	19	908	5659	0.986278814489572
GO:1990090	cellular response to nerve growth factor stimulus	 17	0.703333082174572	1	2	15	909	5663	0.850907212500807
GO:1990124	messenger ribonucleoprotein complex	  6	0.590648335429865	1	1	5	910	5673	1.20545188437614
GO:1990138	neuron projection extension	 10	0.411940837929264	1	2	8	909	5670	1.44654226125137
GO:1990239	steroid hormone binding	  5	1	1	0	5	911	5673	0
GO:1990253	cellular response to leucine starvation	  5	1	1	0	5	911	5673	0
GO:1990316	ATG1/ULK1 kinase complex	  6	0.0380919907275585	1	3	3	908	5675	3.61635565312843
GO:1990380	Lys48-specific deubiquitinase activity	  5	0.0212050012661332	1	3	2	908	5676	4.33962678375412
GO:1990381	ubiquitin-specific protease binding	  8	0.305579489538918	1	2	6	909	5672	1.80817782656422
GO:1990416	cellular response to brain-derived neurotrophic factor stimulus	  5	1	1	0	5	911	5673	0
GO:1990454	L-type voltage-gated calcium channel complex	  6	0.590648335429865	1	1	5	910	5673	1.20545188437614
GO:1990459	transferrin receptor binding	  5	1	1	0	5	911	5673	0
GO:1990573	potassium ion import across plasma membrane	  6	1	1	0	6	911	5672	0
GO:1990712	HFE-transferrin receptor complex	  5	0.524912504930412	1	1	4	910	5674	1.44654226125137
GO:1990782	protein tyrosine kinase binding	  5	0.524912504930412	1	1	4	910	5674	1.44654226125137
GO:1990830	cellular response to leukemia inhibitory factor	 45	0.277770852483584	1	8	37	903	5641	1.28581534333455
GO:1990841	promoter-specific chromatin binding	  9	0.738180574705634	1	1	8	910	5670	0.803634589584096
GO:1990909	Wnt signalosome	  6	1	1	0	6	911	5672	0
GO:2000001	regulation of DNA damage checkpoint	  6	1	1	0	6	911	5672	0
GO:2000009	negative regulation of protein localization to cell surface	  9	0.359581374002193	1	2	7	909	5671	1.60726917916819
GO:2000010	positive regulation of protein localization to cell surface	  7	0.647297183435849	1	1	6	910	5672	1.03324447232241
GO:2000036	regulation of stem cell population maintenance	  7	1	1	0	7	911	5671	0
GO:2000114	regulation of establishment of cell polarity	 12	0.509611316519668	1	2	10	909	5668	1.20545188437614
GO:2000134	negative regulation of G1/S transition of mitotic cell cycle	 15	0.344361377150163	1	3	12	908	5666	1.44654226125137
GO:2000144	positive regulation of DNA-templated transcription, initiation	  5	0.524912504930412	1	1	4	910	5674	1.44654226125137
GO:2000145	regulation of cell motility	 12	0.224422574243593	1	3	9	908	5669	1.80817782656421
GO:2000146	negative regulation of cell motility	  6	1	1	0	6	911	5672	0
GO:2000179	positive regulation of neural precursor cell proliferation	  7	1	1	0	7	911	5671	0
GO:2000249	regulation of actin cytoskeleton reorganization	  9	1	1	0	9	911	5669	0
GO:2000251	positive regulation of actin cytoskeleton reorganization	  6	0.590648335429865	1	1	5	910	5673	1.20545188437614
GO:2000271	positive regulation of fibroblast apoptotic process	  5	0.143519565197953	1	2	3	909	5675	2.89308452250274
GO:2000273	positive regulation of receptor activity	  8	1	1	0	8	911	5670	0
GO:2000279	negative regulation of DNA biosynthetic process	  9	1	1	0	9	911	5669	0
GO:2000300	regulation of synaptic vesicle exocytosis	 11	0.186315240979503	1	3	8	908	5670	1.97255762897914
GO:2000304	positive regulation of ceramide biosynthetic process	  5	1	1	0	5	911	5673	0
GO:2000310	regulation of NMDA receptor activity	 12	0.832578307772574	1	1	11	910	5667	0.602725942188072
GO:2000311	regulation of AMPA receptor activity	 10	0.774429434347452	1	1	9	910	5669	0.723271130625686
GO:2000352	negative regulation of endothelial cell apoptotic process	 10	0.774429434347452	1	1	9	910	5669	0.723271130625686
GO:2000353	positive regulation of endothelial cell apoptotic process	  7	1	1	0	7	911	5671	0
GO:2000369	regulation of clathrin-dependent endocytosis	  7	1	1	0	7	911	5671	0
GO:2000377	regulation of reactive oxygen species metabolic process	 12	0.224422574243593	1	3	9	908	5669	1.80817782656421
GO:2000378	negative regulation of reactive oxygen species metabolic process	  9	1	1	0	9	911	5669	0
GO:2000379	positive regulation of reactive oxygen species metabolic process	 10	0.774429434347452	1	1	9	910	5669	0.723271130625686
GO:2000463	positive regulation of excitatory postsynaptic potential	 16	0.670477249908291	1	2	14	909	5664	0.904088913282108
GO:2000480	negative regulation of cAMP-dependent protein kinase activity	  7	0.250755247393959	1	2	5	909	5673	2.06648894464482
GO:2000484	positive regulation of interleukin-8 secretion	  5	1	1	0	5	911	5673	0
GO:2000505	regulation of energy homeostasis	  7	0.250755247393959	1	2	5	909	5673	2.06648894464482
GO:2000573	positive regulation of DNA biosynthetic process	  6	1	1	0	6	911	5672	0
GO:2000643	positive regulation of early endosome to late endosome transport	  6	0.590648335429865	1	1	5	910	5673	1.20545188437614
GO:2000649	regulation of sodium ion transmembrane transporter activity	 11	1	1	0	11	911	5667	0
GO:2000650	negative regulation of sodium ion transmembrane transporter activity	  5	1	1	0	5	911	5673	0
GO:2000651	positive regulation of sodium ion transmembrane transporter activity	  5	1	1	0	5	911	5673	0
GO:2000678	negative regulation of transcription regulatory region DNA binding	  7	1	1	0	7	911	5671	0
GO:2000727	positive regulation of cardiac muscle cell differentiation	  7	1	1	0	7	911	5671	0
GO:2000737	negative regulation of stem cell differentiation	  6	0.19623335243315	1	2	4	909	5674	2.41090376875229
GO:2000766	negative regulation of cytoplasmic translation	  6	0.590648335429865	1	1	5	910	5673	1.20545188437614
GO:2000772	regulation of cellular senescence	  5	1	1	0	5	911	5673	0
GO:2000773	negative regulation of cellular senescence	  5	0.524912504930412	1	1	4	910	5674	1.44654226125137
GO:2000774	positive regulation of cellular senescence	  6	0.19623335243315	1	2	4	909	5674	2.41090376875229
GO:2000778	positive regulation of interleukin-6 secretion	  7	1	1	0	7	911	5671	0
GO:2000785	regulation of autophagosome assembly	  7	0.647297183435849	1	1	6	910	5672	1.03324447232241
GO:2000786	positive regulation of autophagosome assembly	  8	0.305579489538918	1	2	6	909	5672	1.80817782656422
GO:2000810	regulation of bicellular tight junction assembly	  8	0.696113996849696	1	1	7	910	5671	0.904088913282108
GO:2000811	negative regulation of anoikis	  9	1	1	0	9	911	5669	0
GO:2001020	regulation of response to DNA damage stimulus	  6	0.590648335429865	1	1	5	910	5673	1.20545188437614
GO:2001022	positive regulation of response to DNA damage stimulus	  7	1	1	0	7	911	5671	0
GO:2001214	positive regulation of vasculogenesis	  7	1	1	0	7	911	5671	0
GO:2001222	regulation of neuron migration	  6	1	1	0	6	911	5672	0
GO:2001223	negative regulation of neuron migration	  6	0.590648335429865	1	1	5	910	5673	1.20545188437614
GO:2001234	negative regulation of apoptotic signaling pathway	  8	0.696113996849696	1	1	7	910	5671	0.904088913282108
GO:2001235	positive regulation of apoptotic signaling pathway	 12	0.832578307772574	1	1	11	910	5667	0.602725942188072
GO:2001237	negative regulation of extrinsic apoptotic signaling pathway	 23	0.395750956840956	1	4	19	907	5659	1.25786283587076
GO:2001238	positive regulation of extrinsic apoptotic signaling pathway	 15	1	1	0	15	911	5663	0
GO:2001240	negative regulation of extrinsic apoptotic signaling pathway in absence of ligand	 10	1	1	0	10	911	5668	0
GO:2001241	positive regulation of extrinsic apoptotic signaling pathway in absence of ligand	  6	0.590648335429865	1	1	5	910	5673	1.20545188437614
GO:2001243	negative regulation of intrinsic apoptotic signaling pathway	 10	1	1	0	10	911	5668	0
GO:2001244	positive regulation of intrinsic apoptotic signaling pathway	 13	0.554297337812073	1	2	11	909	5667	1.11272481634721
GO:2001259	positive regulation of cation channel activity	  5	1	1	0	5	911	5673	0
GO:2001275	positive regulation of glucose import in response to insulin stimulus	  9	0.738180574705634	1	1	8	910	5670	0.803634589584096
