Term	Accession	Genes (tot)	Stat (non-dir.) p	p adj (non-dir.)	Significant..in.gene.set.	Non.significant..in.gene.set.	Significant..not.in.gene.set.	Non.significant..not.in.gene.set.	effect.size
IPR000006	Metallothionein, vertebrate	  7	1	1	0	7	918	5690	0
IPR000008	C2 domain	 86	0.539666934365303	1	12	74	906	5623	1.00547195622435
IPR000014	PAS domain	 14	0.87678457697329	1	1	13	917	5684	0.514705882352941
IPR000033	LDLR class B repeat	 10	1	1	0	10	918	5687	0
IPR000048	IQ motif, EF-hand binding site	 29	0.787664379225474	1	3	26	915	5671	0.745436105476673
IPR000073	Alpha/beta hydrolase fold-1	 13	1	1	0	13	918	5684	0
IPR000086	NUDIX hydrolase domain	 13	0.556455386258923	1	2	11	916	5686	1.10859728506787
IPR000095	CRIB domain	  9	0.739584916156844	1	1	8	917	5689	0.800653594771242
IPR000152	EGF-type aspartate/asparagine hydroxylation site	 41	0.937377028212656	1	3	38	915	5659	0.527259684361549
IPR000156	Ran binding domain	  5	0.526329856249264	1	1	4	917	5693	1.44117647058824
IPR000157	Toll/interleukin-1 receptor homology (TIR) domain	 10	0.775773388298536	1	1	9	917	5688	0.720588235294118
IPR000159	Ras-associating (RA) domain	 20	0.787667710099532	1	2	18	916	5679	0.720588235294118
IPR000175	Sodium:neurotransmitter symporter	  5	1	1	0	5	918	5692	0
IPR000182	GNAT domain	  9	1	1	0	9	918	5688	0
IPR000195	Rab-GTPase-TBC domain	 15	0.893920125880807	1	1	14	917	5683	0.480392156862745
IPR000198	Rho GTPase-activating protein domain	 26	0.28869758342159	1	5	21	913	5676	1.38574660633484
IPR000203	GPS motif	  8	1	1	0	8	918	5689	0
IPR000209	Peptidase S8/S53 domain	  6	0.0384709046773625	1	3	3	915	5694	3.60294117647059
IPR000210	BTB/POZ domain	 75	0.605626859230405	1	10	65	908	5632	0.96078431372549
IPR000215	Serpin family	  9	0.739584916156844	1	1	8	917	5689	0.800653594771242
IPR000217	Tubulin	 12	0.833774613511985	1	1	11	917	5686	0.600490196078431
IPR000219	Dbl homology (DH) domain	 34	0.713930806761181	1	4	30	914	5667	0.847750865051903
IPR000222	PPM-type phosphatase, divalent cation binding	  8	0.697563287229438	1	1	7	917	5690	0.900735294117647
IPR000225	Armadillo	 15	0.34661660258468	1	3	12	915	5685	1.44117647058824
IPR000233	Cadherin, cytoplasmic domain	  7	1	1	0	7	918	5690	0
IPR000237	GRIP domain	  5	0.526329856249264	1	1	4	917	5693	1.44117647058824
IPR000242	PTP type protein phosphatase	 23	0.848997525013311	1	2	21	916	5676	0.626598465473146
IPR000253	Forkhead-associated (FHA) domain	 11	0.806937662264008	1	1	10	917	5687	0.655080213903743
IPR000261	EH domain	  9	0.117590956310789	1	3	6	915	5691	2.40196078431373
IPR000270	PB1 domain	  5	0.144431742808919	1	2	3	916	5694	2.88235294117647
IPR000276	G protein-coupled receptor, rhodopsin-like	 66	0.961818193498056	1	5	61	913	5636	0.545900178253119
IPR000299	FERM domain	 31	0.942004908343664	1	2	29	916	5668	0.464895635673624
IPR000300	Inositol polyphosphate-related phosphatase	  5	0.526329856249264	1	1	4	917	5693	1.44117647058824
IPR000301	Tetraspanin	  9	0.739584916156844	1	1	8	917	5689	0.800653594771242
IPR000306	FYVE zinc finger	 16	0.67259893396849	1	2	14	916	5683	0.900735294117647
IPR000308	14-3-3 protein	  6	0.592113395124177	1	1	5	917	5692	1.20098039215686
IPR000313	PWWP domain	 11	0.0543215783850452	1	4	7	914	5690	2.62032085561497
IPR000315	B-box-type zinc finger	 17	0.201835682037381	1	4	13	914	5684	1.69550173010381
IPR000326	Phosphatidic acid phosphatase type 2/haloperoxidase	 10	1	1	0	10	918	5687	0
IPR000330	SNF2-related, N-terminal domain	 15	0.893920125880807	1	1	14	917	5683	0.480392156862745
IPR000331	Rap GTPase activating protein domain	  7	0.252177032640286	1	2	5	916	5692	2.05882352941176
IPR000333	Ser/Thr protein kinase, TGFB receptor	  8	0.697563287229438	1	1	7	917	5690	0.900735294117647
IPR000340	Dual specificity phosphatase, catalytic domain	 18	0.0927603594174299	1	5	13	913	5684	2.0016339869281
IPR000357	HEAT repeat	  5	0.526329856249264	1	1	4	917	5693	1.44117647058824
IPR000372	Leucine-rich repeat N-terminal domain	 23	0.637493949009158	1	3	20	915	5677	0.939897698209719
IPR000375	Dynamin central domain	  5	0.144431742808919	1	2	3	916	5694	2.88235294117647
IPR000387	Tyrosine specific protein phosphatases domain	 44	0.260273177938706	1	8	36	910	5661	1.31016042780749
IPR000403	Phosphatidylinositol 3-/4-kinase, catalytic domain	 11	0.464130648643814	1	2	9	916	5688	1.31016042780749
IPR000407	Nucleoside phosphatase GDA1/CD39	  6	1	1	0	6	918	5691	0
IPR000408	Regulator of chromosome condensation, RCC1	 13	1	1	0	13	918	5684	0
IPR000409	BEACH domain	  6	1	1	0	6	918	5691	0
IPR000413	Integrin alpha chain	  8	1	1	0	8	918	5689	0
IPR000418	Ets domain	 10	0.15139661152445	1	3	7	915	5690	2.16176470588235
IPR000421	Coagulation factor 5/8 C-terminal domain	 11	0.806937662264008	1	1	10	917	5687	0.655080213903743
IPR000433	Zinc finger, ZZ-type	 12	0.0728152982621673	1	4	8	914	5689	2.40196078431373
IPR000436	Sushi/SCR/CCP domain	 20	0.949845130957032	1	1	19	917	5678	0.360294117647059
IPR000463	Cytosolic fatty-acid binding	  7	1	1	0	7	918	5690	0
IPR000467	G-patch domain	 10	1	1	0	10	918	5687	0
IPR000472	Activin types I and II receptor domain	  6	0.592113395124177	1	1	5	917	5692	1.20098039215686
IPR000483	Cysteine-rich flanking region, C-terminal	 34	0.960040455673451	1	2	32	916	5665	0.423875432525952
IPR000488	Death domain	 20	0.949845130957032	1	1	19	917	5678	0.360294117647059
IPR000494	Receptor L-domain	  5	0.144431742808919	1	2	3	916	5694	2.88235294117647
IPR000500	Connexin	  6	1	1	0	6	918	5691	0
IPR000536	Nuclear hormone receptor, ligand-binding domain	 16	0.386902600364978	1	3	13	915	5684	1.35110294117647
IPR000538	Link domain	  8	1	1	0	8	918	5689	0
IPR000555	JAB1/MPN/MOV34 metalloenzyme domain	  7	0.648769455538159	1	1	6	917	5691	1.02941176470588
IPR000557	Calponin repeat	  5	1	1	0	5	918	5692	0
IPR000558	Histone H2B	  5	1	1	0	5	918	5692	0
IPR000560	Histidine phosphatase superfamily, clade-2	  6	0.592113395124177	1	1	5	917	5692	1.20098039215686
IPR000562	Fibronectin, type II, collagen-binding	  5	1	1	0	5	918	5692	0
IPR000566	Lipocalin/cytosolic fatty-acid binding domain	 10	1	1	0	10	918	5687	0
IPR000569	HECT domain	 21	0.956826506208199	1	1	20	917	5677	0.343137254901961
IPR000571	Zinc finger, CCCH-type	 29	0.206120994784403	1	6	23	912	5674	1.49087221095335
IPR000585	Hemopexin-like domain	  5	1	1	0	5	918	5692	0
IPR000591	DEP domain	 12	0.511731198536261	1	2	10	916	5687	1.20098039215686
IPR000594	THIF-type NAD/FAD binding fold	  6	0.592113395124177	1	1	5	917	5692	1.20098039215686
IPR000595	Cyclic nucleotide-binding domain	 12	0.511731198536261	1	2	10	916	5687	1.20098039215686
IPR000608	Ubiquitin-conjugating enzyme E2	 19	0.265216005277939	1	4	15	914	5682	1.51702786377709
IPR000626	Ubiquitin domain	 22	0.962837010803418	1	1	21	917	5676	0.327540106951872
IPR000629	ATP-dependent RNA helicase DEAD-box, conserved site	  9	1	1	0	9	918	5688	0
IPR000639	Epoxide hydrolase-like	  6	1	1	0	6	918	5691	0
IPR000644	CBS domain	  5	1	1	0	5	918	5692	0
IPR000648	Oxysterol-binding protein	 10	0.775773388298536	1	1	9	917	5688	0.720588235294118
IPR000651	Ras-like guanine nucleotide exchange factor, N-terminal	 15	0.893920125880807	1	1	14	917	5683	0.480392156862745
IPR000697	WH1/EVH1 domain	  5	0.144431742808919	1	2	3	916	5694	2.88235294117647
IPR000699	RIH (RyR and IP3R Homology) domain	  6	0.592113395124177	1	1	5	917	5692	1.20098039215686
IPR000716	Thyroglobulin type-1	 10	1	1	0	10	918	5687	0
IPR000717	Proteasome component (PCI) domain	 10	1	1	0	10	918	5687	0
IPR000727	Target SNARE coiled-coil homology domain	 18	0.0927603594174299	1	5	13	913	5684	2.0016339869281
IPR000731	Sterol-sensing domain	  6	0.592113395124177	1	1	5	917	5692	1.20098039215686
IPR000742	EGF-like domain	 89	0.886598526417437	1	9	80	909	5617	0.728684732319894
IPR000756	Diacylglycerol kinase, accessory domain	  6	0.592113395124177	1	1	5	917	5692	1.20098039215686
IPR000772	Ricin B, lectin domain	 13	0.856884549116407	1	1	12	917	5685	0.554298642533937
IPR000795	Transcription factor, GTP-binding domain	 11	0.0543215783850452	1	4	7	914	5690	2.62032085561497
IPR000798	Ezrin/radixin/moesin-like	 11	1	1	0	11	918	5686	0
IPR000832	GPCR, family 2, secretin-like	 13	1	1	0	13	918	5684	0
IPR000834	Peptidase M14, carboxypeptidase A	  5	1	1	0	5	918	5692	0
IPR000837	AP-1 transcription factor	  5	0.526329856249264	1	1	4	917	5693	1.44117647058824
IPR000859	CUB domain	 19	0.762789939333549	1	2	17	916	5680	0.758513931888545
IPR000863	Sulfotransferase domain	 11	1	1	0	11	918	5686	0
IPR000867	Insulin-like growth factor-binding protein, IGFBP	 10	1	1	0	10	918	5687	0
IPR000873	AMP-dependent synthetase/ligase	 10	0.15139661152445	1	3	7	915	5690	2.16176470588235
IPR000884	Thrombospondin type-1 (TSP1) repeat	 18	0.735420703163206	1	2	16	916	5681	0.800653594771242
IPR000885	Fibrillar collagen, C-terminal	  7	1	1	0	7	918	5690	0
IPR000904	Sec7 domain	 10	1	1	0	10	918	5687	0
IPR000906	ZU5 domain	  9	1	1	0	9	918	5688	0
IPR000909	Phosphatidylinositol-specific phospholipase C, X domain	  8	0.697563287229438	1	1	7	917	5690	0.900735294117647
IPR000938	CAP Gly-rich domain	  6	0.592113395124177	1	1	5	917	5692	1.20098039215686
IPR000953	Chromo/chromo shadow domain	 11	0.187799748951727	1	3	8	915	5689	1.96524064171123
IPR000961	AGC-kinase, C-terminal	 31	0.641311766345287	1	4	27	914	5670	0.929791271347249
IPR000980	SH2 domain	 46	0.179509169538221	1	9	37	909	5660	1.40984654731458
IPR001003	MHC class II, alpha chain, N-terminal	  5	0.526329856249264	1	1	4	917	5693	1.44117647058824
IPR001005	SANT/Myb domain	 19	0.265216005277939	1	4	15	914	5682	1.51702786377709
IPR001007	VWFC domain	 17	0.921379291995624	1	1	16	917	5681	0.423875432525952
IPR001012	UBX domain	  6	0.0384709046773625	1	3	3	915	5694	3.60294117647059
IPR001019	Guanine nucleotide binding protein (G-protein), alpha subunit	  9	0.739584916156844	1	1	8	917	5689	0.800653594771242
IPR001054	Adenylyl cyclase class-3/4/guanylyl cyclase	  8	1	1	0	8	918	5689	0
IPR001060	FCH domain	  9	0.739584916156844	1	1	8	917	5689	0.800653594771242
IPR001071	Cellular retinaldehyde binding/alpha-tocopherol transport	  6	1	1	0	6	918	5691	0
IPR001073	C1q domain	 11	0.464130648643814	1	2	9	916	5688	1.31016042780749
IPR001089	CXC chemokine	  5	1	1	0	5	918	5692	0
IPR001090	Ephrin receptor ligand binding domain	  5	1	1	0	5	918	5692	0
IPR001101	Plectin repeat	  5	0.526329856249264	1	1	4	917	5693	1.44117647058824
IPR001111	TGF-beta, propeptide	  7	1	1	0	7	918	5690	0
IPR001128	Cytochrome P450	 13	0.856884549116407	1	1	12	917	5685	0.554298642533937
IPR001132	SMAD domain, Dwarfin-type	  7	0.252177032640286	1	2	5	916	5692	2.05882352941176
IPR001134	Netrin domain	  9	0.739584916156844	1	1	8	917	5689	0.800653594771242
IPR001148	Alpha carbonic anhydrase	  9	0.739584916156844	1	1	8	917	5689	0.800653594771242
IPR001164	Arf GTPase activating protein	 14	1	1	0	14	918	5683	0
IPR001173	Glycosyltransferase 2-like	 10	0.775773388298536	1	1	9	917	5688	0.720588235294118
IPR001179	FKBP-type peptidyl-prolyl cis-trans isomerase domain	  6	1	1	0	6	918	5691	0
IPR001180	Citron homology (CNH) domain	  9	0.739584916156844	1	1	8	917	5689	0.800653594771242
IPR001190	SRCR domain	  7	1	1	0	7	918	5690	0
IPR001192	Phosphoinositide phospholipase C family	  6	0.592113395124177	1	1	5	917	5692	1.20098039215686
IPR001194	DENN domain	  6	0.592113395124177	1	1	5	917	5692	1.20098039215686
IPR001199	Cytochrome b5-like heme/steroid binding domain	  7	0.252177032640286	1	2	5	916	5692	2.05882352941176
IPR001202	WW domain	 29	0.37590421194423	1	5	24	913	5673	1.24239350912779
IPR001206	Diacylglycerol kinase, catalytic domain	  8	0.307212633699208	1	2	6	916	5691	1.80147058823529
IPR001214	SET domain	 16	0.172043945536722	1	4	12	914	5685	1.80147058823529
IPR001217	Transcription factor STAT	  5	0.144431742808919	1	2	3	916	5694	2.88235294117647
IPR001245	Serine-threonine/tyrosine-protein kinase, catalytic domain	 61	0.761120382396797	1	7	54	911	5643	0.826904532304725
IPR001251	CRAL-TRIO lipid binding domain	 17	0.426559797149463	1	3	14	915	5683	1.27162629757785
IPR001254	Serine proteases, trypsin domain	 16	1	1	0	16	918	5681	0
IPR001258	NHL repeat	  5	1	1	0	5	918	5692	0
IPR001263	Phosphoinositide 3-kinase, accessory (PIK) domain	  6	0.592113395124177	1	1	5	917	5692	1.20098039215686
IPR001279	Metallo-beta-lactamase	  8	1	1	0	8	918	5689	0
IPR001304	C-type lectin-like	 17	0.921379291995624	1	1	16	917	5681	0.423875432525952
IPR001309	Peptidase C14,  p20 domain	  5	0.526329856249264	1	1	4	917	5693	1.44117647058824
IPR001314	Peptidase S1A, chymotrypsin family	 15	1	1	0	15	918	5682	0
IPR001315	CARD domain	  7	0.648769455538159	1	1	6	917	5691	1.02941176470588
IPR001320	Ionotropic glutamate receptor	  8	1	1	0	8	918	5689	0
IPR001331	Guanine-nucleotide dissociation stimulator, CDC24, conserved site	 13	0.856884549116407	1	1	12	917	5685	0.554298642533937
IPR001353	Proteasome, subunit alpha/beta	  5	0.526329856249264	1	1	4	917	5693	1.44117647058824
IPR001356	Homeobox domain	 31	0.641311766345287	1	4	27	914	5670	0.929791271347249
IPR001357	BRCT domain	 12	0.226127899181581	1	3	9	915	5688	1.80147058823529
IPR001368	TNFR/NGFR cysteine-rich region	  8	1	1	0	8	918	5689	0
IPR001373	Cullin, N-terminal	  8	1	1	0	8	918	5689	0
IPR001374	R3H domain	  5	0.526329856249264	1	1	4	917	5693	1.44117647058824
IPR001375	Peptidase S9, prolyl oligopeptidase, catalytic domain	  5	0.144431742808919	1	2	3	916	5694	2.88235294117647
IPR001388	Synaptobrevin	 10	0.775773388298536	1	1	9	917	5688	0.720588235294118
IPR001390	Gamma-aminobutyric-acid A receptor, alpha subunit	  5	1	1	0	5	918	5692	0
IPR001394	Peptidase C19, ubiquitin carboxyl-terminal hydrolase	 32	0.666788910182086	1	4	28	914	5669	0.900735294117647
IPR001401	Dynamin, GTPase domain	  6	0.0384709046773625	1	3	3	915	5694	3.60294117647059
IPR001412	Aminoacyl-tRNA synthetase, class I, conserved site	 10	0.775773388298536	1	1	9	917	5688	0.720588235294118
IPR001426	Tyrosine-protein kinase, receptor class V, conserved site	  5	1	1	0	5	918	5692	0
IPR001433	Oxidoreductase FAD/NAD(P)-binding	  6	1	1	0	6	918	5691	0
IPR001436	Alpha crystallin/Heat shock protein	  5	1	1	0	5	918	5692	0
IPR001440	Tetratricopeptide repeat 1	 15	0.34661660258468	1	3	12	915	5685	1.44117647058824
IPR001464	Annexin	  7	0.648769455538159	1	1	6	917	5691	1.02941176470588
IPR001478	PDZ domain	 73	0.951237526022876	1	6	67	912	5630	0.592264302981467
IPR001487	Bromodomain	 25	0.260403439551297	1	5	20	913	5677	1.44117647058824
IPR001494	Importin-beta, N-terminal domain	 11	0.0113927467265165	1	5	6	913	5691	3.27540106951872
IPR001496	SOCS box domain	 10	0.413888666881617	1	2	8	916	5689	1.44117647058824
IPR001508	Ionotropic glutamate receptor, metazoa	  8	1	1	0	8	918	5689	0
IPR001565	Synaptotagmin	 11	0.806937662264008	1	1	10	917	5687	0.655080213903743
IPR001589	Actinin-type actin-binding domain, conserved site	 12	0.511731198536261	1	2	10	916	5687	1.20098039215686
IPR001590	Peptidase M12B, ADAM/reprolysin	 11	0.806937662264008	1	1	10	917	5687	0.655080213903743
IPR001594	Palmitoyltransferase, DHHC domain	 11	0.806937662264008	1	1	10	917	5687	0.655080213903743
IPR001606	ARID DNA-binding domain	  7	0.252177032640286	1	2	5	916	5692	2.05882352941176
IPR001607	Zinc finger, UBP-type	  9	0.361390255810184	1	2	7	916	5690	1.60130718954248
IPR001609	Myosin head, motor domain	 12	0.511731198536261	1	2	10	916	5687	1.20098039215686
IPR001610	PAC motif	  6	0.592113395124177	1	1	5	917	5692	1.20098039215686
IPR001611	Leucine-rich repeat	 94	0.95977100030717	1	8	86	910	5611	0.613266583229036
IPR001623	DnaJ domain	 29	0.586665741692085	1	4	25	914	5672	0.993914807302231
IPR001627	Sema domain	 12	1	1	0	12	918	5685	0
IPR001628	Zinc finger, nuclear hormone receptor-type	 16	0.386902600364978	1	3	13	915	5684	1.35110294117647
IPR001650	Helicase, C-terminal	 43	0.731279857581539	1	5	38	913	5659	0.837893296853625
IPR001660	Sterile alpha motif domain	 45	0.08508378050959	1	10	35	908	5662	1.60130718954248
IPR001664	Intermediate filament protein	 13	0.0940603429147892	1	4	9	914	5688	2.21719457013575
IPR001666	Phosphatidylinositol transfer protein	  5	0.526329856249264	1	1	4	917	5693	1.44117647058824
IPR001675	Glycosyl transferase family 29	  8	0.697563287229438	1	1	7	917	5690	0.900735294117647
IPR001683	Phox homologous domain	 29	0.925930181439429	1	2	27	916	5670	0.496957403651116
IPR001709	Flavoprotein pyridine nucleotide cytochrome reductase	  5	1	1	0	5	918	5692	0
IPR001711	Phospholipase C, phosphatidylinositol-specific, Y domain	  6	0.592113395124177	1	1	5	917	5692	1.20098039215686
IPR001715	Calponin homology domain	 40	0.930260451617619	1	3	37	915	5660	0.540441176470588
IPR001723	Nuclear hormone receptor	 16	0.386902600364978	1	3	13	915	5684	1.35110294117647
IPR001739	Methyl-CpG DNA binding	  9	0.361390255810184	1	2	7	916	5690	1.60130718954248
IPR001751	S100/Calbindin-D9k, conserved site	 11	0.464130648643814	1	2	9	916	5688	1.31016042780749
IPR001752	Kinesin motor domain	 20	0.949845130957032	1	1	19	917	5678	0.360294117647059
IPR001753	Crotonase superfamily	  6	1	1	0	6	918	5691	0
IPR001757	P-type ATPase	 21	0.956826506208199	1	1	20	917	5677	0.343137254901961
IPR001762	Disintegrin domain	  6	1	1	0	6	918	5691	0
IPR001763	Rhodanese-like domain	 10	0.775773388298536	1	1	9	917	5688	0.720588235294118
IPR001766	Fork head domain	 12	0.0728152982621673	1	4	8	914	5689	2.40196078431373
IPR001781	Zinc finger, LIM-type	 28	0.91639460887295	1	2	26	916	5671	0.514705882352941
IPR001791	Laminin G domain	 26	0.893768794384667	1	2	24	916	5673	0.554298642533937
IPR001806	Small GTPase superfamily	 72	0.800534582596459	1	8	64	910	5633	0.800653594771242
IPR001810	F-box domain	 28	0.0829139242702986	1	7	21	911	5676	1.80147058823529
IPR001811	Chemokine interleukin-8-like domain	  9	0.739584916156844	1	1	8	917	5689	0.800653594771242
IPR001818	Peptidase M10, metallopeptidase	  5	1	1	0	5	918	5692	0
IPR001824	Tyrosine-protein kinase, receptor class III, conserved site	  5	1	1	0	5	918	5692	0
IPR001828	Receptor, ligand binding region	 13	1	1	0	13	918	5684	0
IPR001839	Transforming growth factor-beta, C-terminal	  8	1	1	0	8	918	5689	0
IPR001870	B30.2/SPRY domain	 23	0.848997525013311	1	2	21	916	5676	0.626598465473146
IPR001876	Zinc finger, RanBP2-type	 12	0.0173341386308011	1	5	7	913	5690	3.00245098039216
IPR001878	Zinc finger, CCHC-type	 16	0.908674872008295	1	1	15	917	5682	0.450367647058824
IPR001879	GPCR, family 2, extracellular hormone receptor domain	  9	1	1	0	9	918	5688	0
IPR001881	EGF-like calcium-binding domain	 44	0.988885219691654	1	2	42	916	5655	0.327540106951872
IPR001895	Ras guanine-nucleotide exchange factors catalytic domain	 18	0.932318032515178	1	1	17	917	5680	0.400326797385621
IPR001909	Krueppel-associated box	 94	0.773329324425245	1	11	83	907	5614	0.843241551939925
IPR001932	PPM-type phosphatase domain	 10	0.775773388298536	1	1	9	917	5688	0.720588235294118
IPR001936	Ras GTPase-activating protein	  9	0.117590956310789	1	3	6	915	5691	2.40196078431373
IPR001965	Zinc finger, PHD-type	 39	0.014325061523777	1	11	28	907	5669	2.03242835595777
IPR001991	Sodium:dicarboxylate symporter	  6	1	1	0	6	918	5691	0
IPR002011	Tyrosine-protein kinase, receptor class II, conserved site	  5	0.0214248688978567	1	3	2	915	5695	4.32352941176471
IPR002017	Spectrin repeat	 15	0.143946499415546	1	4	11	914	5686	1.92156862745098
IPR002018	Carboxylesterase, type B	  7	0.648769455538159	1	1	6	917	5691	1.02941176470588
IPR002035	von Willebrand factor, type A	 44	0.584914742938055	1	6	38	912	5659	0.982620320855615
IPR002048	EF-hand domain	 93	0.212534807259749	1	16	77	902	5620	1.23972169512966
IPR002049	Laminin EGF domain	 12	0.511731198536261	1	2	10	916	5687	1.20098039215686
IPR002058	PAP/25A-associated	  5	1	1	0	5	918	5692	0
IPR002067	Mitochondrial carrier protein	 12	0.833774613511985	1	1	11	917	5686	0.600490196078431
IPR002068	Alpha crystallin/Hsp20 domain	  5	1	1	0	5	918	5692	0
IPR002073	3'5'-cyclic nucleotide phosphodiesterase, catalytic domain	 14	0.87678457697329	1	1	13	917	5684	0.514705882352941
IPR002076	ELO family	  5	0.144431742808919	1	2	3	916	5694	2.88235294117647
IPR002077	Voltage-dependent calcium channel, alpha-1 subunit	  5	1	1	0	5	918	5692	0
IPR002110	Ankyrin repeat	 96	0.965847873708817	1	8	88	910	5609	0.600490196078431
IPR002123	Phospholipid/glycerol acyltransferase	  5	0.526329856249264	1	1	4	917	5693	1.44117647058824
IPR002126	Cadherin	 28	0.91639460887295	1	2	26	916	5671	0.514705882352941
IPR002130	Cyclophilin-type peptidyl-prolyl cis-trans isomerase domain	 10	1	1	0	10	918	5687	0
IPR002164	Nucleosome assembly protein (NAP)	  6	0.592113395124177	1	1	5	917	5692	1.20098039215686
IPR002165	Plexin repeat	 12	1	1	0	12	918	5685	0
IPR002172	Low-density lipoprotein (LDL) receptor class A repeat	 18	0.932318032515178	1	1	17	917	5680	0.400326797385621
IPR002181	Fibrinogen, alpha/beta/gamma chain, C-terminal globular domain	 11	1	1	0	11	918	5686	0
IPR002209	Fibroblast growth factor family	  6	1	1	0	6	918	5691	0
IPR002219	Protein kinase C-like, phorbol ester/diacylglycerol-binding domain	 33	0.690998382381356	1	4	29	914	5668	0.873440285204991
IPR002223	Pancreatic trypsin inhibitor Kunitz domain	  7	1	1	0	7	918	5690	0
IPR002293	Amino acid/polyamine transporter I	  7	0.648769455538159	1	1	6	917	5691	1.02941176470588
IPR002300	Aminoacyl-tRNA synthetase, class Ia	  6	0.592113395124177	1	1	5	917	5692	1.20098039215686
IPR002343	Paraneoplastic encephalomyelitis antigen	  8	0.697563287229438	1	1	7	917	5690	0.900735294117647
IPR002347	Short-chain dehydrogenase/reductase SDR	 25	0.260403439551297	1	5	20	913	5677	1.44117647058824
IPR002350	Kazal domain	 17	0.921379291995624	1	1	16	917	5681	0.423875432525952
IPR002369	Integrin beta subunit, VWA domain	  5	1	1	0	5	918	5692	0
IPR002401	Cytochrome P450, E-class, group I	  9	0.739584916156844	1	1	8	917	5689	0.800653594771242
IPR002404	IRS-type PTB domain	  6	0.197412161874698	1	2	4	916	5693	2.40196078431373
IPR002420	Phosphatidylinositol 3-kinase, C2 domain	  5	1	1	0	5	918	5692	0
IPR002423	Chaperonin Cpn60/TCP-1 family	  7	0.252177032640286	1	2	5	916	5692	2.05882352941176
IPR002453	Beta tubulin	  6	1	1	0	6	918	5691	0
IPR002464	DNA/RNA helicase, ATP-dependent, DEAH-box type, conserved site	 10	0.775773388298536	1	1	9	917	5688	0.720588235294118
IPR002477	Peptidoglycan binding-like	  5	1	1	0	5	918	5692	0
IPR002483	PWI domain	  6	0.197412161874698	1	2	4	916	5693	2.40196078431373
IPR002495	Glycosyl transferase, family 8	  5	0.526329856249264	1	1	4	917	5693	1.44117647058824
IPR002498	Phosphatidylinositol-4-phosphate 5-kinase, core	  6	1	1	0	6	918	5691	0
IPR002524	Cation efflux protein	  7	0.252177032640286	1	2	5	916	5692	2.05882352941176
IPR002553	Clathrin/coatomer adaptor, adaptin-like, N-terminal	  7	1	1	0	7	918	5690	0
IPR002589	Macro domain	  8	0.697563287229438	1	1	7	917	5690	0.900735294117647
IPR002591	Type I phosphodiesterase/nucleotide pyrophosphatase/phosphate transferase	  6	0.197412161874698	1	2	4	916	5693	2.40196078431373
IPR002653	Zinc finger, A20-type	  5	0.526329856249264	1	1	4	917	5693	1.44117647058824
IPR002857	Zinc finger, CXXC-type	  5	0.526329856249264	1	1	4	917	5693	1.44117647058824
IPR002867	IBR domain	 10	1	1	0	10	918	5687	0
IPR002870	Peptidase M12B, propeptide	 11	0.806937662264008	1	1	10	917	5687	0.655080213903743
IPR002893	Zinc finger, MYND-type	  9	0.361390255810184	1	2	7	916	5690	1.60130718954248
IPR002909	IPT domain	  9	0.361390255810184	1	2	7	916	5690	1.60130718954248
IPR002913	START domain	  5	0.526329856249264	1	1	4	917	5693	1.44117647058824
IPR002934	Polymerase, nucleotidyl transferase domain	  7	1	1	0	7	918	5690	0
IPR002939	Chaperone DnaJ, C-terminal	  6	1	1	0	6	918	5691	0
IPR002999	Tudor domain	 13	0.856884549116407	1	1	12	917	5685	0.554298642533937
IPR003006	Immunoglobulin/major histocompatibility complex, conserved site	 17	0.705404152211027	1	2	15	916	5682	0.847750865051903
IPR003008	Tubulin/FtsZ, GTPase domain	 12	0.833774613511985	1	1	11	917	5686	0.600490196078431
IPR003019	Metallothionein	  7	1	1	0	7	918	5690	0
IPR003034	SAP domain	  9	0.361390255810184	1	2	7	916	5690	1.60130718954248
IPR003096	Smooth muscle protein/calponin	  7	1	1	0	7	918	5690	0
IPR003100	PAZ domain	  6	0.197412161874698	1	2	4	916	5693	2.40196078431373
IPR003107	HAT (Half-A-TPR) repeat	  6	0.592113395124177	1	1	5	917	5692	1.20098039215686
IPR003112	Olfactomedin-like domain	 10	0.775773388298536	1	1	9	917	5688	0.720588235294118
IPR003117	cAMP-dependent protein kinase regulatory subunit, dimerization-anchoring domain	  7	0.648769455538159	1	1	6	917	5691	1.02941176470588
IPR003124	WH2 domain	  8	0.697563287229438	1	1	7	917	5690	0.900735294117647
IPR003130	Dynamin GTPase effector	  5	0.144431742808919	1	2	3	916	5694	2.88235294117647
IPR003131	Potassium channel tetramerisation-type BTB domain	 21	0.956826506208199	1	1	20	917	5677	0.343137254901961
IPR003137	PA domain	  9	0.739584916156844	1	1	8	917	5689	0.800653594771242
IPR003150	DNA-binding RFX-type winged-helix domain	  5	1	1	0	5	918	5692	0
IPR003152	FATC domain	  5	0.526329856249264	1	1	4	917	5693	1.44117647058824
IPR003191	Guanylate-binding protein, C-terminal	  5	1	1	0	5	918	5692	0
IPR003280	Two pore domain potassium channel	  5	0.526329856249264	1	1	4	917	5693	1.44117647058824
IPR003309	SCAN domain	 12	0.511731198536261	1	2	10	916	5687	1.20098039215686
IPR003323	OTU domain	  8	0.697563287229438	1	1	7	917	5690	0.900735294117647
IPR003347	JmjC domain	 12	0.511731198536261	1	2	10	916	5687	1.20098039215686
IPR003395	RecF/RecN/SMC, N-terminal	  6	1	1	0	6	918	5691	0
IPR003397	Mitochondrial inner membrane translocase subunit Tim17/Tim22/Tim23/peroxisomal protein PMP24	  5	0.526329856249264	1	1	4	917	5693	1.44117647058824
IPR003409	MORN motif	  6	1	1	0	6	918	5691	0
IPR003439	ABC transporter-like	 16	0.386902600364978	1	3	13	915	5684	1.35110294117647
IPR003527	Mitogen-activated protein (MAP) kinase, conserved site	  7	0.252177032640286	1	2	5	916	5692	2.05882352941176
IPR003585	Neurexin/syndecan/glycophorin C	 11	0.806937662264008	1	1	10	917	5687	0.655080213903743
IPR003591	Leucine-rich repeat, typical subtype	 71	0.976523629312537	1	5	66	913	5631	0.507456503728252
IPR003593	AAA+ ATPase domain	 56	0.00301768187285625	0.760176961659274	16	40	902	5657	2.05882352941176
IPR003594	Histidine kinase-like ATPase, C-terminal domain	 15	0.636886892268051	1	2	13	916	5684	0.96078431372549
IPR003595	Protein-tyrosine phosphatase, catalytic	 38	0.269457487891915	1	7	31	911	5666	1.32739938080495
IPR003597	Immunoglobulin C1-set	 17	0.921379291995624	1	1	16	917	5681	0.423875432525952
IPR003598	Immunoglobulin subtype 2	 87	0.930180050944662	1	8	79	910	5618	0.662609871534821
IPR003604	Matrin/U1-C-like, C2H2-type zinc finger	 16	0.386902600364978	1	3	13	915	5684	1.35110294117647
IPR003605	GS domain	  5	0.526329856249264	1	1	4	917	5693	1.44117647058824
IPR003607	HD/PDEase domain	 14	0.87678457697329	1	1	13	917	5684	0.514705882352941
IPR003616	Post-SET domain	  7	0.0604999849607275	1	3	4	915	5693	3.08823529411765
IPR003619	MAD homology 1, Dwarfin-type	 11	0.187799748951727	1	3	8	915	5689	1.96524064171123
IPR003644	Na-Ca exchanger/integrin-beta4	  8	1	1	0	8	918	5689	0
IPR003645	Follistatin-like, N-terminal	  5	1	1	0	5	918	5692	0
IPR003649	B-box, C-terminal	  8	1	1	0	8	918	5689	0
IPR003650	Orange domain	  6	0.592113395124177	1	1	5	917	5692	1.20098039215686
IPR003663	Sugar/inositol transporter	  6	1	1	0	6	918	5691	0
IPR003689	Zinc/iron permease	  5	0.526329856249264	1	1	4	917	5693	1.44117647058824
IPR003877	SPRY domain	 20	0.787667710099532	1	2	18	916	5679	0.720588235294118
IPR003879	Butyrophylin-like	  8	0.307212633699208	1	2	6	916	5691	1.80147058823529
IPR003892	Ubiquitin system component Cue	  7	0.648769455538159	1	1	6	917	5691	1.02941176470588
IPR003903	Ubiquitin interacting motif	 11	0.464130648643814	1	2	9	916	5688	1.31016042780749
IPR003954	RNA recognition motif domain, eukaryote	 10	0.0387110941455802	1	4	6	914	5691	2.88235294117647
IPR003959	ATPase, AAA-type, core	 26	0.0587509715238053	1	7	19	911	5678	1.94004524886878
IPR003960	ATPase, AAA-type, conserved site	 16	0.0596541610520203	1	5	11	913	5686	2.25183823529412
IPR003961	Fibronectin type III	 82	0.718754014679104	1	10	72	908	5625	0.878766140602583
IPR003968	Potassium channel, voltage dependent, Kv	 12	1	1	0	12	918	5685	0
IPR004000	Actin family	 12	0.226127899181581	1	3	9	915	5688	1.80147058823529
IPR004001	Actin, conserved site	  8	0.697563287229438	1	1	7	917	5690	0.900735294117647
IPR004012	RUN domain	 12	0.833774613511985	1	1	11	917	5686	0.600490196078431
IPR004014	Cation-transporting P-type ATPase, N-terminal	 11	0.806937662264008	1	1	10	917	5687	0.655080213903743
IPR004031	PMP-22/EMP/MP20/Claudin superfamily	 13	1	1	0	13	918	5684	0
IPR004045	Glutathione S-transferase, N-terminal	 10	0.413888666881617	1	2	8	916	5689	1.44117647058824
IPR004046	Glutathione S-transferase, C-terminal	  9	0.361390255810184	1	2	7	916	5690	1.60130718954248
IPR004087	K Homology domain	 15	1	1	0	15	918	5682	0
IPR004088	K Homology domain, type 1	 18	0.932318032515178	1	1	17	917	5680	0.400326797385621
IPR004092	Mbt repeat	  5	0.144431742808919	1	2	3	916	5694	2.88235294117647
IPR004148	BAR domain	  6	1	1	0	6	918	5691	0
IPR004156	Organic anion transporter polypeptide OATP	  5	1	1	0	5	918	5692	0
IPR004160	Translation elongation factor EFTu/EF1A, C-terminal	  5	1	1	0	5	918	5692	0
IPR004161	Translation elongation factor EFTu-like, domain 2	  9	0.117590956310789	1	3	6	915	5691	2.40196078431373
IPR004170	WWE domain	  9	1	1	0	9	918	5688	0
IPR004172	L27 domain	  8	1	1	0	8	918	5689	0
IPR004177	DDHD domain	  5	1	1	0	5	918	5692	0
IPR004182	GRAM domain	 11	0.806937662264008	1	1	10	917	5687	0.655080213903743
IPR004273	Dynein heavy chain domain	  5	1	1	0	5	918	5692	0
IPR004274	FCP1 homology domain	  5	0.144431742808919	1	2	3	916	5694	2.88235294117647
IPR004367	Cyclin, C-terminal domain	  6	0.592113395124177	1	1	5	917	5692	1.20098039215686
IPR004827	Basic-leucine zipper domain	 27	0.744448963415888	1	3	24	915	5673	0.800653594771242
IPR004837	Sodium/calcium exchanger membrane region	  5	0.526329856249264	1	1	4	917	5693	1.44117647058824
IPR004839	Aminotransferase, class I/classII	  8	0.0870702294635234	1	3	5	915	5692	2.70220588235294
IPR004843	Calcineurin-like phosphoesterase domain, ApaH type	 12	0.511731198536261	1	2	10	916	5687	1.20098039215686
IPR004853	Sugar phosphate transporter domain	  5	0.526329856249264	1	1	4	917	5693	1.44117647058824
IPR004910	Yippee/Mis18/Cereblon	  5	0.144431742808919	1	2	3	916	5694	2.88235294117647
IPR005112	dDENN domain	  6	0.592113395124177	1	1	5	917	5692	1.20098039215686
IPR005113	uDENN domain	  6	0.592113395124177	1	1	5	917	5692	1.20098039215686
IPR005123	Oxoglutarate/iron-dependent dioxygenase	  8	0.697563287229438	1	1	7	917	5690	0.900735294117647
IPR005135	Endonuclease/exonuclease/phosphatase	  6	0.592113395124177	1	1	5	917	5692	1.20098039215686
IPR005225	Small GTP-binding protein domain	 81	0.330477510398535	1	13	68	905	5629	1.15649963689179
IPR005301	MOB kinase activator family	  5	0.526329856249264	1	1	4	917	5693	1.44117647058824
IPR005331	Sulfotransferase	  6	0.592113395124177	1	1	5	917	5692	1.20098039215686
IPR005475	Transketolase-like, pyrimidine-binding domain	  6	0.592113395124177	1	1	5	917	5692	1.20098039215686
IPR005522	Inositol polyphosphate kinase	  5	1	1	0	5	918	5692	0
IPR005818	Linker histone H1/H5, domain H15	  5	1	1	0	5	918	5692	0
IPR005821	Ion transport domain	 43	0.987340118821868	1	2	41	916	5656	0.33515731874145
IPR005828	Major facilitator,  sugar transporter-like	 16	1	1	0	16	918	5681	0
IPR005829	Sugar transporter, conserved site	 12	1	1	0	12	918	5685	0
IPR006011	Syntaxin, N-terminal domain	  6	0.197412161874698	1	2	4	916	5693	2.40196078431373
IPR006012	Syntaxin/epimorphin, conserved site	  8	0.307212633699208	1	2	6	916	5691	1.80147058823529
IPR006020	PTB/PI domain	 27	0.161954934285077	1	6	21	912	5676	1.60130718954248
IPR006026	Peptidase, metallopeptidase	  6	1	1	0	6	918	5691	0
IPR006028	Gamma-aminobutyric acid A receptor/Glycine receptor alpha	 11	1	1	0	11	918	5686	0
IPR006029	Neurotransmitter-gated ion-channel transmembrane domain	 12	1	1	0	12	918	5685	0
IPR006068	Cation-transporting P-type ATPase, C-terminal	 10	0.775773388298536	1	1	9	917	5688	0.720588235294118
IPR006073	GTP binding domain	  9	0.117590956310789	1	3	6	915	5691	2.40196078431373
IPR006076	FAD dependent oxidoreductase	  5	0.144431742808919	1	2	3	916	5694	2.88235294117647
IPR006077	Vinculin/alpha-catenin	  5	1	1	0	5	918	5692	0
IPR006089	Acyl-CoA dehydrogenase, conserved site	  5	0.526329856249264	1	1	4	917	5693	1.44117647058824
IPR006091	Acyl-CoA oxidase/dehydrogenase, central domain	  5	0.526329856249264	1	1	4	917	5693	1.44117647058824
IPR006153	Cation/H+ exchanger	  5	0.526329856249264	1	1	4	917	5693	1.44117647058824
IPR006186	Serine/threonine-specific protein phosphatase/bis(5-nucleosyl)-tetraphosphatase	  6	0.197412161874698	1	2	4	916	5693	2.40196078431373
IPR006195	Aminoacyl-tRNA synthetase, class II	  7	1	1	0	7	918	5690	0
IPR006201	Neurotransmitter-gated ion-channel	 12	1	1	0	12	918	5685	0
IPR006202	Neurotransmitter-gated ion-channel ligand-binding domain	 12	1	1	0	12	918	5685	0
IPR006207	Cystine knot, C-terminal	 11	1	1	0	11	918	5686	0
IPR006211	Furin-like cysteine-rich domain	  5	0.144431742808919	1	2	3	916	5694	2.88235294117647
IPR006212	Furin-like repeat	 11	0.0543215783850452	1	4	7	914	5690	2.62032085561497
IPR006539	P-type ATPase, subfamily IV	  8	1	1	0	8	918	5689	0
IPR006553	Leucine-rich repeat, cysteine-containing subtype	 10	0.413888666881617	1	2	8	916	5689	1.44117647058824
IPR006569	CID domain	  7	0.0604999849607275	1	3	4	915	5693	3.08823529411765
IPR006574	SPRY-associated	  5	0.144431742808919	1	2	3	916	5694	2.88235294117647
IPR006575	RWD domain	  8	1	1	0	8	918	5689	0
IPR006586	ADAM, cysteine-rich	  6	1	1	0	6	918	5691	0
IPR006594	LIS1 homology motif	 16	0.172043945536722	1	4	12	914	5685	1.80147058823529
IPR006595	CTLH, C-terminal LisH motif	  6	1	1	0	6	918	5691	0
IPR006597	Sel1-like repeat	  5	0.526329856249264	1	1	4	917	5693	1.44117647058824
IPR006615	Peptidase C19, ubiquitin-specific peptidase, DUSP domain	  5	0.526329856249264	1	1	4	917	5693	1.44117647058824
IPR006620	Prolyl 4-hydroxylase, alpha subunit	  6	1	1	0	6	918	5691	0
IPR006630	RNA-binding protein Lupus La	  6	0.592113395124177	1	1	5	917	5692	1.20098039215686
IPR006634	TRAM/LAG1/CLN8 homology domain	 10	1	1	0	10	918	5687	0
IPR006636	Heat shock chaperonin-binding	  5	1	1	0	5	918	5692	0
IPR006639	Presenilin/signal peptide peptidase	  5	1	1	0	5	918	5692	0
IPR006652	Kelch repeat type 1	 22	0.830605909708602	1	2	20	916	5677	0.655080213903743
IPR006671	Cyclin, N-terminal	 15	0.0461045308613303	1	5	10	913	5687	2.40196078431373
IPR006689	Small GTPase superfamily, ARF/SAR type	 11	0.187799748951727	1	3	8	915	5689	1.96524064171123
IPR006694	Fatty acid hydroxylase	  5	1	1	0	5	918	5692	0
IPR006703	AIG1-type guanine nucleotide-binding (G) domain	  6	1	1	0	6	918	5691	0
IPR006903	RNA polymerase II-binding domain	  6	0.0384709046773625	1	3	3	915	5694	3.60294117647059
IPR006911	Armadillo repeat-containing domain	  7	1	1	0	7	918	5690	0
IPR007052	CS domain	  6	1	1	0	6	918	5691	0
IPR007123	Gelsolin-like domain	  6	1	1	0	6	918	5691	0
IPR007125	Histone H2A/H2B/H3	 11	1	1	0	11	918	5686	0
IPR007237	CD20-like family	  8	0.697563287229438	1	1	7	917	5690	0.900735294117647
IPR007330	MIT	 10	0.775773388298536	1	1	9	917	5688	0.720588235294118
IPR007484	Peptidase M28	  6	1	1	0	6	918	5691	0
IPR007502	Helicase-associated domain	  9	0.361390255810184	1	2	7	916	5690	1.60130718954248
IPR007632	Anoctamin	  6	1	1	0	6	918	5691	0
IPR007863	Peptidase M16, C-terminal	  6	1	1	0	6	918	5691	0
IPR008011	Complex 1 LYR protein	  5	0.526329856249264	1	1	4	917	5693	1.44117647058824
IPR008144	Guanylate kinase-like domain	 10	1	1	0	10	918	5687	0
IPR008145	Guanylate kinase/L-type calcium channel beta subunit	 14	1	1	0	14	918	5683	0
IPR008160	Collagen triple helix repeat	 29	0.925930181439429	1	2	27	916	5670	0.496957403651116
IPR008250	P-type ATPase, A  domain	 21	0.956826506208199	1	1	20	917	5677	0.343137254901961
IPR008253	Marvel domain	 16	0.386902600364978	1	3	13	915	5684	1.35110294117647
IPR008266	Tyrosine-protein kinase, active site	 41	0.840117148080484	1	4	37	914	5660	0.703012912482066
IPR008280	Tubulin/FtsZ, C-terminal	 12	0.833774613511985	1	1	11	917	5686	0.600490196078431
IPR008343	Mitogen-activated protein (MAP) kinase phosphatase	  6	0.592113395124177	1	1	5	917	5692	1.20098039215686
IPR008598	Drought induced 19 protein type, zinc-binding domain	  6	1	1	0	6	918	5691	0
IPR008916	Retrovirus capsid, C-terminal	 12	0.511731198536261	1	2	10	916	5687	1.20098039215686
IPR008917	Transcription factor, Skn-1-like, DNA-binding domain	  5	0.526329856249264	1	1	4	917	5693	1.44117647058824
IPR008927	6-phosphogluconate dehydrogenase C-terminal domain-like	  5	0.526329856249264	1	1	4	917	5693	1.44117647058824
IPR008930	Terpenoid cyclases/protein prenyltransferase alpha-alpha toroid	  6	1	1	0	6	918	5691	0
IPR008936	Rho GTPase activation protein	 38	0.147379529584553	1	8	30	910	5667	1.51702786377709
IPR008942	ENTH/VHS	 14	0.306082581950853	1	3	11	915	5686	1.54411764705882
IPR008952	Tetraspanin, EC2 domain	 10	0.775773388298536	1	1	9	917	5688	0.720588235294118
IPR008962	PapD-like	  5	0.526329856249264	1	1	4	917	5693	1.44117647058824
IPR008967	p53-like transcription factor, DNA-binding	 10	0.15139661152445	1	3	7	915	5690	2.16176470588235
IPR008969	Carboxypeptidase-like, regulatory domain	  7	1	1	0	7	918	5690	0
IPR008971	HSP40/DnaJ peptide-binding	  6	1	1	0	6	918	5691	0
IPR008972	Cupredoxin	  7	0.648769455538159	1	1	6	917	5691	1.02941176470588
IPR008974	TRAF-like	  9	1	1	0	9	918	5688	0
IPR008978	HSP20-like chaperone	 11	1	1	0	11	918	5686	0
IPR008979	Galactose-binding domain-like	 31	0.641311766345287	1	4	27	914	5670	0.929791271347249
IPR008983	Tumour necrosis factor-like domain	 14	0.306082581950853	1	3	11	915	5686	1.54411764705882
IPR008984	SMAD/FHA domain	 20	0.538890002439711	1	3	17	915	5680	1.08088235294118
IPR008993	Tissue inhibitor of metalloproteinases-like, OB-fold	  9	0.739584916156844	1	1	8	917	5689	0.800653594771242
IPR008996	Cytokine IL1/FGF	  7	1	1	0	7	918	5690	0
IPR009000	Translation protein, beta-barrel domain	 11	0.0543215783850452	1	4	7	914	5690	2.62032085561497
IPR009001	Translation elongation factor EF1A/initiation factor IF2gamma, C-terminal	  6	0.592113395124177	1	1	5	917	5692	1.20098039215686
IPR009003	Peptidase S1, PA clan	 19	1	1	0	19	918	5678	0
IPR009008	Valyl/Leucyl/Isoleucyl-tRNA synthetase, editing domain	  6	0.592113395124177	1	1	5	917	5692	1.20098039215686
IPR009011	Mannose-6-phosphate receptor binding domain	  5	0.526329856249264	1	1	4	917	5693	1.44117647058824
IPR009020	Protease propeptides/proteinase inhibitor I9	  5	0.144431742808919	1	2	3	916	5694	2.88235294117647
IPR009030	Growth factor receptor cysteine-rich domain	 55	0.896170131619558	1	5	50	913	5647	0.655080213903743
IPR009038	GOLD domain	  9	0.361390255810184	1	2	7	916	5690	1.60130718954248
IPR009057	Homeobox domain-like	 63	0.251810551777755	1	11	52	907	5645	1.25816993464052
IPR009060	UBA-like	 31	0.641311766345287	1	4	27	914	5670	0.929791271347249
IPR009061	Putative DNA-binding domain	  7	0.0604999849607275	1	3	4	915	5693	3.08823529411765
IPR009071	High mobility group box domain	 25	0.464406074239735	1	4	21	914	5676	1.15294117647059
IPR009072	Histone-fold	 21	0.956826506208199	1	1	20	917	5677	0.343137254901961
IPR009075	Acyl-CoA dehydrogenase/oxidase C-terminal	  5	0.526329856249264	1	1	4	917	5693	1.44117647058824
IPR009080	Aminoacyl-tRNA synthetase, class Ia, anticodon-binding	  8	0.307212633699208	1	2	6	916	5691	1.80147058823529
IPR009091	Regulator of chromosome condensation 1/beta-lactamase-inhibitor protein II	 13	1	1	0	13	918	5684	0
IPR009100	Acyl-CoA dehydrogenase/oxidase, N-terminal and middle domain	  5	0.526329856249264	1	1	4	917	5693	1.44117647058824
IPR009168	Insulin-like growth factor binding protein	  5	1	1	0	5	918	5692	0
IPR009818	Ataxin-2, C-terminal	  7	0.252177032640286	1	2	5	916	5692	2.05882352941176
IPR010294	ADAM-TS Spacer 1	  5	0.526329856249264	1	1	4	917	5693	1.44117647058824
IPR010569	Myotubularin-like phosphatase domain	 11	0.806937662264008	1	1	10	917	5687	0.655080213903743
IPR010703	Dedicator of cytokinesis, C-terminal	 10	0.775773388298536	1	1	9	917	5688	0.720588235294118
IPR010734	Copine	  8	0.307212633699208	1	2	6	916	5691	1.80147058823529
IPR010911	Rab-binding domain	  8	0.307212633699208	1	2	6	916	5691	1.80147058823529
IPR010919	SAND domain-like	  5	0.526329856249264	1	1	4	917	5693	1.44117647058824
IPR010920	LSM domain	  6	0.0384709046773625	1	3	3	915	5694	3.60294117647059
IPR010935	SMCs flexible hinge	  5	1	1	0	5	918	5692	0
IPR010982	Lambda repressor-like, DNA-binding domain	  6	0.197412161874698	1	2	4	916	5693	2.40196078431373
IPR010987	Glutathione S-transferase, C-terminal-like	 17	0.201835682037381	1	4	13	914	5684	1.69550173010381
IPR010989	SNARE	 10	0.15139661152445	1	3	7	915	5690	2.16176470588235
IPR011008	Dimeric alpha-beta barrel	  6	0.592113395124177	1	1	5	917	5692	1.20098039215686
IPR011011	Zinc finger, FYVE/PHD-type	 67	0.03838159142462	1	15	52	903	5645	1.61325724319579
IPR011012	Longin-like domain	 15	0.636886892268051	1	2	13	916	5684	0.96078431372549
IPR011016	Zinc finger, RING-CH-type	 11	0.187799748951727	1	3	8	915	5689	1.96524064171123
IPR011017	TRASH domain	  5	0.526329856249264	1	1	4	917	5693	1.44117647058824
IPR011021	Arrestin-like, N-terminal	  6	1	1	0	6	918	5691	0
IPR011022	Arrestin C-terminal-like domain	  6	1	1	0	6	918	5691	0
IPR011025	G protein alpha subunit, helical insertion	  9	0.739584916156844	1	1	8	917	5689	0.800653594771242
IPR011029	Death-like domain	 30	0.988808859236426	1	1	29	917	5668	0.240196078431373
IPR011032	GroES-like	  7	0.648769455538159	1	1	6	917	5691	1.02941176470588
IPR011040	Sialidases	  5	0.526329856249264	1	1	4	917	5693	1.44117647058824
IPR011041	Soluble quinoprotein glucose/sorbosone dehydrogenase	  5	1	1	0	5	918	5692	0
IPR011042	Six-bladed beta-propeller, TolB-like	 26	0.979602457743732	1	1	25	917	5672	0.277149321266968
IPR011043	Galactose oxidase/kelch, beta-propeller	  6	0.592113395124177	1	1	5	917	5692	1.20098039215686
IPR011044	Quinoprotein amine dehydrogenase, beta chain-like	  6	0.592113395124177	1	1	5	917	5692	1.20098039215686
IPR011047	Quinoprotein alcohol dehydrogenase-like superfamily	 17	0.705404152211027	1	2	15	916	5682	0.847750865051903
IPR011051	RmlC-like cupin domain	  5	0.526329856249264	1	1	4	917	5693	1.44117647058824
IPR011053	Single hybrid motif	  5	0.144431742808919	1	2	3	916	5694	2.88235294117647
IPR011074	CRAL/TRIO, N-terminal domain	  9	0.739584916156844	1	1	8	917	5689	0.800653594771242
IPR011161	MHC class I-like antigen recognition-like	  6	1	1	0	6	918	5691	0
IPR011162	MHC classes I/II-like antigen recognition protein	 14	0.87678457697329	1	1	13	917	5684	0.514705882352941
IPR011249	Metalloenzyme, LuxS/M16 peptidase-like	  6	1	1	0	6	918	5691	0
IPR011333	SKP1/BTB/POZ domain	 77	0.508804645862657	1	11	66	907	5631	1.02941176470588
IPR011511	Variant SH3 domain	 28	0.91639460887295	1	2	26	916	5671	0.514705882352941
IPR011524	SARAH domain	  6	0.197412161874698	1	2	4	916	5693	2.40196078431373
IPR011527	ABC transporter type 1, transmembrane domain	 10	0.413888666881617	1	2	8	916	5689	1.44117647058824
IPR011545	DEAD/DEAH box helicase domain	 26	0.720338798570586	1	3	23	915	5674	0.831447963800905
IPR011598	Myc-type, basic helix-loop-helix (bHLH) domain	 38	0.793103801446973	1	4	34	914	5663	0.758513931888545
IPR011641	Tyrosine-protein kinase ephrin type A/B receptor-like	 11	0.806937662264008	1	1	10	917	5687	0.655080213903743
IPR011701	Major facilitator superfamily	 23	0.637493949009158	1	3	20	915	5677	0.939897698209719
IPR011704	ATPase, dynein-related, AAA domain	  5	1	1	0	5	918	5692	0
IPR011705	BTB/Kelch-associated	 26	0.720338798570586	1	3	23	915	5674	0.831447963800905
IPR011709	Domain of unknown function DUF1605	  9	0.361390255810184	1	2	7	916	5690	1.60130718954248
IPR011761	ATP-grasp fold	  6	1	1	0	6	918	5691	0
IPR011765	Peptidase M16, N-terminal	  6	1	1	0	6	918	5691	0
IPR011991	Winged helix-turn-helix DNA-binding domain	 86	0.0457836543355682	1	18	68	900	5629	1.50820793433653
IPR012163	Sialyltransferase	  5	0.526329856249264	1	1	4	917	5693	1.44117647058824
IPR012317	Poly(ADP-ribose) polymerase, catalytic domain	  8	1	1	0	8	918	5689	0
IPR012336	Thioredoxin-like fold	 54	0.119948252394808	1	11	43	907	5654	1.46786492374728
IPR012337	Ribonuclease H-like domain	 25	0.464406074239735	1	4	21	914	5676	1.15294117647059
IPR012340	Nucleic acid-binding, OB-fold	 32	0.840964817819019	1	3	29	915	5668	0.675551470588235
IPR012345	STAT transcription factor, DNA-binding, subdomain	  5	0.144431742808919	1	2	3	916	5694	2.88235294117647
IPR012674	Calycin	 10	1	1	0	10	918	5687	0
IPR012675	Beta-grasp domain	  5	0.144431742808919	1	2	3	916	5694	2.88235294117647
IPR013019	MAD homology, MH1	  7	0.252177032640286	1	2	5	916	5692	2.05882352941176
IPR013026	Tetratricopeptide repeat-containing domain	 67	0.212121947318016	1	12	55	906	5642	1.29060579455663
IPR013032	EGF-like, conserved site	 75	0.959161912059547	1	6	69	912	5628	0.576470588235294
IPR013041	Coatomer/clathrin adaptor appendage, Ig-like subdomain	  6	0.592113395124177	1	1	5	917	5692	1.20098039215686
IPR013088	Zinc finger, NHR/GATA-type	 20	0.538890002439711	1	3	17	915	5680	1.08088235294118
IPR013092	Connexin, N-terminal	  6	1	1	0	6	918	5691	0
IPR013098	Immunoglobulin I-set	 63	0.790217170740799	1	7	56	911	5641	0.800653594771242
IPR013099	Potassium channel domain	 10	0.775773388298536	1	1	9	917	5688	0.720588235294118
IPR013105	Tetratricopeptide repeat 2	  9	0.361390255810184	1	2	7	916	5690	1.60130718954248
IPR013106	Immunoglobulin V-set domain	 51	0.979570344477945	1	3	48	915	5649	0.423875432525952
IPR013111	EGF-like domain, extracellular	 12	1	1	0	12	918	5685	0
IPR013126	Heat shock protein 70 family	 11	0.806937662264008	1	1	10	917	5687	0.655080213903743
IPR013151	Immunoglobulin	 26	0.496353072570307	1	4	22	914	5675	1.10859728506787
IPR013154	Alcohol dehydrogenase, N-terminal	  5	0.526329856249264	1	1	4	917	5693	1.44117647058824
IPR013155	Methionyl/Valyl/Leucyl/Isoleucyl-tRNA synthetase, anticodon-binding	  6	0.592113395124177	1	1	5	917	5692	1.20098039215686
IPR013162	CD80-like, immunoglobulin C2-set	 10	1	1	0	10	918	5687	0
IPR013164	Cadherin, N-terminal	 13	0.556455386258923	1	2	11	916	5686	1.10859728506787
IPR013216	Methyltransferase type 11	  6	0.00437883311835083	0.760176961659274	4	2	914	5695	4.80392156862745
IPR013273	Peptidase M12B, ADAM-TS	  5	0.526329856249264	1	1	4	917	5693	1.44117647058824
IPR013315	Spectrin alpha chain, SH3 domain	  7	1	1	0	7	918	5690	0
IPR013320	Concanavalin A-like lectin/glucanase domain	 74	0.98260715435923	1	5	69	913	5628	0.486883942766296
IPR013328	6-phosphogluconate dehydrogenase, domain 2	  5	0.526329856249264	1	1	4	917	5693	1.44117647058824
IPR013517	FG-GAP repeat	  9	1	1	0	9	918	5688	0
IPR013518	Potassium channel, inwardly rectifying, Kir, cytoplasmic	  8	1	1	0	8	918	5689	0
IPR013519	Integrin alpha beta-propellor	  9	1	1	0	9	918	5688	0
IPR013520	Exonuclease, RNase T/DNA polymerase III	  7	0.648769455538159	1	1	6	917	5691	1.02941176470588
IPR013602	Dynein heavy chain, domain-2	  5	1	1	0	5	918	5692	0
IPR013649	Integrin alpha-2	  8	1	1	0	8	918	5689	0
IPR013662	RyR/IP3R Homology associated domain	  6	0.592113395124177	1	1	5	917	5692	1.20098039215686
IPR013684	Mitochondrial Rho-like	  7	0.252177032640286	1	2	5	916	5692	2.05882352941176
IPR013761	Sterile alpha motif/pointed domain	 55	0.132218722687625	1	11	44	907	5653	1.44117647058824
IPR013763	Cyclin-like	 19	0.112190264869513	1	5	14	913	5683	1.89628482972136
IPR013766	Thioredoxin domain	 17	0.426559797149463	1	3	14	915	5683	1.27162629757785
IPR013767	PAS fold	  8	0.697563287229438	1	1	7	917	5690	0.900735294117647
IPR013785	Aldolase-type TIM barrel	 13	0.556455386258923	1	2	11	916	5686	1.10859728506787
IPR013786	Acyl-CoA dehydrogenase/oxidase, N-terminal	  5	0.526329856249264	1	1	4	917	5693	1.44117647058824
IPR013787	S100/CaBP-9k-type, calcium binding, subdomain	 10	0.413888666881617	1	2	8	916	5689	1.44117647058824
IPR013790	Dwarfin	  7	0.252177032640286	1	2	5	916	5692	2.05882352941176
IPR013799	STAT transcription factor, protein interaction	  5	0.144431742808919	1	2	3	916	5694	2.88235294117647
IPR013800	STAT transcription factor, all-alpha domain	  5	0.144431742808919	1	2	3	916	5694	2.88235294117647
IPR013801	STAT transcription factor, DNA-binding	  5	0.144431742808919	1	2	3	916	5694	2.88235294117647
IPR013806	Kringle-like fold	  7	1	1	0	7	918	5690	0
IPR013809	ENTH  domain	  5	1	1	0	5	918	5692	0
IPR013815	ATP-grasp fold, subdomain 1	  8	1	1	0	8	918	5689	0
IPR013838	Beta tubulin, autoregulation binding site	  6	1	1	0	6	918	5691	0
IPR014001	Helicase superfamily 1/2, ATP-binding domain	 43	0.731279857581539	1	5	38	913	5659	0.837893296853625
IPR014009	PIK-related kinase	  5	0.526329856249264	1	1	4	917	5693	1.44117647058824
IPR014014	RNA helicase, DEAD-box type, Q motif	 13	1	1	0	13	918	5684	0
IPR014352	FERM/acyl-CoA-binding protein, 3-helical bundle	 30	0.934432709513625	1	2	28	916	5669	0.480392156862745
IPR014710	RmlC-like jelly roll fold	 21	0.57344350967495	1	3	18	915	5679	1.02941176470588
IPR014715	Fibrinogen, alpha/beta/gamma chain, C-terminal globular, subdomain 2	  7	1	1	0	7	918	5690	0
IPR014716	Fibrinogen, alpha/beta/gamma chain, C-terminal globular, subdomain 1	 10	1	1	0	10	918	5687	0
IPR014720	Double-stranded RNA-binding domain	 12	0.511731198536261	1	2	10	916	5687	1.20098039215686
IPR014721	Ribosomal protein S5 domain 2-type fold, subgroup	 10	0.0387110941455802	1	4	6	914	5691	2.88235294117647
IPR014722	Ribosomal protein L2 domain 2	  5	1	1	0	5	918	5692	0
IPR014729	Rossmann-like alpha/beta/alpha sandwich fold	 21	0.810217625933698	1	2	19	916	5678	0.686274509803922
IPR014745	MHC class II, alpha/beta chain, N-terminal	  8	0.697563287229438	1	1	7	917	5690	0.900735294117647
IPR014756	Immunoglobulin E-set	 40	0.825544511554604	1	4	36	914	5661	0.720588235294118
IPR014767	Diaphanous autoregulatory (DAD) domain	  5	0.526329856249264	1	1	4	917	5693	1.44117647058824
IPR014768	Rho GTPase-binding/formin homology 3 (GBD/FH3) domain	  5	0.526329856249264	1	1	4	917	5693	1.44117647058824
IPR014775	L27 domain, C-terminal	  5	1	1	0	5	918	5692	0
IPR014821	Inositol 1,4,5-trisphosphate/ryanodine receptor	  6	0.592113395124177	1	1	5	917	5692	1.20098039215686
IPR014847	FERM adjacent (FA)	  7	1	1	0	7	918	5690	0
IPR015359	Phosphoinositide-specific phospholipase C, EF-hand-like domain	  6	0.592113395124177	1	1	5	917	5692	1.20098039215686
IPR015415	Vps4 oligomerisation, C-terminal	  6	0.197412161874698	1	2	4	916	5693	2.40196078431373
IPR015421	Pyridoxal phosphate-dependent transferase, major region, subdomain 1	 17	0.00529740042968135	0.760176961659274	7	10	911	5687	2.96712802768166
IPR015422	Pyridoxal phosphate-dependent transferase, subdomain 2	 16	0.0162953444418124	1	6	10	912	5687	2.70220588235294
IPR015424	Pyridoxal phosphate-dependent transferase	 17	0.00529740042968135	0.760176961659274	7	10	911	5687	2.96712802768166
IPR015425	Formin, FH2 domain	  6	0.592113395124177	1	1	5	917	5692	1.20098039215686
IPR015433	Phosphatidylinositol kinase	  6	0.592113395124177	1	1	5	917	5692	1.20098039215686
IPR015500	Peptidase S8, subtilisin-related	  5	0.0214248688978567	1	3	2	915	5695	4.32352941176471
IPR015526	Frizzled/secreted frizzled-related protein	  7	0.648769455538159	1	1	6	917	5691	1.02941176470588
IPR015590	Aldehyde dehydrogenase domain	  9	0.361390255810184	1	2	7	916	5690	1.60130718954248
IPR015615	Transforming growth factor-beta-related	  8	1	1	0	8	918	5689	0
IPR015621	Interleukin-1 receptor family	  5	1	1	0	5	918	5692	0
IPR015655	Protein phosphatase 2C family	  9	0.739584916156844	1	1	8	917	5689	0.800653594771242
IPR015797	NUDIX hydrolase domain-like	 13	0.556455386258923	1	2	11	916	5686	1.10859728506787
IPR015812	Integrin beta subunit	  5	1	1	0	5	918	5692	0
IPR015894	Guanylate-binding protein, N-terminal	  6	0.592113395124177	1	1	5	917	5692	1.20098039215686
IPR015898	G-protein gamma-like domain	  7	1	1	0	7	918	5690	0
IPR015915	Kelch-type beta propeller	 16	0.67259893396849	1	2	14	916	5683	0.900735294117647
IPR015916	Galactose oxidase, beta-propeller	 10	0.775773388298536	1	1	9	917	5688	0.720588235294118
IPR015919	Cadherin-like	 28	0.91639460887295	1	2	26	916	5671	0.514705882352941
IPR015925	Ryanodine receptor-related	  6	0.592113395124177	1	1	5	917	5692	1.20098039215686
IPR015940	Ubiquitin-associated domain	 25	0.260403439551297	1	5	20	913	5677	1.44117647058824
IPR015947	PUA-like domain	  8	0.697563287229438	1	1	7	917	5690	0.900735294117647
IPR015988	STAT transcription factor, coiled coil	  5	0.144431742808919	1	2	3	916	5694	2.88235294117647
IPR016035	Acyl transferase/acyl hydrolase/lysophospholipase	  6	1	1	0	6	918	5691	0
IPR016039	Thiolase-like	  6	0.592113395124177	1	1	5	917	5692	1.20098039215686
IPR016040	NAD(P)-binding domain	 80	0.0451815582037926	1	17	63	901	5634	1.53125
IPR016054	Ly-6 antigen/uPA receptor-like	  6	1	1	0	6	918	5691	0
IPR016064	NAD kinase/diacylglycerol kinase-like domain	  9	0.361390255810184	1	2	7	916	5690	1.60130718954248
IPR016093	MIR motif	  6	0.592113395124177	1	1	5	917	5692	1.20098039215686
IPR016130	Protein-tyrosine phosphatase, active site	 38	0.622534200160289	1	5	33	913	5664	0.948142414860681
IPR016135	Ubiquitin-conjugating enzyme/RWD-like	 27	0.527457479808166	1	4	23	914	5674	1.06753812636166
IPR016137	RGS domain	 19	0.762789939333549	1	2	17	916	5680	0.758513931888545
IPR016157	Cullin, conserved site	  6	1	1	0	6	918	5691	0
IPR016158	Cullin homology	  7	1	1	0	7	918	5690	0
IPR016159	Cullin repeat-like-containing domain	 12	1	1	0	12	918	5685	0
IPR016160	Aldehyde dehydrogenase, cysteine active site	  8	0.307212633699208	1	2	6	916	5691	1.80147058823529
IPR016161	Aldehyde/histidinol dehydrogenase	  9	0.361390255810184	1	2	7	916	5690	1.60130718954248
IPR016162	Aldehyde dehydrogenase N-terminal domain	  9	0.361390255810184	1	2	7	916	5690	1.60130718954248
IPR016177	DNA-binding domain	  9	0.361390255810184	1	2	7	916	5690	1.60130718954248
IPR016181	Acyl-CoA N-acyltransferase	 15	0.636886892268051	1	2	13	916	5684	0.96078431372549
IPR016185	Pre-ATP-grasp domain	  7	0.648769455538159	1	1	6	917	5691	1.02941176470588
IPR016186	C-type lectin-like/link domain	 23	0.968011532884786	1	1	22	917	5675	0.313299232736573
IPR016187	C-type lectin fold	 26	0.979602457743732	1	1	25	917	5672	0.277149321266968
IPR016197	Chromo domain-like	 11	0.464130648643814	1	2	9	916	5688	1.31016042780749
IPR016201	PSI domain	 19	1	1	0	19	918	5678	0
IPR016257	Ephrin receptor type-A /type-B	  5	1	1	0	5	918	5692	0
IPR016449	Potassium channel, inwardly rectifying, Kir	  8	1	1	0	8	918	5689	0
IPR016491	Septin	  6	0.197412161874698	1	2	4	916	5693	2.40196078431373
IPR017096	BTB-kelch protein	 14	0.598184186976935	1	2	12	916	5685	1.02941176470588
IPR017448	SRCR-like domain	  7	1	1	0	7	918	5690	0
IPR017452	GPCR, rhodopsin-like, 7TM	 65	0.958009026757374	1	5	60	913	5637	0.554298642533937
IPR017455	Zinc finger, FYVE-related	 18	0.465271744593597	1	3	15	915	5682	1.20098039215686
IPR017849	Alkaline phosphatase-like, alpha/beta/alpha	 10	0.00700529820410846	0.861651679105341	5	5	913	5692	3.60294117647059
IPR017850	Alkaline-phosphatase-like, core domain	 11	0.0017403599772188	0.760176961659274	6	5	912	5692	3.93048128342246
IPR017853	Glycoside hydrolase superfamily	 11	0.806937662264008	1	1	10	917	5687	0.655080213903743
IPR017854	Metallothionein domain	  7	1	1	0	7	918	5690	0
IPR017855	SMAD domain-like	  9	0.361390255810184	1	2	7	916	5690	1.60130718954248
IPR017868	Filamin/ABP280 repeat-like	  5	1	1	0	5	918	5692	0
IPR017871	ABC transporter, conserved site	 14	0.306082581950853	1	3	11	915	5686	1.54411764705882
IPR017877	Myb-like domain	  5	0.526329856249264	1	1	4	917	5693	1.44117647058824
IPR017884	SANT domain	 11	0.187799748951727	1	3	8	915	5689	1.96524064171123
IPR017891	Insulin-like growth factor binding protein, N-terminal, Cys-rich conserved site	  7	1	1	0	7	918	5690	0
IPR017892	Protein kinase, C-terminal	 20	0.538890002439711	1	3	17	915	5680	1.08088235294118
IPR017903	COS domain	  5	1	1	0	5	918	5692	0
IPR017907	Zinc finger, RING-type, conserved site	 52	0.595891796251928	1	7	45	911	5652	0.970022624434389
IPR017920	COMM domain	  5	0.144431742808919	1	2	3	916	5694	2.88235294117647
IPR017927	Ferredoxin reductase-type FAD-binding domain	  7	1	1	0	7	918	5690	0
IPR017937	Thioredoxin, conserved site	  9	0.739584916156844	1	1	8	917	5689	0.800653594771242
IPR017938	Riboflavin synthase-like beta-barrel	  7	1	1	0	7	918	5690	0
IPR017946	PLC-like phosphodiesterase, TIM beta/alpha-barrel domain	 12	0.511731198536261	1	2	10	916	5687	1.20098039215686
IPR017948	Transforming growth factor beta, conserved site	  8	1	1	0	8	918	5689	0
IPR017970	Homeobox, conserved site	 14	0.306082581950853	1	3	11	915	5686	1.54411764705882
IPR017972	Cytochrome P450, conserved site	 12	0.833774613511985	1	1	11	917	5686	0.600490196078431
IPR017975	Tubulin, conserved site	 12	0.833774613511985	1	1	11	917	5686	0.600490196078431
IPR017978	GPCR family 3, C-terminal	  7	1	1	0	7	918	5690	0
IPR017981	GPCR, family 2-like	 17	0.921379291995624	1	1	16	917	5681	0.423875432525952
IPR017983	GPCR, family 2, secretin-like, conserved site	  9	1	1	0	9	918	5688	0
IPR017984	Chromo domain subgroup	  5	0.526329856249264	1	1	4	917	5693	1.44117647058824
IPR017990	Connexin, conserved site	  6	1	1	0	6	918	5691	0
IPR018000	Neurotransmitter-gated ion-channel, conserved site	 12	1	1	0	12	918	5685	0
IPR018039	Intermediate filament protein, conserved site	 11	0.187799748951727	1	3	8	915	5689	1.96524064171123
IPR018048	CXC chemokine, conserved site	  5	1	1	0	5	918	5692	0
IPR018064	Metallothionein, vertebrate, metal binding site	  7	1	1	0	7	918	5690	0
IPR018097	EGF-like calcium-binding, conserved site	 38	0.975897360766513	1	2	36	916	5661	0.379256965944272
IPR018107	Sodium:dicarboxylate symporter, conserved site	  6	1	1	0	6	918	5691	0
IPR018108	Mitochondrial substrate/solute carrier	 20	0.0485764716312007	1	6	14	912	5683	2.16176470588235
IPR018114	Serine proteases, trypsin family, histidine active site	 11	1	1	0	11	918	5686	0
IPR018122	Fork head domain conserved site1	  9	0.117590956310789	1	3	6	915	5691	2.40196078431373
IPR018159	Spectrin/alpha-actinin	 18	0.465271744593597	1	3	15	915	5682	1.20098039215686
IPR018181	Heat shock protein 70, conserved site	 11	0.806937662264008	1	1	10	917	5687	0.655080213903743
IPR018184	Integrin alpha chain, C-terminal cytoplasmic region, conserved site	  8	1	1	0	8	918	5689	0
IPR018200	Ubiquitin specific protease, conserved site	 30	0.614590696648515	1	4	26	914	5671	0.96078431372549
IPR018247	EF-Hand 1, calcium-binding site	 75	0.088947147989494	1	15	60	903	5637	1.44117647058824
IPR018252	Annexin repeat, conserved site	  7	0.648769455538159	1	1	6	917	5691	1.02941176470588
IPR018253	DnaJ domain, conserved site	 16	0.908674872008295	1	1	15	917	5682	0.450367647058824
IPR018297	Adenylyl cyclase class-4/guanylyl cyclase, conserved site	  8	1	1	0	8	918	5689	0
IPR018303	P-type ATPase, phosphorylation site	 21	0.956826506208199	1	1	20	917	5677	0.343137254901961
IPR018316	Tubulin/FtsZ, 2-layer sandwich domain	 11	0.806937662264008	1	1	10	917	5687	0.655080213903743
IPR018338	Carbonic anhydrase, alpha-class, conserved site	  5	1	1	0	5	918	5692	0
IPR018359	Bromodomain, conserved site	 17	0.201835682037381	1	4	13	914	5684	1.69550173010381
IPR018378	C-type lectin, conserved site	  8	1	1	0	8	918	5689	0
IPR018487	Hemopexin-like repeats	  5	1	1	0	5	918	5692	0
IPR018488	Cyclic nucleotide-binding, conserved site	  5	0.526329856249264	1	1	4	917	5693	1.44117647058824
IPR018490	Cyclic nucleotide-binding-like	 14	0.598184186976935	1	2	12	916	5685	1.02941176470588
IPR018494	Oxysterol-binding protein, conserved site	 10	0.775773388298536	1	1	9	917	5688	0.720588235294118
IPR018499	Tetraspanin/Peripherin	 11	0.806937662264008	1	1	10	917	5687	0.655080213903743
IPR018502	Annexin repeat	  7	0.648769455538159	1	1	6	917	5691	1.02941176470588
IPR018503	Tetraspanin, conserved site	  8	0.697563287229438	1	1	7	917	5690	0.900735294117647
IPR018933	Netrin module, non-TIMP type	  7	0.648769455538159	1	1	6	917	5691	1.02941176470588
IPR018936	Phosphatidylinositol 3/4-kinase, conserved site	 10	0.413888666881617	1	2	8	916	5689	1.44117647058824
IPR018957	Zinc finger, C3HC4 RING-type	 12	0.833774613511985	1	1	11	917	5686	0.600490196078431
IPR018979	FERM, N-terminal	 19	0.762789939333549	1	2	17	916	5680	0.758513931888545
IPR018980	FERM, C-terminal PH-like domain	 17	0.705404152211027	1	2	15	916	5682	0.847750865051903
IPR019410	Lysine methyltransferase	  5	0.526329856249264	1	1	4	917	5693	1.44117647058824
IPR019559	Cullin protein, neddylation domain	  6	1	1	0	6	918	5691	0
IPR019570	Gap junction protein, cysteine-rich domain	  6	1	1	0	6	918	5691	0
IPR019577	SPARC/Testican, calcium-binding domain	  5	1	1	0	5	918	5692	0
IPR019594	Ionotropic glutamate receptor, L-glutamate and glycine-binding domain	  8	1	1	0	8	918	5689	0
IPR019734	Tetratricopeptide repeat	 71	0.275664137800863	1	12	59	906	5638	1.2178956089478
IPR019747	FERM conserved site	 17	0.921379291995624	1	1	16	917	5681	0.423875432525952
IPR019748	FERM central domain	 31	0.942004908343664	1	2	29	916	5668	0.464895635673624
IPR019749	Band 4.1 domain	 31	0.942004908343664	1	2	29	916	5668	0.464895635673624
IPR019762	Dynamin, GTPase region, conserved site	  5	0.144431742808919	1	2	3	916	5694	2.88235294117647
IPR019775	WD40 repeat, conserved site	 70	0.513142689560238	1	10	60	908	5637	1.02941176470588
IPR019786	Zinc finger, PHD-type, conserved site	 30	0.0471212106104011	1	8	22	910	5675	1.92156862745098
IPR019787	Zinc finger, PHD-finger	 35	0.0174802065570355	1	10	25	908	5672	2.05882352941176
IPR019804	Ras guanine-nucleotide exchange factor, conserved site	  9	0.739584916156844	1	1	8	917	5689	0.800653594771242
IPR019819	Carboxylesterase type B, conserved site	  7	0.648769455538159	1	1	6	917	5691	1.02941176470588
IPR019821	Kinesin motor domain, conserved site	 20	0.949845130957032	1	1	19	917	5678	0.360294117647059
IPR020067	Frizzled domain	  7	0.648769455538159	1	1	6	917	5691	1.02941176470588
IPR020084	NUDIX hydrolase, conserved site	  8	1	1	0	8	918	5689	0
IPR020422	Dual specificity protein phosphatase domain	 14	0.117855307801089	1	4	10	914	5687	2.05882352941176
IPR020454	Diacylglycerol/phorbol-ester binding	 18	0.932318032515178	1	1	17	917	5680	0.400326797385621
IPR020472	G-protein beta WD-40 repeat	 45	0.607858522269375	1	6	39	912	5658	0.96078431372549
IPR020568	Ribosomal protein S5 domain 2-type fold	 16	0.172043945536722	1	4	12	914	5685	1.80147058823529
IPR020590	Guanylate kinase, conserved site	  8	1	1	0	8	918	5689	0
IPR020635	Tyrosine-protein kinase, catalytic domain	 38	0.793103801446973	1	4	34	914	5663	0.758513931888545
IPR020636	Calcium/calmodulin-dependent/calcium-dependent protein kinase	 16	0.67259893396849	1	2	14	916	5683	0.900735294117647
IPR020683	Ankyrin repeat-containing domain	100	0.903761855152351	1	10	90	908	5607	0.720588235294118
IPR020843	Polyketide synthase, enoylreductase domain	  7	0.648769455538159	1	1	6	917	5691	1.02941176470588
IPR020845	AMP-binding, conserved site	  8	0.307212633699208	1	2	6	916	5691	1.80147058823529
IPR020846	Major facilitator superfamily domain	 47	0.967740582479737	1	3	44	915	5653	0.459949937421777
IPR020849	Small GTPase superfamily, Ras type	 23	0.968011532884786	1	1	22	917	5675	0.313299232736573
IPR020850	GTPase effector domain	  6	0.197412161874698	1	2	4	916	5693	2.40196078431373
IPR020892	Cyclophilin-type peptidyl-prolyl cis-trans isomerase, conserved site	  8	1	1	0	8	918	5689	0
IPR020894	Cadherin conserved site	 25	0.880428025475891	1	2	23	916	5674	0.576470588235294
IPR020901	Proteinase inhibitor I2, Kunitz, conserved site	  7	1	1	0	7	918	5690	0
IPR020902	Actin/actin-like conserved site	  8	0.307212633699208	1	2	6	916	5691	1.80147058823529
IPR020904	Short-chain dehydrogenase/reductase, conserved site	 19	0.112190264869513	1	5	14	913	5683	1.89628482972136
IPR021109	Aspartic peptidase domain	  5	0.526329856249264	1	1	4	917	5693	1.44117647058824
IPR021133	HEAT, type 2	 10	0.15139661152445	1	3	7	915	5690	2.16176470588235
IPR021156	Transcription elongation factor A-like/Brain expressed X-linked	  8	0.307212633699208	1	2	6	916	5691	1.80147058823529
IPR021190	Peptidase M10A	  5	1	1	0	5	918	5692	0
IPR021816	Dedicator of cytokinesis C/D, N-terminal	  5	0.526329856249264	1	1	4	917	5693	1.44117647058824
IPR022164	Kinesin-like	  5	0.526329856249264	1	1	4	917	5693	1.44117647058824
IPR022321	Insulin-like growth factor-binding protein family 1-6, chordata	  5	1	1	0	5	918	5692	0
IPR022398	Peptidase S8, subtilisin, His-active site	  5	0.0214248688978567	1	3	2	915	5695	4.32352941176471
IPR022755	Zinc finger, double-stranded RNA binding	  7	0.648769455538159	1	1	6	917	5691	1.02941176470588
IPR022764	Peptidase S54, rhomboid domain	  5	1	1	0	5	918	5692	0
IPR022775	AP complex, mu/sigma subunit	  8	1	1	0	8	918	5689	0
IPR022812	Dynamin superfamily	 11	0.0543215783850452	1	4	7	914	5690	2.62032085561497
IPR023088	3'5'-cyclic nucleotide phosphodiesterase	 13	0.856884549116407	1	1	12	917	5685	0.554298642533937
IPR023152	Ras GTPase-activating protein, conserved site	  8	0.0870702294635234	1	3	5	915	5692	2.70220588235294
IPR023174	3'5'-cyclic nucleotide phosphodiesterase, conserved site	 13	0.856884549116407	1	1	12	917	5685	0.554298642533937
IPR023210	NADP-dependent oxidoreductase domain	  5	0.526329856249264	1	1	4	917	5693	1.44117647058824
IPR023214	HAD-like domain	 40	0.930260451617619	1	3	37	915	5660	0.540441176470588
IPR023298	P-type ATPase,  transmembrane domain	  9	1	1	0	9	918	5688	0
IPR023299	P-type ATPase, cytoplasmic domain N	 21	0.956826506208199	1	1	20	917	5677	0.343137254901961
IPR023313	Ubiquitin-conjugating enzyme, active site	 12	0.0728152982621673	1	4	8	914	5689	2.40196078431373
IPR023362	PH-BEACH domain	  6	1	1	0	6	918	5691	0
IPR023393	START-like domain	 11	0.464130648643814	1	2	9	916	5688	1.31016042780749
IPR023394	Sec7 domain, alpha orthogonal bundle	  9	1	1	0	9	918	5688	0
IPR023395	Mitochondrial carrier domain	 20	0.0485764716312007	1	6	14	912	5683	2.16176470588235
IPR023409	14-3-3 protein, conserved site	  6	0.592113395124177	1	1	5	917	5692	1.20098039215686
IPR023410	14-3-3 domain	  6	0.592113395124177	1	1	5	917	5692	1.20098039215686
IPR023415	Low-density lipoprotein (LDL) receptor class A, conserved site	 18	0.932318032515178	1	1	17	917	5680	0.400326797385621
IPR023561	Carbonic anhydrase, alpha-class	  7	0.648769455538159	1	1	6	917	5691	1.02941176470588
IPR023566	Peptidyl-prolyl cis-trans isomerase, FKBP-type	  8	1	1	0	8	918	5689	0
IPR023578	Ras guanine nucleotide exchange factor domain	 18	0.932318032515178	1	1	17	917	5680	0.400326797385621
IPR023587	Metallothionein domain, vertebrate	  7	1	1	0	7	918	5690	0
IPR023610	Phosphatidylinositol-4-phosphate 5-kinase	  5	1	1	0	5	918	5692	0
IPR023753	FAD/NAD(P)-binding domain	 30	0.11197457676623	1	7	23	911	5674	1.68137254901961
IPR023779	Chromo domain, conserved site	  6	0.592113395124177	1	1	5	917	5692	1.20098039215686
IPR023780	Chromo domain	  9	0.361390255810184	1	2	7	916	5690	1.60130718954248
IPR023795	Serpin, conserved site	  9	0.739584916156844	1	1	8	917	5689	0.800653594771242
IPR023796	Serpin domain	  9	0.739584916156844	1	1	8	917	5689	0.800653594771242
IPR023828	Peptidase S8, subtilisin, Ser-active site	  5	0.0214248688978567	1	3	2	915	5695	4.32352941176471
IPR024066	RGS, subdomain 1	 13	0.856884549116407	1	1	12	917	5685	0.554298642533937
IPR024079	Metallopeptidase, catalytic domain	 19	0.941736259914157	1	1	18	917	5679	0.379256965944272
IPR024156	Small GTPase superfamily, ARF type	 10	0.15139661152445	1	3	7	915	5690	2.16176470588235
IPR024317	Dynein heavy chain, P-loop containing D4 domain	  5	1	1	0	5	918	5692	0
IPR024678	Serine/threonine-protein kinase OSR1/WNK, CCT domain	  5	0.526329856249264	1	1	4	917	5693	1.44117647058824
IPR024743	Dynein heavy chain, coiled coil stalk	  5	1	1	0	5	918	5692	0
IPR024936	Cyclophilin-type peptidyl-prolyl cis-trans isomerase	  9	1	1	0	9	918	5688	0
IPR024950	Dual specificity phosphatase	 12	0.226127899181581	1	3	9	915	5688	1.80147058823529
IPR024977	Anaphase-promoting complex subunit 4, WD40 domain	 10	0.413888666881617	1	2	8	916	5689	1.44117647058824
IPR025799	Protein arginine N-methyltransferase	  7	0.252177032640286	1	2	5	916	5692	2.05882352941176
IPR025875	Leucine rich repeat 4	  6	1	1	0	6	918	5691	0
IPR026523	Paraneoplastic antigen Ma	  8	0.697563287229438	1	1	7	917	5690	0.900735294117647
IPR026613	KRAB domain C2H2 zinc finger family	  7	0.648769455538159	1	1	6	917	5691	1.02941176470588
IPR026791	Dedicator of cytokinesis	 10	0.775773388298536	1	1	9	917	5688	0.720588235294118
IPR026823	Complement Clr-like EGF domain	 11	1	1	0	11	918	5686	0
IPR026854	Vacuolar protein sorting-associated protein 13, N-terminal domain	  6	1	1	0	6	918	5691	0
IPR026906	Leucine rich repeat 5	  5	1	1	0	5	918	5692	0
IPR026983	Dynein heavy chain	  5	1	1	0	5	918	5692	0
IPR027007	DHR-1 domain	 10	0.775773388298536	1	1	9	917	5688	0.720588235294118
IPR027231	Semaphorin	  7	1	1	0	7	918	5690	0
IPR027267	Arfaptin homology (AH) domain/BAR domain	 15	0.893920125880807	1	1	14	917	5683	0.480392156862745
IPR027357	DHR-2 domain	 10	0.775773388298536	1	1	9	917	5688	0.720588235294118
IPR027370	RING-type zinc-finger, LisH dimerisation motif	 13	0.556455386258923	1	2	11	916	5686	1.10859728506787
IPR027397	Catenin binding domain	 11	0.464130648643814	1	2	9	916	5688	1.31016042780749
IPR027409	GroEL-like apical domain	  7	0.252177032640286	1	2	5	916	5692	2.05882352941176
IPR027413	GroEL-like equatorial domain	  6	0.197412161874698	1	2	4	916	5693	2.40196078431373
IPR027483	Phosphatidylinositol-4-phosphate 5-kinase, C-terminal	  6	1	1	0	6	918	5691	0
IPR027484	Phosphatidylinositol-4-phosphate 5-kinase, N-terminal domain	  6	1	1	0	6	918	5691	0
IPR027775	C2H2- zinc finger protein family subset	  9	0.117590956310789	1	3	6	915	5691	2.40196078431373
IPR027789	Syndecan/Neurexin domain	  5	0.526329856249264	1	1	4	917	5693	1.44117647058824
IPR027936	Ephrin receptor, transmembrane domain	  5	1	1	0	5	918	5692	0
IPR028082	Periplasmic binding protein-like I	 13	1	1	0	13	918	5684	0
IPR028325	Voltage-gated potassium channel	 15	1	1	0	15	918	5682	0
IPR028375	KA1 domain/Ssp2, C-terminal	  5	0.526329856249264	1	1	4	917	5693	1.44117647058824
IPR028565	Mu homology domain	  8	0.697563287229438	1	1	7	917	5690	0.900735294117647
IPR028889	Ubiquitin specific protease domain	 34	0.713930806761181	1	4	30	914	5667	0.847750865051903
IPR029000	Cyclophilin-like domain	 10	1	1	0	10	918	5687	0
IPR029006	ADF-H/Gelsolin-like domain	 10	1	1	0	10	918	5687	0
IPR029021	Protein-tyrosine phosphatase-like	 56	0.372614131878351	1	9	47	909	5650	1.15808823529412
IPR029030	Caspase-like domain	  5	0.526329856249264	1	1	4	917	5693	1.44117647058824
IPR029033	Histidine phosphatase superfamily	 10	0.775773388298536	1	1	9	917	5688	0.720588235294118
IPR029034	Cystine-knot cytokine	 14	0.598184186976935	1	2	12	916	5685	1.02941176470588
IPR029035	DHS-like NAD/FAD-binding domain	  6	0.197412161874698	1	2	4	916	5693	2.40196078431373
IPR029039	Flavoprotein-like domain	  5	0.526329856249264	1	1	4	917	5693	1.44117647058824
IPR029044	Nucleotide-diphospho-sugar transferases	 33	0.491270236737379	1	5	28	913	5669	1.09180035650624
IPR029045	ClpP/crotonase-like domain	 10	0.775773388298536	1	1	9	917	5688	0.720588235294118
IPR029047	Heat shock protein 70kD, peptide-binding domain	 10	1	1	0	10	918	5687	0
IPR029048	Heat shock protein 70kD, C-terminal domain	  9	1	1	0	9	918	5688	0
IPR029052	Metallo-dependent phosphatase-like	 12	0.511731198536261	1	2	10	916	5687	1.20098039215686
IPR029055	Nucleophile aminohydrolases, N-terminal	 11	0.187799748951727	1	3	8	915	5689	1.96524064171123
IPR029057	Phosphoribosyltransferase-like	  6	0.197412161874698	1	2	4	916	5693	2.40196078431373
IPR029058	Alpha/Beta hydrolase fold	 52	0.595891796251928	1	7	45	911	5652	0.970022624434389
IPR029060	PIN domain-like	  5	0.526329856249264	1	1	4	917	5693	1.44117647058824
IPR029061	Thiamin diphosphate-binding fold	  8	0.307212633699208	1	2	6	916	5691	1.80147058823529
IPR029062	Class I glutamine amidotransferase-like	  7	0.648769455538159	1	1	6	917	5691	1.02941176470588
IPR029063	S-adenosyl-L-methionine-dependent methyltransferase	 50	0.00239061287160258	0.760176961659274	15	35	903	5662	2.16176470588235
IPR029071	Ubiquitin-related domain	 90	0.484258262924611	1	13	77	905	5620	1.04084967320261
IPR029510	Aldehyde dehydrogenase, glutamic acid active site	  8	0.307212633699208	1	2	6	916	5691	1.80147058823529
IPR029515	LAR-interacting protein, Liprin	  5	0.144431742808919	1	2	3	916	5694	2.88235294117647
IPR029787	Nucleotide cyclase	  8	1	1	0	8	918	5689	0
IPR030379	Septin-type guanine nucleotide-binding (G) domain	  6	0.197412161874698	1	2	4	916	5693	2.40196078431373
IPR030381	Dynamin-type guanine nucleotide-binding (G) domain	 11	0.0543215783850452	1	4	7	914	5690	2.62032085561497
IPR030386	GB1/RHD3-type guanine nucleotide-binding (G) domain	  6	0.592113395124177	1	1	5	917	5692	1.20098039215686
IPR030456	Fork head domain conserved site 2	 12	0.0728152982621673	1	4	8	914	5689	2.40196078431373
IPR030564	Myotubularin family	 11	0.806937662264008	1	1	10	917	5687	0.655080213903743
IPR030672	Adenylate cyclase	  5	1	1	0	5	918	5692	0
IPR031107	Small heat shock protein HSP20	  5	1	1	0	5	918	5692	0
IPR031127	E3 ubiquitin ligase RBR family	  8	1	1	0	8	918	5689	0
IPR031148	Plexin family	  5	1	1	0	5	918	5692	0
IPR031157	Tr-type G domain, conserved site	  7	0.0604999849607275	1	3	4	915	5693	3.08823529411765
IPR031160	F-BAR domain	 10	0.775773388298536	1	1	9	917	5688	0.720588235294118
IPR031259	Intracellular lipid binding protein	  7	1	1	0	7	918	5690	0
IPR032376	Dedicator of cytokinesis, N-terminal domain	  5	1	1	0	5	918	5692	0
IPR032405	Kinesin-associated	  5	0.526329856249264	1	1	4	917	5693	1.44117647058824
IPR032425	Talin, N-terminal F0 domain	  5	1	1	0	5	918	5692	0
IPR032455	Cadherin, cytoplasmic C-terminal domain	  8	0.307212633699208	1	2	6	916	5691	1.80147058823529
IPR032466	Metal-dependent hydrolase	  6	0.197412161874698	1	2	4	916	5693	2.40196078431373
IPR032471	GAIN domain, N-terminal	  6	1	1	0	6	918	5691	0
IPR032628	Adenylate cyclase, N-terminal	  5	1	1	0	5	918	5692	0
IPR032630	P-type ATPase, C-terminal	  8	1	1	0	8	918	5689	0
IPR032631	P-type ATPase, N-terminal	  8	1	1	0	8	918	5689	0
IPR032695	Integrin domain	 12	1	1	0	12	918	5685	0
IPR032710	NTF2-like domain	  8	0.697563287229438	1	1	7	917	5690	0.900735294117647
IPR032778	Growth factor receptor domain 4	  5	0.526329856249264	1	1	4	917	5693	1.44117647058824
IPR033116	Serine proteases, trypsin family, serine active site	 11	1	1	0	11	918	5686	0
IPR033275	E3 ubiquitin-protein ligase MARCH-like	  5	0.526329856249264	1	1	4	917	5693	1.44117647058824
IPR033760	Integrin beta N-terminal	  5	1	1	0	5	918	5692	0
