Term	Accession	Genes (tot)	Stat (non-dir.) p	p adj (non-dir.)	Significant..in.gene.set.	Non.significant..in.gene.set.	Significant..not.in.gene.set.	Non.significant..not.in.gene.set.	effect.size
GO:0000002	mitochondrial genome maintenance	  9	0.619953536302463	1	2	7	2211	7872	1.01340563337852
GO:0000027	ribosomal large subunit assembly	  6	0.391952090801775	1	2	4	2211	7875	1.52010845006778
GO:0000028	ribosomal small subunit assembly	  5	1	1	0	5	2213	7874	0
GO:0000030	mannosyltransferase activity	 11	0.731548842740116	1	2	9	2211	7870	0.829150063673335
GO:0000038	very long-chain fatty acid metabolic process	  8	0.246907474461687	1	3	5	2210	7874	1.71012200632625
GO:0000042	protein targeting to Golgi	 10	0.0101866485348348	0.88623842253063	6	4	2207	7875	2.73619521012201
GO:0000045	autophagosome assembly	 37	0.281925171345196	1	10	27	2203	7852	1.23252036491982
GO:0000049	tRNA binding	 38	0.0558839965351353	1	13	25	2200	7854	1.56011130401693
GO:0000050	urea cycle	  7	1	1	0	7	2213	7872	0
GO:0000055	ribosomal large subunit export from nucleus	  7	1	1	0	7	2213	7872	0
GO:0000056	ribosomal small subunit export from nucleus	  5	0.710033128778248	1	1	4	2212	7875	0.912065070040669
GO:0000060	protein import into nucleus, translocation	 16	0.715200159590258	1	3	13	2210	7866	0.855061003163127
GO:0000062	fatty-acyl-CoA binding	  9	0.313783026377615	1	3	6	2210	7873	1.52010845006778
GO:0000070	mitotic sister chromatid segregation	 12	0.508975472817498	1	3	9	2210	7870	1.14008133755084
GO:0000075	cell cycle checkpoint	  6	0.391952090801775	1	2	4	2211	7875	1.52010845006778
GO:0000077	DNA damage checkpoint	 20	0.454930598735057	1	5	15	2208	7864	1.14008133755084
GO:0000079	regulation of cyclin-dependent protein serine/threonine kinase activity	 27	0.56045703727351	1	6	21	2207	7858	1.01340563337852
GO:0000082	G1/S transition of mitotic cell cycle	 67	0.511650402770148	1	15	52	2198	7827	1.02096836198582
GO:0000083	regulation of transcription involved in G1/S transition of mitotic cell cycle	 13	0.135471430249234	1	5	8	2208	7871	1.75397128853975
GO:0000086	G2/M transition of mitotic cell cycle	 94	0.164659538542036	1	25	69	2188	7810	1.21285248675621
GO:0000118	histone deacetylase complex	 26	0.85360725893065	1	4	22	2209	7857	0.701588515415899
GO:0000123	histone acetyltransferase complex	 21	0.305021869322218	1	6	15	2207	7864	1.3029501000581
GO:0000124	SAGA complex	  9	0.892351169002328	1	1	8	2212	7871	0.50670281668926
GO:0000132	establishment of mitotic spindle orientation	 16	0.895524834056086	1	2	14	2211	7865	0.570040668775418
GO:0000137	Golgi cis cisterna	  6	1	1	0	6	2213	7873	0
GO:0000145	exocyst	 15	0.670849711670293	1	3	12	2210	7867	0.912065070040669
GO:0000146	microfilament motor activity	  8	0.551915645208052	1	2	6	2211	7873	1.14008133755084
GO:0000149	SNARE binding	 45	0.539421401961263	1	10	35	2203	7844	1.01340563337852
GO:0000151	ubiquitin ligase complex	 73	0.903283824456344	1	12	61	2201	7818	0.749642523321098
GO:0000154	rRNA modification	  6	0.391952090801775	1	2	4	2211	7875	1.52010845006778
GO:0000155	phosphorelay sensor kinase activity	  5	0.710033128778248	1	1	4	2212	7875	0.912065070040669
GO:0000159	protein phosphatase type 2A complex	 19	0.40693083008532	1	5	14	2208	7865	1.20008561847456
GO:0000160	phosphorelay signal transduction system	  6	0.773649336373543	1	1	5	2212	7874	0.760054225033891
GO:0000175	3	 19	0.40693083008532	1	5	14	2208	7865	1.20008561847456
GO:0000176	nuclear exosome (RNase complex)	 11	0.731548842740116	1	2	9	2211	7870	0.829150063673335
GO:0000177	cytoplasmic exosome (RNase complex)	  9	0.892351169002328	1	1	8	2212	7871	0.50670281668926
GO:0000178	exosome (RNase complex)	 14	0.846032978004182	1	2	12	2211	7867	0.651475050029049
GO:0000183	chromatin silencing at rDNA	  5	0.710033128778248	1	1	4	2212	7875	0.912065070040669
GO:0000184	nuclear-transcribed mRNA catabolic process, nonsense-mediated decay	 47	0.0733568102971884	1	15	32	2198	7847	1.45542298410745
GO:0000185	activation of MAPKKK activity	 12	0.258856173758332	1	4	8	2209	7871	1.52010845006778
GO:0000186	activation of MAPKK activity	 43	0.335793742411609	1	11	32	2202	7847	1.16659485702876
GO:0000187	activation of MAPK activity	 69	0.56254590653512	1	15	54	2198	7825	0.991375076131162
GO:0000188	inactivation of MAPK activity	 20	0.668528482767157	1	4	16	2209	7863	0.912065070040669
GO:0000226	microtubule cytoskeleton organization	 57	0.254777840460478	1	15	42	2198	7837	1.20008561847456
GO:0000228	nuclear chromosome	 20	0.668528482767157	1	4	16	2209	7863	0.912065070040669
GO:0000242	pericentriolar material	 17	0.0189160545906873	1	8	9	2205	7870	2.14603545891922
GO:0000244	spliceosomal tri-snRNP complex assembly	  9	0.313783026377615	1	3	6	2210	7873	1.52010845006778
GO:0000245	spliceosomal complex assembly	 17	0.31005409346522	1	5	12	2208	7867	1.34127216182451
GO:0000266	mitochondrial fission	 12	0.508975472817498	1	3	9	2210	7870	1.14008133755084
GO:0000278	mitotic cell cycle	 71	0.130078535150754	1	20	51	2193	7828	1.28459869019813
GO:0000281	mitotic cytokinesis	 23	0.224654598346874	1	7	16	2206	7863	1.38792510658363
GO:0000288	nuclear-transcribed mRNA catabolic process, deadenylation-dependent decay	 10	0.157129881410612	1	4	6	2209	7873	1.82413014008134
GO:0000289	nuclear-transcribed mRNA poly(A) tail shortening	 21	0.157705661170843	1	7	14	2206	7865	1.52010845006778
GO:0000290	deadenylation-dependent decapping of nuclear-transcribed mRNA	  7	0.475663602521461	1	2	5	2211	7874	1.3029501000581
GO:0000302	response to reactive oxygen species	  9	1	1	0	9	2213	7870	0
GO:0000307	cyclin-dependent protein kinase holoenzyme complex	 11	0.206185263049328	1	4	7	2209	7872	1.65830012734667
GO:0000338	protein deneddylation	  8	1	1	0	8	2213	7871	0
GO:0000339	RNA cap binding	  7	0.475663602521461	1	2	5	2211	7874	1.3029501000581
GO:0000340	RNA 7-methylguanosine cap binding	  7	0.82331362534889	1	1	6	2212	7873	0.651475050029049
GO:0000346	transcription export complex	  7	0.0455724578638761	1	4	3	2209	7876	2.6059002001162
GO:0000347	THO complex	  5	0.302606661467939	1	2	3	2211	7876	1.82413014008134
GO:0000375	RNA splicing, via transesterification reactions	 18	0.0276347658788338	1	8	10	2205	7869	2.02681126675704
GO:0000380	alternative mRNA splicing, via spliceosome	 13	0.00232909738610009	0.455920813329092	8	5	2205	7874	2.8063540616636
GO:0000381	regulation of alternative mRNA splicing, via spliceosome	 31	6.40402197476402e-05	0.100286984124804	17	14	2196	7865	2.50082357914377
GO:0000387	spliceosomal snRNP assembly	 14	0.846032978004182	1	2	12	2211	7867	0.651475050029049
GO:0000395	mRNA 5	  5	0.073752586889371	1	3	2	2210	7877	2.73619521012201
GO:0000400	four-way junction DNA binding	 10	0.380920088506331	1	3	7	2210	7872	1.368097605061
GO:0000407	pre-autophagosomal structure	 19	0.990977776999059	1	1	18	2212	7861	0.240017123694913
GO:0000408	EKC/KEOPS complex	  5	0.302606661467939	1	2	3	2211	7876	1.82413014008134
GO:0000413	protein peptidyl-prolyl isomerization	 25	0.668990259355853	1	5	20	2208	7859	0.912065070040669
GO:0000421	autophagosome membrane	 19	0.625808905960736	1	4	15	2209	7864	0.960068494779651
GO:0000422	autophagy of mitochondrion	 29	0.636078361210927	1	6	23	2207	7856	0.943515589697243
GO:0000423	mitophagy	  5	1	1	0	5	2213	7874	0
GO:0000439	core TFIIH complex	  5	0.073752586889371	1	3	2	2210	7877	2.73619521012201
GO:0000445	THO complex part of transcription export complex	  5	0.302606661467939	1	2	3	2211	7876	1.82413014008134
GO:0000460	maturation of 5.8S rRNA	 10	0.380920088506331	1	3	7	2210	7872	1.368097605061
GO:0000462	maturation of SSU-rRNA from tricistronic rRNA transcript (SSU-rRNA, 5.8S rRNA, LSU-rRNA)	 15	0.975670266056184	1	1	14	2212	7865	0.304021690013556
GO:0000470	maturation of LSU-rRNA	  7	0.182673311502561	1	3	4	2210	7875	1.95442515008715
GO:0000502	proteasome complex	 52	0.998465264978942	1	4	48	2209	7831	0.35079425770795
GO:0000506	glycosylphosphatidylinositol-N-acetylglucosaminyltransferase (GPI-GnT) complex	  5	0.710033128778248	1	1	4	2212	7875	0.912065070040669
GO:0000578	embryonic axis specification	  5	1	1	0	5	2213	7874	0
GO:0000712	resolution of meiotic recombination intermediates	  7	0.182673311502561	1	3	4	2210	7875	1.95442515008715
GO:0000715	nucleotide-excision repair, DNA damage recognition	 16	0.895524834056086	1	2	14	2211	7865	0.570040668775418
GO:0000717	nucleotide-excision repair, DNA duplex unwinding	 14	0.0651620805250405	1	6	8	2207	7871	1.95442515008715
GO:0000723	telomere maintenance	 28	0.96239913984799	1	3	25	2210	7854	0.488606287521787
GO:0000724	double-strand break repair via homologous recombination	 35	0.125569130976376	1	11	24	2202	7855	1.43324511006391
GO:0000729	DNA double-strand break processing	  8	0.246907474461687	1	3	5	2210	7874	1.71012200632625
GO:0000731	DNA synthesis involved in DNA repair	 12	0.508975472817498	1	3	9	2210	7870	1.14008133755084
GO:0000732	strand displacement	 10	0.380920088506331	1	3	7	2210	7872	1.368097605061
GO:0000774	adenyl-nucleotide exchange factor activity	  8	1	1	0	8	2213	7871	0
GO:0000775	chromosome, centromeric region	 80	0.38864993835678	1	19	61	2194	7818	1.08307727067329
GO:0000776	kinetochore	 71	0.384990654636734	1	17	54	2196	7825	1.09190888666841
GO:0000777	condensed chromosome kinetochore	 53	0.374423476621071	1	13	40	2200	7839	1.1185703689178
GO:0000780	condensed nuclear chromosome, centromeric region	  6	0.123915802800268	1	3	3	2210	7876	2.28016267510167
GO:0000781	chromosome, telomeric region	 33	0.287730492198488	1	9	24	2204	7855	1.24372509551
GO:0000783	nuclear telomere cap complex	  7	0.82331362534889	1	1	6	2212	7873	0.651475050029049
GO:0000784	nuclear chromosome, telomeric region	 69	0.675184237691283	1	14	55	2199	7824	0.925283404389084
GO:0000785	chromatin	 76	0.398845021060974	1	18	58	2195	7821	1.08007705662711
GO:0000786	nucleosome	 20	0.262931524136111	1	6	14	2207	7865	1.368097605061
GO:0000788	nuclear nucleosome	  5	0.302606661467939	1	2	3	2211	7876	1.82413014008134
GO:0000792	heterochromatin	 16	0.478664437350441	1	4	12	2209	7867	1.14008133755084
GO:0000793	condensed chromosome	 14	0.000779693138158613	0.281769104851474	9	5	2204	7874	2.93163772513072
GO:0000794	condensed nuclear chromosome	 20	0.454930598735057	1	5	15	2208	7864	1.14008133755084
GO:0000795	synaptonemal complex	 10	0.380920088506331	1	3	7	2210	7872	1.368097605061
GO:0000808	origin recognition complex	  5	1	1	0	5	2213	7874	0
GO:0000812	Swr1 complex	  7	1	1	0	7	2213	7872	0
GO:0000813	ESCRT I complex	  6	0.391952090801775	1	2	4	2211	7875	1.52010845006778
GO:0000815	ESCRT III complex	  7	0.475663602521461	1	2	5	2211	7874	1.3029501000581
GO:0000827	inositol-1,3,4,5,6-pentakisphosphate kinase activity	  5	0.710033128778248	1	1	4	2212	7875	0.912065070040669
GO:0000828	inositol hexakisphosphate kinase activity	  5	0.710033128778248	1	1	4	2212	7875	0.912065070040669
GO:0000829	inositol heptakisphosphate kinase activity	  5	0.710033128778248	1	1	4	2212	7875	0.912065070040669
GO:0000832	inositol hexakisphosphate 5-kinase activity	  5	0.710033128778248	1	1	4	2212	7875	0.912065070040669
GO:0000900	translation repressor activity, nucleic acid binding	 10	0.0471961044586633	1	5	5	2208	7874	2.28016267510167
GO:0000902	cell morphogenesis	 41	0.170055038059498	1	12	29	2201	7850	1.33472937079122
GO:0000904	cell morphogenesis involved in differentiation	  5	1	1	0	5	2213	7874	0
GO:0000910	cytokinesis	 31	0.84151041812627	1	5	26	2208	7853	0.735536346806991
GO:0000920	cell separation after cytokinesis	 10	0.157129881410612	1	4	6	2209	7873	1.82413014008134
GO:0000922	spindle pole	 79	0.683693757985345	1	16	63	2197	7816	0.923610197509538
GO:0000923	equatorial microtubule organizing center	  5	0.710033128778248	1	1	4	2212	7875	0.912065070040669
GO:0000930	gamma-tubulin complex	 11	0.206185263049328	1	4	7	2209	7872	1.65830012734667
GO:0000932	P-body	 74	0.176847014415621	1	20	54	2193	7825	1.23252036491982
GO:0000956	nuclear-transcribed mRNA catabolic process	 13	0.813973253692629	1	2	11	2211	7868	0.701588515415899
GO:0000974	Prp19 complex	  8	0.551915645208052	1	2	6	2211	7873	1.14008133755084
GO:0000975	regulatory region DNA binding	 10	0.915977754641309	1	1	9	2212	7870	0.456032535020334
GO:0000976	transcription regulatory region sequence-specific DNA binding	 29	0.907170755858537	1	4	25	2209	7854	0.629010393131496
GO:0000979	RNA polymerase II core promoter sequence-specific DNA binding	 40	0.527013831960622	1	9	31	2204	7848	1.02607320379575
GO:0000980	RNA polymerase II distal enhancer sequence-specific DNA binding	 44	0.651683703697105	1	9	35	2204	7844	0.932793821632502
GO:0000982	transcription factor activity, RNA polymerase II core promoter proximal region sequence-specific binding	 14	0.846032978004182	1	2	12	2211	7867	0.651475050029049
GO:0000983	transcription factor activity, RNA polymerase II core promoter sequence-specific	 10	0.380920088506331	1	3	7	2210	7872	1.368097605061
GO:0000987	core promoter proximal region sequence-specific DNA binding	  6	0.391952090801775	1	2	4	2211	7875	1.52010845006778
GO:0000989	transcription factor activity, transcription factor binding	 10	0.915977754641309	1	1	9	2212	7870	0.456032535020334
GO:0000993	RNA polymerase II core binding	 20	0.0525614737396124	1	8	12	2205	7867	1.82413014008134
GO:0001046	core promoter sequence-specific DNA binding	 32	0.255275651027849	1	9	23	2204	7856	1.28259150474469
GO:0001047	core promoter binding	 48	0.0859390162246962	1	15	33	2198	7846	1.42510167193854
GO:0001054	RNA polymerase I activity	  8	0.551915645208052	1	2	6	2211	7873	1.14008133755084
GO:0001055	RNA polymerase II activity	  6	0.773649336373543	1	1	5	2212	7874	0.760054225033891
GO:0001056	RNA polymerase III activity	 13	0.960053706376239	1	1	12	2212	7867	0.35079425770795
GO:0001075	transcription factor activity, RNA polymerase II core promoter sequence-specific binding involved in preinitiation complex assembly	  8	0.862084765369009	1	1	7	2212	7872	0.570040668775418
GO:0001076	transcription factor activity, RNA polymerase II transcription factor binding	  9	0.619953536302463	1	2	7	2211	7872	1.01340563337852
GO:0001078	transcriptional repressor activity, RNA polymerase II core promoter proximal region sequence-specific binding	 78	0.662566435123589	1	16	62	2197	7817	0.935451353887865
GO:0001085	RNA polymerase II transcription factor binding	 30	0.670839407999931	1	6	24	2207	7855	0.912065070040669
GO:0001094	TFIID-class transcription factor binding	  5	0.710033128778248	1	1	4	2212	7875	0.912065070040669
GO:0001102	RNA polymerase II activating transcription factor binding	 28	0.891630301489211	1	4	24	2209	7855	0.651475050029049
GO:0001103	RNA polymerase II repressing transcription factor binding	 20	0.847343512007977	1	3	17	2210	7862	0.684048802530502
GO:0001104	RNA polymerase II transcription cofactor activity	 24	0.630818426079107	1	5	19	2208	7860	0.950067781292363
GO:0001105	RNA polymerase II transcription coactivator activity	 23	0.391748984254665	1	6	17	2207	7862	1.18965009135739
GO:0001106	RNA polymerase II transcription corepressor activity	 18	0.579729311039596	1	4	14	2209	7865	1.01340563337852
GO:0001135	transcription factor activity, RNA polymerase II transcription factor recruiting	  6	0.123915802800268	1	3	3	2210	7876	2.28016267510167
GO:0001158	enhancer sequence-specific DNA binding	 11	0.206185263049328	1	4	7	2209	7872	1.65830012734667
GO:0001164	RNA polymerase I CORE element sequence-specific DNA binding	  6	0.773649336373543	1	1	5	2212	7874	0.760054225033891
GO:0001190	transcriptional activator activity, RNA polymerase II transcription factor binding	 13	0.960053706376239	1	1	12	2212	7867	0.35079425770795
GO:0001191	transcriptional repressor activity, RNA polymerase II transcription factor binding	  9	0.619953536302463	1	2	7	2211	7872	1.01340563337852
GO:0001205	transcriptional activator activity, RNA polymerase II distal enhancer sequence-specific binding	 17	0.754769220253611	1	3	14	2210	7865	0.804763297094708
GO:0001206	transcriptional repressor activity, RNA polymerase II distal enhancer sequence-specific binding	  7	0.475663602521461	1	2	5	2211	7874	1.3029501000581
GO:0001221	transcription cofactor binding	  5	0.710033128778248	1	1	4	2212	7875	0.912065070040669
GO:0001222	transcription corepressor binding	  6	0.123915802800268	1	3	3	2210	7876	2.28016267510167
GO:0001223	transcription coactivator binding	 11	0.206185263049328	1	4	7	2209	7872	1.65830012734667
GO:0001227	transcriptional repressor activity, RNA polymerase II transcription regulatory region sequence-specific binding	 49	0.777446514673125	1	9	40	2204	7839	0.837610778608777
GO:0001228	transcriptional activator activity, RNA polymerase II transcription regulatory region sequence-specific binding	 71	0.49722664499027	1	16	55	2197	7824	1.0276789521585
GO:0001501	skeletal system development	 83	0.837873062547193	1	15	68	2198	7811	0.824155183771689
GO:0001502	cartilage condensation	 10	1	1	0	10	2213	7869	0
GO:0001503	ossification	 61	0.88869139753884	1	10	51	2203	7828	0.747594319705466
GO:0001504	neurotransmitter uptake	  5	0.710033128778248	1	1	4	2212	7875	0.912065070040669
GO:0001505	regulation of neurotransmitter levels	  6	1	1	0	6	2213	7873	0
GO:0001508	action potential	 10	0.157129881410612	1	4	6	2209	7873	1.82413014008134
GO:0001510	RNA methylation	  7	0.475663602521461	1	2	5	2211	7874	1.3029501000581
GO:0001514	selenocysteine incorporation	  6	0.391952090801775	1	2	4	2211	7875	1.52010845006778
GO:0001516	prostaglandin biosynthetic process	  9	0.892351169002328	1	1	8	2212	7871	0.50670281668926
GO:0001518	voltage-gated sodium channel complex	  9	1	1	0	9	2213	7870	0
GO:0001522	pseudouridine synthesis	  8	0.551915645208052	1	2	6	2211	7873	1.14008133755084
GO:0001523	retinoid metabolic process	 27	0.954816764309549	1	3	24	2210	7855	0.50670281668926
GO:0001530	lipopolysaccharide binding	 14	0.621614907823308	1	3	11	2210	7868	0.977212575043574
GO:0001533	cornified envelope	 12	1	1	0	12	2213	7867	0
GO:0001540	amyloid-beta binding	 38	0.459218702472665	1	9	29	2204	7850	1.08007705662711
GO:0001541	ovarian follicle development	 26	0.945820770982062	1	3	23	2210	7856	0.526191386561924
GO:0001556	oocyte maturation	  9	0.313783026377615	1	3	6	2210	7873	1.52010845006778
GO:0001558	regulation of cell growth	 50	0.798142840176615	1	9	41	2204	7838	0.820858563036602
GO:0001568	blood vessel development	 40	0.985481747346329	1	4	36	2209	7843	0.456032535020334
GO:0001569	branching involved in blood vessel morphogenesis	 20	0.992959925266813	1	1	19	2212	7860	0.228016267510167
GO:0001570	vasculogenesis	 39	0.88553881551563	1	6	33	2207	7846	0.701588515415899
GO:0001578	microtubule bundle formation	 16	0.11719510586415	1	6	10	2207	7869	1.71012200632625
GO:0001580	detection of chemical stimulus involved in sensory perception of bitter taste	  8	0.551915645208052	1	2	6	2211	7873	1.14008133755084
GO:0001618	virus receptor activity	 47	0.60008386174838	1	10	37	2203	7842	0.970281989404967
GO:0001649	osteoblast differentiation	 67	0.628650413811143	1	14	53	2199	7826	0.952903804520102
GO:0001650	fibrillar center	 88	0.278973066045798	1	22	66	2191	7813	1.14008133755084
GO:0001654	eye development	 22	0.546958821448314	1	5	17	2208	7862	1.03643757959167
GO:0001655	urogenital system development	  8	0.862084765369009	1	1	7	2212	7872	0.570040668775418
GO:0001656	metanephros development	 20	0.668528482767157	1	4	16	2209	7863	0.912065070040669
GO:0001657	ureteric bud development	 29	0.907170755858537	1	4	25	2209	7854	0.629010393131496
GO:0001658	branching involved in ureteric bud morphogenesis	 28	0.599228819757412	1	6	22	2207	7857	0.977212575043574
GO:0001659	temperature homeostasis	 12	0.77606351672464	1	2	10	2211	7869	0.760054225033891
GO:0001662	behavioral fear response	 22	0.743498615792167	1	4	18	2209	7861	0.829150063673335
GO:0001664	G-protein coupled receptor binding	 37	0.932233756285535	1	5	32	2208	7847	0.616260182459911
GO:0001665	alpha-N-acetylgalactosaminide alpha-2,6-sialyltransferase activity	  5	1	1	0	5	2213	7874	0
GO:0001669	acrosomal vesicle	 30	0.670839407999931	1	6	24	2207	7855	0.912065070040669
GO:0001671	ATPase activator activity	 19	0.222505526992328	1	6	13	2207	7866	1.44010274216948
GO:0001673	male germ cell nucleus	  7	0.475663602521461	1	2	5	2211	7874	1.3029501000581
GO:0001675	acrosome assembly	  6	0.773649336373543	1	1	5	2212	7874	0.760054225033891
GO:0001676	long-chain fatty acid metabolic process	 13	0.960053706376239	1	1	12	2212	7867	0.35079425770795
GO:0001678	cellular glucose homeostasis	 10	0.679711898251496	1	2	8	2211	7871	0.912065070040669
GO:0001682	tRNA 5	  6	0.391952090801775	1	2	4	2211	7875	1.52010845006778
GO:0001702	gastrulation with mouth forming second	 10	0.679711898251496	1	2	8	2211	7871	0.912065070040669
GO:0001706	endoderm formation	  7	0.82331362534889	1	1	6	2212	7873	0.651475050029049
GO:0001707	mesoderm formation	 18	0.184360311948163	1	6	12	2207	7867	1.52010845006778
GO:0001708	cell fate specification	 11	0.934420645831428	1	1	10	2212	7869	0.414575031836668
GO:0001709	cell fate determination	 12	0.77606351672464	1	2	10	2211	7869	0.760054225033891
GO:0001711	endodermal cell fate commitment	  5	0.710033128778248	1	1	4	2212	7875	0.912065070040669
GO:0001725	stress fiber	 35	0.0637867213362776	1	12	23	2201	7856	1.56354012006972
GO:0001726	ruffle	 71	0.130078535150754	1	20	51	2193	7828	1.28459869019813
GO:0001731	formation of translation preinitiation complex	  9	0.619953536302463	1	2	7	2211	7872	1.01340563337852
GO:0001736	establishment of planar polarity	 11	0.446445648052706	1	3	8	2210	7871	1.24372509551
GO:0001750	photoreceptor outer segment	 31	0.703403274729522	1	6	25	2207	7854	0.882643616168389
GO:0001755	neural crest cell migration	 15	0.670849711670293	1	3	12	2210	7867	0.912065070040669
GO:0001756	somitogenesis	 32	0.572063532355993	1	7	25	2206	7854	0.997571170356981
GO:0001759	organ induction	  6	0.123915802800268	1	3	3	2210	7876	2.28016267510167
GO:0001763	morphogenesis of a branching structure	  6	0.773649336373543	1	1	5	2212	7874	0.760054225033891
GO:0001764	neuron migration	 76	0.212264351285047	1	20	56	2193	7823	1.20008561847456
GO:0001765	membrane raft assembly	  5	1	1	0	5	2213	7874	0
GO:0001766	membrane raft polarization	  5	0.710033128778248	1	1	4	2212	7875	0.912065070040669
GO:0001771	immunological synapse formation	  5	0.710033128778248	1	1	4	2212	7875	0.912065070040669
GO:0001772	immunological synapse	 20	0.454930598735057	1	5	15	2208	7864	1.14008133755084
GO:0001774	microglial cell activation	  7	0.475663602521461	1	2	5	2211	7874	1.3029501000581
GO:0001775	cell activation	  9	1	1	0	9	2213	7870	0
GO:0001779	natural killer cell differentiation	  7	1	1	0	7	2213	7872	0
GO:0001782	B cell homeostasis	 16	0.262709457690152	1	5	11	2208	7868	1.42510167193854
GO:0001784	phosphotyrosine residue binding	 24	0.804794893906303	1	4	20	2209	7859	0.760054225033891
GO:0001786	phosphatidylserine binding	 28	0.999033393569583	1	1	27	2212	7852	0.162868762507262
GO:0001816	cytokine production	 15	0.424675692435369	1	4	11	2209	7868	1.21608676005423
GO:0001817	regulation of cytokine production	 10	1	1	0	10	2213	7869	0
GO:0001818	negative regulation of cytokine production	 10	0.915977754641309	1	1	9	2212	7870	0.456032535020334
GO:0001819	positive regulation of cytokine production	 12	0.77606351672464	1	2	10	2211	7869	0.760054225033891
GO:0001822	kidney development	 76	0.809286822189112	1	14	62	2199	7817	0.840059932932195
GO:0001824	blastocyst development	 11	0.446445648052706	1	3	8	2210	7871	1.24372509551
GO:0001825	blastocyst formation	  6	0.391952090801775	1	2	4	2211	7875	1.52010845006778
GO:0001829	trophectodermal cell differentiation	  8	0.551915645208052	1	2	6	2211	7873	1.14008133755084
GO:0001833	inner cell mass cell proliferation	  5	1	1	0	5	2213	7874	0
GO:0001836	release of cytochrome c from mitochondria	 18	0.988437873742338	1	1	17	2212	7862	0.25335140834463
GO:0001837	epithelial to mesenchymal transition	 23	0.907908096067233	1	3	20	2210	7859	0.594825045678697
GO:0001841	neural tube formation	 10	0.915977754641309	1	1	9	2212	7870	0.456032535020334
GO:0001843	neural tube closure	 56	0.814568597339521	1	10	46	2203	7833	0.814343812536311
GO:0001844	protein insertion into mitochondrial membrane involved in apoptotic signaling pathway	  6	0.773649336373543	1	1	5	2212	7874	0.760054225033891
GO:0001867	complement activation, lectin pathway	  5	1	1	0	5	2213	7874	0
GO:0001878	response to yeast	  5	1	1	0	5	2213	7874	0
GO:0001881	receptor recycling	  8	0.862084765369009	1	1	7	2212	7872	0.570040668775418
GO:0001886	endothelial cell morphogenesis	 10	0.915977754641309	1	1	9	2212	7870	0.456032535020334
GO:0001889	liver development	 63	0.953812907157445	1	9	54	2204	7825	0.651475050029049
GO:0001890	placenta development	 21	0.870606746054365	1	3	18	2210	7861	0.651475050029049
GO:0001891	phagocytic cup	 12	0.508975472817498	1	3	9	2210	7870	1.14008133755084
GO:0001892	embryonic placenta development	 14	0.846032978004182	1	2	12	2211	7867	0.651475050029049
GO:0001893	maternal placenta development	  9	0.619953536302463	1	2	7	2211	7872	1.01340563337852
GO:0001894	tissue homeostasis	 13	0.313693837540153	1	4	9	2209	7870	1.4031770308318
GO:0001895	retina homeostasis	 19	0.820521257621854	1	3	16	2210	7863	0.720051371084738
GO:0001916	positive regulation of T cell mediated cytotoxicity	  5	0.073752586889371	1	3	2	2210	7877	2.73619521012201
GO:0001917	photoreceptor inner segment	 14	0.846032978004182	1	2	12	2211	7867	0.651475050029049
GO:0001919	regulation of receptor recycling	  5	1	1	0	5	2213	7874	0
GO:0001921	positive regulation of receptor recycling	 13	0.960053706376239	1	1	12	2212	7867	0.35079425770795
GO:0001931	uropod	  9	1	1	0	9	2213	7870	0
GO:0001932	regulation of protein phosphorylation	 36	0.389923262713907	1	9	27	2204	7852	1.14008133755084
GO:0001933	negative regulation of protein phosphorylation	 54	0.661488429188503	1	11	43	2202	7836	0.928955163930311
GO:0001935	endothelial cell proliferation	 10	0.915977754641309	1	1	9	2212	7870	0.456032535020334
GO:0001937	negative regulation of endothelial cell proliferation	 18	0.358397855587164	1	5	13	2208	7866	1.26675704172315
GO:0001938	positive regulation of endothelial cell proliferation	 40	0.805356150074361	1	7	33	2206	7846	0.798056936285585
GO:0001939	female pronucleus	  6	0.391952090801775	1	2	4	2211	7875	1.52010845006778
GO:0001940	male pronucleus	  5	0.710033128778248	1	1	4	2212	7875	0.912065070040669
GO:0001942	hair follicle development	 24	0.804794893906303	1	4	20	2209	7859	0.760054225033891
GO:0001944	vasculature development	 17	0.985183360207843	1	1	16	2212	7863	0.268254432364903
GO:0001945	lymph vessel development	  8	0.551915645208052	1	2	6	2211	7873	1.14008133755084
GO:0001946	lymphangiogenesis	  8	0.862084765369009	1	1	7	2212	7872	0.570040668775418
GO:0001947	heart looping	 31	0.224105618360784	1	9	22	2204	7857	1.32396542425258
GO:0001952	regulation of cell-matrix adhesion	  7	0.82331362534889	1	1	6	2212	7873	0.651475050029049
GO:0001953	negative regulation of cell-matrix adhesion	  8	0.551915645208052	1	2	6	2211	7873	1.14008133755084
GO:0001954	positive regulation of cell-matrix adhesion	 16	0.895524834056086	1	2	14	2211	7865	0.570040668775418
GO:0001955	blood vessel maturation	  7	1	1	0	7	2213	7872	0
GO:0001956	positive regulation of neurotransmitter secretion	  6	0.773649336373543	1	1	5	2212	7874	0.760054225033891
GO:0001958	endochondral ossification	 17	0.754769220253611	1	3	14	2210	7865	0.804763297094708
GO:0001959	regulation of cytokine-mediated signaling pathway	  5	0.710033128778248	1	1	4	2212	7875	0.912065070040669
GO:0001961	positive regulation of cytokine-mediated signaling pathway	  5	1	1	0	5	2213	7874	0
GO:0001963	synaptic transmission, dopaminergic	  7	1	1	0	7	2213	7872	0
GO:0001964	startle response	 10	0.915977754641309	1	1	9	2212	7870	0.456032535020334
GO:0001965	G-protein alpha-subunit binding	 14	0.846032978004182	1	2	12	2211	7867	0.651475050029049
GO:0001967	suckling behavior	 11	0.934420645831428	1	1	10	2212	7869	0.414575031836668
GO:0001968	fibronectin binding	 15	0.670849711670293	1	3	12	2210	7867	0.912065070040669
GO:0001972	retinoic acid binding	  5	0.710033128778248	1	1	4	2212	7875	0.912065070040669
GO:0001973	adenosine receptor signaling pathway	  7	1	1	0	7	2213	7872	0
GO:0001974	blood vessel remodeling	 24	0.979750646601004	1	2	22	2211	7857	0.380027112516945
GO:0001975	response to amphetamine	 19	0.40693083008532	1	5	14	2208	7865	1.20008561847456
GO:0002003	angiotensin maturation	  5	1	1	0	5	2213	7874	0
GO:0002009	morphogenesis of an epithelium	  9	0.892351169002328	1	1	8	2212	7871	0.50670281668926
GO:0002011	morphogenesis of an epithelial sheet	  5	0.302606661467939	1	2	3	2211	7876	1.82413014008134
GO:0002020	protease binding	 62	0.900127144036547	1	10	52	2203	7827	0.735536346806991
GO:0002021	response to dietary excess	  7	1	1	0	7	2213	7872	0
GO:0002024	diet induced thermogenesis	  5	0.302606661467939	1	2	3	2211	7876	1.82413014008134
GO:0002026	regulation of the force of heart contraction	 11	1	1	0	11	2213	7868	0
GO:0002027	regulation of heart rate	 14	1	1	0	14	2213	7865	0
GO:0002028	regulation of sodium ion transport	 15	0.424675692435369	1	4	11	2209	7868	1.21608676005423
GO:0002039	p53 binding	 44	0.0836736710444657	1	14	30	2199	7849	1.45101261142834
GO:0002040	sprouting angiogenesis	 16	0.715200159590258	1	3	13	2210	7866	0.855061003163127
GO:0002042	cell migration involved in sprouting angiogenesis	 13	0.567559963400701	1	3	10	2210	7869	1.05238277312385
GO:0002043	blood vessel endothelial cell proliferation involved in sprouting angiogenesis	  6	1	1	0	6	2213	7873	0
GO:0002052	positive regulation of neuroblast proliferation	 14	0.968824531635628	1	1	13	2212	7866	0.325737525014525
GO:0002053	positive regulation of mesenchymal cell proliferation	 20	0.454930598735057	1	5	15	2208	7864	1.14008133755084
GO:0002062	chondrocyte differentiation	 27	0.873852824362164	1	4	23	2209	7856	0.675603755585681
GO:0002063	chondrocyte development	 13	0.960053706376239	1	1	12	2212	7867	0.35079425770795
GO:0002076	osteoblast development	 10	0.380920088506331	1	3	7	2210	7872	1.368097605061
GO:0002080	acrosomal membrane	  8	0.551915645208052	1	2	6	2211	7873	1.14008133755084
GO:0002087	regulation of respiratory gaseous exchange by neurological system process	  9	0.892351169002328	1	1	8	2212	7871	0.50670281668926
GO:0002088	lens development in camera-type eye	 16	0.715200159590258	1	3	13	2210	7866	0.855061003163127
GO:0002089	lens morphogenesis in camera-type eye	 11	0.731548842740116	1	2	9	2211	7870	0.829150063673335
GO:0002091	negative regulation of receptor internalization	  6	0.391952090801775	1	2	4	2211	7875	1.52010845006778
GO:0002092	positive regulation of receptor internalization	 11	0.206185263049328	1	4	7	2209	7872	1.65830012734667
GO:0002098	tRNA wobble uridine modification	  5	0.710033128778248	1	1	4	2212	7875	0.912065070040669
GO:0002102	podosome	 18	0.789777202096414	1	3	15	2210	7864	0.760054225033891
GO:0002116	semaphorin receptor complex	  5	1	1	0	5	2213	7874	0
GO:0002151	G-quadruplex RNA binding	  5	0.710033128778248	1	1	4	2212	7875	0.912065070040669
GO:0002161	aminoacyl-tRNA editing activity	  8	0.551915645208052	1	2	6	2211	7873	1.14008133755084
GO:0002162	dystroglycan binding	  6	1	1	0	6	2213	7873	0
GO:0002181	cytoplasmic translation	  8	0.551915645208052	1	2	6	2211	7873	1.14008133755084
GO:0002199	zona pellucida receptor complex	  7	1	1	0	7	2213	7872	0
GO:0002218	activation of innate immune response	  8	0.246907474461687	1	3	5	2210	7874	1.71012200632625
GO:0002223	stimulatory C-type lectin receptor signaling pathway	 76	0.962388309472145	1	11	65	2202	7814	0.66004709016101
GO:0002224	toll-like receptor signaling pathway	 25	0.668990259355853	1	5	20	2208	7859	0.912065070040669
GO:0002227	innate immune response in mucosa	  5	1	1	0	5	2213	7874	0
GO:0002230	positive regulation of defense response to virus by host	  7	1	1	0	7	2213	7872	0
GO:0002237	response to molecule of bacterial origin	  7	0.475663602521461	1	2	5	2211	7874	1.3029501000581
GO:0002244	hematopoietic progenitor cell differentiation	 44	0.877888950950871	1	7	37	2206	7842	0.725506305714168
GO:0002250	adaptive immune response	 64	0.85924524219979	1	11	53	2202	7826	0.7838059195662
GO:0002262	myeloid cell homeostasis	  8	0.862084765369009	1	1	7	2212	7872	0.570040668775418
GO:0002281	macrophage activation involved in immune response	  6	0.773649336373543	1	1	5	2212	7874	0.760054225033891
GO:0002315	marginal zone B cell differentiation	  8	0.551915645208052	1	2	6	2211	7873	1.14008133755084
GO:0002377	immunoglobulin production	  7	0.82331362534889	1	1	6	2212	7873	0.651475050029049
GO:0002407	dendritic cell chemotaxis	  8	0.551915645208052	1	2	6	2211	7873	1.14008133755084
GO:0002437	inflammatory response to antigenic stimulus	  8	0.551915645208052	1	2	6	2211	7873	1.14008133755084
GO:0002446	neutrophil mediated immunity	  5	0.710033128778248	1	1	4	2212	7875	0.912065070040669
GO:0002456	T cell mediated immunity	  7	0.475663602521461	1	2	5	2211	7874	1.3029501000581
GO:0002467	germinal center formation	  6	0.773649336373543	1	1	5	2212	7874	0.760054225033891
GO:0002474	antigen processing and presentation of peptide antigen via MHC class I	 19	0.40693083008532	1	5	14	2208	7865	1.20008561847456
GO:0002479	antigen processing and presentation of exogenous peptide antigen via MHC class I, TAP-dependent	 55	0.880518411021416	1	9	46	2204	7833	0.746235057306002
GO:0002480	antigen processing and presentation of exogenous peptide antigen via MHC class I, TAP-independent	  5	0.710033128778248	1	1	4	2212	7875	0.912065070040669
GO:0002504	antigen processing and presentation of peptide or polysaccharide antigen via MHC class II	  7	1	1	0	7	2213	7872	0
GO:0002523	leukocyte migration involved in inflammatory response	  9	0.892351169002328	1	1	8	2212	7871	0.50670281668926
GO:0002526	acute inflammatory response	  9	0.619953536302463	1	2	7	2211	7872	1.01340563337852
GO:0002548	monocyte chemotaxis	 14	0.968824531635628	1	1	13	2212	7866	0.325737525014525
GO:0002576	platelet degranulation	 77	0.936658164752447	1	12	65	2201	7814	0.710700054577144
GO:0002675	positive regulation of acute inflammatory response	  7	0.82331362534889	1	1	6	2212	7873	0.651475050029049
GO:0002690	positive regulation of leukocyte chemotaxis	  6	0.773649336373543	1	1	5	2212	7874	0.760054225033891
GO:0002726	positive regulation of T cell cytokine production	  6	0.123915802800268	1	3	3	2210	7876	2.28016267510167
GO:0002755	MyD88-dependent toll-like receptor signaling pathway	 14	0.621614907823308	1	3	11	2210	7868	0.977212575043574
GO:0002756	MyD88-independent toll-like receptor signaling pathway	  5	0.710033128778248	1	1	4	2212	7875	0.912065070040669
GO:0002819	regulation of adaptive immune response	  5	0.710033128778248	1	1	4	2212	7875	0.912065070040669
GO:0002903	negative regulation of B cell apoptotic process	  5	0.073752586889371	1	3	2	2210	7877	2.73619521012201
GO:0002931	response to ischemia	 30	0.999411771295737	1	1	29	2212	7850	0.152010845006778
GO:0003007	heart morphogenesis	 31	0.978578943808408	1	3	28	2210	7851	0.441321808084195
GO:0003009	skeletal muscle contraction	 10	0.679711898251496	1	2	8	2211	7871	0.912065070040669
GO:0003014	renal system process	  8	0.862084765369009	1	1	7	2212	7872	0.570040668775418
GO:0003016	respiratory system process	  8	0.862084765369009	1	1	7	2212	7872	0.570040668775418
GO:0003073	regulation of systemic arterial blood pressure	  8	0.862084765369009	1	1	7	2212	7872	0.570040668775418
GO:0003084	positive regulation of systemic arterial blood pressure	  5	0.302606661467939	1	2	3	2211	7876	1.82413014008134
GO:0003091	renal water homeostasis	 24	0.630818426079107	1	5	19	2208	7860	0.950067781292363
GO:0003094	glomerular filtration	  7	0.475663602521461	1	2	5	2211	7874	1.3029501000581
GO:0003139	secondary heart field specification	  6	1	1	0	6	2213	7873	0
GO:0003148	outflow tract septum morphogenesis	 12	0.77606351672464	1	2	10	2211	7869	0.760054225033891
GO:0003149	membranous septum morphogenesis	  8	0.862084765369009	1	1	7	2212	7872	0.570040668775418
GO:0003150	muscular septum morphogenesis	  5	1	1	0	5	2213	7874	0
GO:0003151	outflow tract morphogenesis	 36	0.998522002436445	1	2	34	2211	7845	0.25335140834463
GO:0003158	endothelium development	  5	1	1	0	5	2213	7874	0
GO:0003181	atrioventricular valve morphogenesis	  7	1	1	0	7	2213	7872	0
GO:0003183	mitral valve morphogenesis	  7	0.82331362534889	1	1	6	2212	7873	0.651475050029049
GO:0003184	pulmonary valve morphogenesis	  9	1	1	0	9	2213	7870	0
GO:0003197	endocardial cushion development	 10	0.915977754641309	1	1	9	2212	7870	0.456032535020334
GO:0003198	epithelial to mesenchymal transition involved in endocardial cushion formation	  8	0.862084765369009	1	1	7	2212	7872	0.570040668775418
GO:0003203	endocardial cushion morphogenesis	  9	1	1	0	9	2213	7870	0
GO:0003208	cardiac ventricle morphogenesis	  7	1	1	0	7	2213	7872	0
GO:0003209	cardiac atrium morphogenesis	  6	0.773649336373543	1	1	5	2212	7874	0.760054225033891
GO:0003214	cardiac left ventricle morphogenesis	 10	1	1	0	10	2213	7869	0
GO:0003215	cardiac right ventricle morphogenesis	  8	0.862084765369009	1	1	7	2212	7872	0.570040668775418
GO:0003222	ventricular trabecula myocardium morphogenesis	 15	1	1	0	15	2213	7864	0
GO:0003254	regulation of membrane depolarization	  5	0.710033128778248	1	1	4	2212	7875	0.912065070040669
GO:0003279	cardiac septum development	  7	0.475663602521461	1	2	5	2211	7874	1.3029501000581
GO:0003281	ventricular septum development	 18	0.579729311039596	1	4	14	2209	7865	1.01340563337852
GO:0003300	cardiac muscle hypertrophy	  5	0.710033128778248	1	1	4	2212	7875	0.912065070040669
GO:0003309	type B pancreatic cell differentiation	  5	1	1	0	5	2213	7874	0
GO:0003323	type B pancreatic cell development	  9	0.313783026377615	1	3	6	2210	7873	1.52010845006778
GO:0003333	amino acid transmembrane transport	 27	0.737195257699444	1	5	22	2208	7857	0.844504694482101
GO:0003334	keratinocyte development	  7	0.82331362534889	1	1	6	2212	7873	0.651475050029049
GO:0003341	cilium movement	 12	0.0298982942190106	1	6	6	2207	7873	2.28016267510167
GO:0003351	epithelial cilium movement	  6	0.391952090801775	1	2	4	2211	7875	1.52010845006778
GO:0003360	brainstem development	  5	0.302606661467939	1	2	3	2211	7876	1.82413014008134
GO:0003374	dynamin family protein polymerization involved in mitochondrial fission	  6	0.773649336373543	1	1	5	2212	7874	0.760054225033891
GO:0003376	sphingosine-1-phosphate signaling pathway	 10	1	1	0	10	2213	7869	0
GO:0003382	epithelial cell morphogenesis	  8	0.551915645208052	1	2	6	2211	7873	1.14008133755084
GO:0003406	retinal pigment epithelium development	  5	1	1	0	5	2213	7874	0
GO:0003407	neural retina development	 12	0.508975472817498	1	3	9	2210	7870	1.14008133755084
GO:0003678	DNA helicase activity	 13	0.813973253692629	1	2	11	2211	7868	0.701588515415899
GO:0003680	AT DNA binding	  6	0.391952090801775	1	2	4	2211	7875	1.52010845006778
GO:0003684	damaged DNA binding	 45	0.270647633559906	1	12	33	2201	7846	1.21608676005423
GO:0003688	DNA replication origin binding	 10	0.915977754641309	1	1	9	2212	7870	0.456032535020334
GO:0003689	DNA clamp loader activity	  8	0.246907474461687	1	3	5	2210	7874	1.71012200632625
GO:0003690	double-stranded DNA binding	 73	0.0365361903653636	1	23	50	2190	7829	1.43681483636544
GO:0003691	double-stranded telomeric DNA binding	  8	0.862084765369009	1	1	7	2212	7872	0.570040668775418
GO:0003697	single-stranded DNA binding	 56	0.337215966145826	1	14	42	2199	7837	1.14008133755084
GO:0003705	transcription factor activity, RNA polymerase II distal enhancer sequence-specific binding	 40	0.805356150074361	1	7	33	2206	7846	0.798056936285585
GO:0003707	steroid hormone receptor activity	 30	0.497034174054913	1	7	23	2206	7856	1.06407591504745
GO:0003712	transcription cofactor activity	 47	0.130832143876913	1	14	33	2199	7846	1.35839478516695
GO:0003720	telomerase activity	  5	1	1	0	5	2213	7874	0
GO:0003724	RNA helicase activity	  9	0.619953536302463	1	2	7	2211	7872	1.01340563337852
GO:0003725	double-stranded RNA binding	 48	0.0859390162246962	1	15	33	2198	7846	1.42510167193854
GO:0003727	single-stranded RNA binding	 32	0.0328531538160317	1	12	20	2201	7859	1.71012200632625
GO:0003729	mRNA binding	 89	0.000147340224135129	0.138440874597367	35	54	2178	7825	1.79338637367547
GO:0003730	mRNA 3	 40	0.247738556627972	1	11	29	2202	7850	1.25408947130592
GO:0003735	structural constituent of ribosome	 63	0.755608123111353	1	12	51	2201	7828	0.868633400038732
GO:0003743	translation initiation factor activity	 41	0.170055038059498	1	12	29	2201	7850	1.33472937079122
GO:0003746	translation elongation factor activity	 16	0.895524834056086	1	2	14	2211	7865	0.570040668775418
GO:0003747	translation release factor activity	  5	0.073752586889371	1	3	2	2210	7877	2.73619521012201
GO:0003755	peptidyl-prolyl cis-trans isomerase activity	 25	0.668990259355853	1	5	20	2208	7859	0.912065070040669
GO:0003756	protein disulfide isomerase activity	 12	0.100843441631321	1	5	7	2208	7872	1.90013556258473
GO:0003774	motor activity	 58	0.0680076610240902	1	18	40	2195	7839	1.41527338454587
GO:0003777	microtubule motor activity	 42	0.11190640091395	1	13	29	2200	7850	1.41152927506294
GO:0003785	actin monomer binding	 14	1	1	0	14	2213	7865	0
GO:0003823	antigen binding	 13	1	1	0	13	2213	7866	0
GO:0003831	beta-N-acetylglucosaminylglycopeptide beta-1,4-galactosyltransferase activity	  6	1	1	0	6	2213	7873	0
GO:0003841	1-acylglycerol-3-phosphate O-acyltransferase activity	 15	0.424675692435369	1	4	11	2209	7868	1.21608676005423
GO:0003887	DNA-directed DNA polymerase activity	 14	0.369358500517811	1	4	10	2209	7869	1.3029501000581
GO:0003899	DNA-directed 5	 23	0.775798815935103	1	4	19	2209	7860	0.793100060904929
GO:0003906	DNA-(apurinic or apyrimidinic site) lyase activity	  8	0.862084765369009	1	1	7	2212	7872	0.570040668775418
GO:0003950	NAD+ ADP-ribosyltransferase activity	 15	0.975670266056184	1	1	14	2212	7865	0.304021690013556
GO:0003951	NAD+ kinase activity	 12	0.77606351672464	1	2	10	2211	7869	0.760054225033891
GO:0003954	NADH dehydrogenase activity	  9	1	1	0	9	2213	7870	0
GO:0003993	acid phosphatase activity	  7	0.182673311502561	1	3	4	2210	7875	1.95442515008715
GO:0003995	acyl-CoA dehydrogenase activity	 11	0.731548842740116	1	2	9	2211	7870	0.829150063673335
GO:0004000	adenosine deaminase activity	  6	0.773649336373543	1	1	5	2212	7874	0.760054225033891
GO:0004003	ATP-dependent DNA helicase activity	 18	0.184360311948163	1	6	12	2207	7867	1.52010845006778
GO:0004004	ATP-dependent RNA helicase activity	 38	0.615163392648386	1	8	30	2205	7849	0.960068494779651
GO:0004012	phospholipid-translocating ATPase activity	 12	0.0298982942190106	1	6	6	2207	7873	2.28016267510167
GO:0004016	adenylate cyclase activity	 10	0.915977754641309	1	1	9	2212	7870	0.456032535020334
GO:0004017	adenylate kinase activity	  5	0.073752586889371	1	3	2	2210	7877	2.73619521012201
GO:0004029	aldehyde dehydrogenase (NAD) activity	  8	0.862084765369009	1	1	7	2212	7872	0.570040668775418
GO:0004033	aldo-keto reductase (NADP) activity	  8	1	1	0	8	2213	7871	0
GO:0004064	arylesterase activity	  5	1	1	0	5	2213	7874	0
GO:0004089	carbonate dehydratase activity	  7	0.82331362534889	1	1	6	2212	7873	0.651475050029049
GO:0004114	3	 16	0.000540700644133235	0.243487974149252	10	6	2203	7873	2.85020334387709
GO:0004115	3	 13	0.00232909738610009	0.455920813329092	8	5	2205	7874	2.8063540616636
GO:0004128	cytochrome-b5 reductase activity, acting on NAD(P)H	  6	0.773649336373543	1	1	5	2212	7874	0.760054225033891
GO:0004129	cytochrome-c oxidase activity	 13	0.813973253692629	1	2	11	2211	7868	0.701588515415899
GO:0004143	diacylglycerol kinase activity	  8	0.862084765369009	1	1	7	2212	7872	0.570040668775418
GO:0004175	endopeptidase activity	 57	0.61526170024093	1	12	45	2201	7834	0.960068494779651
GO:0004177	aminopeptidase activity	 23	0.775798815935103	1	4	19	2209	7860	0.793100060904929
GO:0004180	carboxypeptidase activity	 16	0.715200159590258	1	3	13	2210	7866	0.855061003163127
GO:0004181	metallocarboxypeptidase activity	 10	0.679711898251496	1	2	8	2211	7871	0.912065070040669
GO:0004185	serine-type carboxypeptidase activity	  6	0.773649336373543	1	1	5	2212	7874	0.760054225033891
GO:0004190	aspartic-type endopeptidase activity	 15	0.424675692435369	1	4	11	2209	7868	1.21608676005423
GO:0004197	cysteine-type endopeptidase activity	 43	0.0707630689965458	1	14	29	2199	7850	1.48475709076388
GO:0004198	calcium-dependent cysteine-type endopeptidase activity	 10	0.679711898251496	1	2	8	2211	7871	0.912065070040669
GO:0004222	metalloendopeptidase activity	 54	0.5325705058307	1	12	42	2201	7837	1.01340563337852
GO:0004252	serine-type endopeptidase activity	 83	0.993103547792047	1	10	73	2203	7806	0.549436789181126
GO:0004298	threonine-type endopeptidase activity	 14	0.846032978004182	1	2	12	2211	7867	0.651475050029049
GO:0004300	enoyl-CoA hydratase activity	  6	0.123915802800268	1	3	3	2210	7876	2.28016267510167
GO:0004303	estradiol 17-beta-dehydrogenase activity	  5	0.710033128778248	1	1	4	2212	7875	0.912065070040669
GO:0004308	exo-alpha-sialidase activity	  5	1	1	0	5	2213	7874	0
GO:0004364	glutathione transferase activity	 12	0.77606351672464	1	2	10	2211	7869	0.760054225033891
GO:0004383	guanylate cyclase activity	 13	0.813973253692629	1	2	11	2211	7868	0.701588515415899
GO:0004385	guanylate kinase activity	 10	1	1	0	10	2213	7869	0
GO:0004386	helicase activity	 87	0.185128765246263	1	23	64	2190	7815	1.20560325350203
GO:0004402	histone acetyltransferase activity	 30	0.497034174054913	1	7	23	2206	7856	1.06407591504745
GO:0004407	histone deacetylase activity	 29	0.907170755858537	1	4	25	2209	7854	0.629010393131496
GO:0004435	phosphatidylinositol phospholipase C activity	 17	0.985183360207843	1	1	16	2212	7863	0.268254432364903
GO:0004438	phosphatidylinositol-3-phosphatase activity	 13	0.960053706376239	1	1	12	2212	7867	0.35079425770795
GO:0004439	phosphatidylinositol-4,5-bisphosphate 5-phosphatase activity	  5	0.710033128778248	1	1	4	2212	7875	0.912065070040669
GO:0004467	long-chain fatty acid-CoA ligase activity	  9	0.892351169002328	1	1	8	2212	7871	0.50670281668926
GO:0004497	monooxygenase activity	 33	0.951297228934078	1	4	29	2209	7850	0.552766709115557
GO:0004518	nuclease activity	 73	0.54695498791054	1	16	57	2197	7822	0.99952336442813
GO:0004519	endonuclease activity	 46	0.821110934689909	1	8	38	2205	7841	0.793100060904929
GO:0004520	endodeoxyribonuclease activity	  9	0.892351169002328	1	1	8	2212	7871	0.50670281668926
GO:0004521	endoribonuclease activity	 11	0.731548842740116	1	2	9	2211	7870	0.829150063673335
GO:0004523	RNA-DNA hybrid ribonuclease activity	  5	0.710033128778248	1	1	4	2212	7875	0.912065070040669
GO:0004526	ribonuclease P activity	  5	0.710033128778248	1	1	4	2212	7875	0.912065070040669
GO:0004527	exonuclease activity	 34	0.106151802232345	1	11	23	2202	7856	1.47539937800696
GO:0004535	poly(A)-specific ribonuclease activity	  8	0.0756163732373509	1	4	4	2209	7875	2.28016267510167
GO:0004540	ribonuclease activity	 14	0.621614907823308	1	3	11	2210	7868	0.977212575043574
GO:0004550	nucleoside diphosphate kinase activity	 10	0.915977754641309	1	1	9	2212	7870	0.456032535020334
GO:0004553	hydrolase activity, hydrolyzing O-glycosyl compounds	 16	0.98101329485619	1	1	15	2212	7864	0.285020334387709
GO:0004559	alpha-mannosidase activity	  5	0.073752586889371	1	3	2	2210	7877	2.73619521012201
GO:0004571	mannosyl-oligosaccharide 1,2-alpha-mannosidase activity	  7	0.182673311502561	1	3	4	2210	7875	1.95442515008715
GO:0004579	dolichyl-diphosphooligosaccharide-protein glycotransferase activity	  8	0.862084765369009	1	1	7	2212	7872	0.570040668775418
GO:0004596	peptide alpha-N-acetyltransferase activity	  7	0.182673311502561	1	3	4	2210	7875	1.95442515008715
GO:0004601	peroxidase activity	 16	0.895524834056086	1	2	14	2211	7865	0.570040668775418
GO:0004602	glutathione peroxidase activity	  6	0.773649336373543	1	1	5	2212	7874	0.760054225033891
GO:0004620	phospholipase activity	  9	0.892351169002328	1	1	8	2212	7871	0.50670281668926
GO:0004622	lysophospholipase activity	 13	0.313693837540153	1	4	9	2209	7870	1.4031770308318
GO:0004623	phospholipase A2 activity	 14	0.174532180096009	1	5	9	2208	7870	1.62868762507262
GO:0004629	phospholipase C activity	 11	0.934420645831428	1	1	10	2212	7869	0.414575031836668
GO:0004630	phospholipase D activity	  6	0.773649336373543	1	1	5	2212	7874	0.760054225033891
GO:0004652	polynucleotide adenylyltransferase activity	  7	0.475663602521461	1	2	5	2211	7874	1.3029501000581
GO:0004653	polypeptide N-acetylgalactosaminyltransferase activity	 12	0.100843441631321	1	5	7	2208	7872	1.90013556258473
GO:0004659	prenyltransferase activity	  7	0.182673311502561	1	3	4	2210	7875	1.95442515008715
GO:0004675	transmembrane receptor protein serine/threonine kinase activity	 11	1	1	0	11	2213	7868	0
GO:0004679	AMP-activated protein kinase activity	  6	0.123915802800268	1	3	3	2210	7876	2.28016267510167
GO:0004683	calmodulin-dependent protein kinase activity	 18	0.789777202096414	1	3	15	2210	7864	0.760054225033891
GO:0004693	cyclin-dependent protein serine/threonine kinase activity	 17	0.31005409346522	1	5	12	2208	7867	1.34127216182451
GO:0004697	protein kinase C activity	 12	0.508975472817498	1	3	9	2210	7870	1.14008133755084
GO:0004702	signal transducer, downstream of receptor, with serine/threonine kinase activity	 14	0.968824531635628	1	1	13	2212	7866	0.325737525014525
GO:0004707	MAP kinase activity	 11	0.934420645831428	1	1	10	2212	7869	0.414575031836668
GO:0004708	MAP kinase kinase activity	 13	1	1	0	13	2213	7866	0
GO:0004709	MAP kinase kinase kinase activity	 21	0.707764107729648	1	4	17	2209	7862	0.868633400038732
GO:0004712	protein serine/threonine/tyrosine kinase activity	 18	0.184360311948163	1	6	12	2207	7867	1.52010845006778
GO:0004713	protein tyrosine kinase activity	 92	0.65690050248459	1	19	73	2194	7806	0.941806322324604
GO:0004714	transmembrane receptor protein tyrosine kinase activity	 36	0.921411162229533	1	5	31	2208	7848	0.633378520861576
GO:0004715	non-membrane spanning protein tyrosine kinase activity	 28	0.767187961599886	1	5	23	2208	7856	0.814343812536311
GO:0004716	signal transducer, downstream of receptor, with protein tyrosine kinase activity	  8	1	1	0	8	2213	7871	0
GO:0004722	protein serine/threonine phosphatase activity	 42	0.731382703584426	1	8	34	2205	7845	0.868633400038732
GO:0004725	protein tyrosine phosphatase activity	 77	0.740311049701353	1	15	62	2198	7817	0.888375068221431
GO:0004726	non-membrane spanning protein tyrosine phosphatase activity	  8	0.0756163732373509	1	4	4	2209	7875	2.28016267510167
GO:0004745	retinol dehydrogenase activity	  7	1	1	0	7	2213	7872	0
GO:0004784	superoxide dismutase activity	  5	0.710033128778248	1	1	4	2212	7875	0.912065070040669
GO:0004791	thioredoxin-disulfide reductase activity	  6	0.391952090801775	1	2	4	2211	7875	1.52010845006778
GO:0004806	triglyceride lipase activity	  5	0.710033128778248	1	1	4	2212	7875	0.912065070040669
GO:0004812	aminoacyl-tRNA ligase activity	 30	0.670839407999931	1	6	24	2207	7855	0.912065070040669
GO:0004843	thiol-dependent ubiquitin-specific protease activity	 59	0.131620532389142	1	17	42	2196	7837	1.31399205005859
GO:0004857	enzyme inhibitor activity	 26	0.51999232664405	1	6	20	2207	7859	1.05238277312385
GO:0004859	phospholipase inhibitor activity	  8	1	1	0	8	2213	7871	0
GO:0004860	protein kinase inhibitor activity	 39	0.949963075080934	1	5	34	2208	7845	0.584657096179916
GO:0004861	cyclin-dependent protein serine/threonine kinase inhibitor activity	  9	0.892351169002328	1	1	8	2212	7871	0.50670281668926
GO:0004862	cAMP-dependent protein kinase inhibitor activity	  9	0.313783026377615	1	3	6	2210	7873	1.52010845006778
GO:0004864	protein phosphatase inhibitor activity	 23	0.590072665113217	1	5	18	2208	7861	0.991375076131162
GO:0004865	protein serine/threonine phosphatase inhibitor activity	  5	1	1	0	5	2213	7874	0
GO:0004866	endopeptidase inhibitor activity	 19	0.942719615121364	1	2	17	2211	7862	0.480034247389826
GO:0004867	serine-type endopeptidase inhibitor activity	 34	0.999782232411293	1	1	33	2212	7846	0.134127216182451
GO:0004869	cysteine-type endopeptidase inhibitor activity	 16	0.98101329485619	1	1	15	2212	7864	0.285020334387709
GO:0004879	RNA polymerase II transcription factor activity, ligand-activated sequence-specific DNA binding	 18	0.358397855587164	1	5	13	2208	7866	1.26675704172315
GO:0004888	transmembrane signaling receptor activity	 87	0.651719781925534	1	18	69	2195	7810	0.943515589697244
GO:0004890	GABA-A receptor activity	 11	0.731548842740116	1	2	9	2211	7870	0.829150063673335
GO:0004896	cytokine receptor activity	 27	0.954816764309549	1	3	24	2210	7855	0.50670281668926
GO:0004950	chemokine receptor activity	  5	1	1	0	5	2213	7874	0
GO:0004970	ionotropic glutamate receptor activity	 12	0.9488167484775	1	1	11	2212	7868	0.380027112516945
GO:0004972	NMDA glutamate receptor activity	  6	1	1	0	6	2213	7873	0
GO:0004993	G-protein coupled serotonin receptor activity	  6	1	1	0	6	2213	7873	0
GO:0005001	transmembrane receptor protein tyrosine phosphatase activity	 11	0.731548842740116	1	2	9	2211	7870	0.829150063673335
GO:0005003	ephrin receptor activity	 10	1	1	0	10	2213	7869	0
GO:0005004	GPI-linked ephrin receptor activity	  6	0.773649336373543	1	1	5	2212	7874	0.760054225033891
GO:0005024	transforming growth factor beta-activated receptor activity	  5	1	1	0	5	2213	7874	0
GO:0005031	tumor necrosis factor-activated receptor activity	 14	1	1	0	14	2213	7865	0
GO:0005041	low-density lipoprotein receptor activity	 11	0.446445648052706	1	3	8	2210	7871	1.24372509551
GO:0005044	scavenger receptor activity	 26	0.85360725893065	1	4	22	2209	7857	0.701588515415899
GO:0005049	nuclear export signal receptor activity	  5	0.073752586889371	1	3	2	2210	7877	2.73619521012201
GO:0005057	signal transducer activity, downstream of receptor	 29	0.907170755858537	1	4	25	2209	7854	0.629010393131496
GO:0005068	transmembrane receptor protein tyrosine kinase adaptor activity	  7	0.0455724578638761	1	4	3	2209	7876	2.6059002001162
GO:0005070	SH3/SH2 adaptor activity	 35	0.355345167744352	1	9	26	2204	7853	1.17265509005229
GO:0005078	MAP-kinase scaffold activity	  6	0.391952090801775	1	2	4	2211	7875	1.52010845006778
GO:0005080	protein kinase C binding	 31	0.224105618360784	1	9	22	2204	7857	1.32396542425258
GO:0005086	ARF guanyl-nucleotide exchange factor activity	 16	0.262709457690152	1	5	11	2208	7868	1.42510167193854
GO:0005088	Ras guanyl-nucleotide exchange factor activity	 68	0.145993635531492	1	19	49	2194	7830	1.27420855373329
GO:0005089	Rho guanyl-nucleotide exchange factor activity	 49	0.265212747947292	1	13	36	2200	7843	1.20988223576823
GO:0005092	GDP-dissociation inhibitor activity	 11	0.731548842740116	1	2	9	2211	7870	0.829150063673335
GO:0005095	GTPase inhibitor activity	 11	0.731548842740116	1	2	9	2211	7870	0.829150063673335
GO:0005104	fibroblast growth factor receptor binding	  7	0.182673311502561	1	3	4	2210	7875	1.95442515008715
GO:0005109	frizzled binding	 18	0.789777202096414	1	3	15	2210	7864	0.760054225033891
GO:0005112	Notch binding	 17	0.149082331829991	1	6	11	2207	7868	1.60952659418942
GO:0005113	patched binding	  5	1	1	0	5	2213	7874	0
GO:0005114	type II transforming growth factor beta receptor binding	  6	1	1	0	6	2213	7873	0
GO:0005123	death receptor binding	 12	0.508975472817498	1	3	9	2210	7870	1.14008133755084
GO:0005125	cytokine activity	 70	0.992465560674931	1	8	62	2205	7817	0.521180040023239
GO:0005138	interleukin-6 receptor binding	  5	0.302606661467939	1	2	3	2211	7876	1.82413014008134
GO:0005154	epidermal growth factor receptor binding	 21	0.157705661170843	1	7	14	2206	7865	1.52010845006778
GO:0005158	insulin receptor binding	 21	0.00804754422648645	0.771578832163946	10	11	2203	7868	2.17158350009683
GO:0005159	insulin-like growth factor receptor binding	 11	0.731548842740116	1	2	9	2211	7870	0.829150063673335
GO:0005160	transforming growth factor beta receptor binding	 15	0.872984249747857	1	2	13	2211	7866	0.608043380027113
GO:0005161	platelet-derived growth factor receptor binding	 12	1	1	0	12	2213	7867	0
GO:0005164	tumor necrosis factor receptor binding	 13	0.813973253692629	1	2	11	2211	7868	0.701588515415899
GO:0005168	neurotrophin TRKA receptor binding	  6	0.391952090801775	1	2	4	2211	7875	1.52010845006778
GO:0005178	integrin binding	 79	0.579377601355424	1	17	62	2196	7817	0.981335834853884
GO:0005179	hormone activity	 34	0.999782232411293	1	1	33	2212	7846	0.134127216182451
GO:0005184	neuropeptide hormone activity	 14	1	1	0	14	2213	7865	0
GO:0005198	structural molecule activity	100	0.945227540110125	1	16	84	2197	7795	0.729652056032535
GO:0005200	structural constituent of cytoskeleton	 68	0.975971982592745	1	9	59	2204	7820	0.603572472821031
GO:0005201	extracellular matrix structural constituent	 31	0.535156629959967	1	7	24	2206	7855	1.02975088552979
GO:0005212	structural constituent of eye lens	  6	0.773649336373543	1	1	5	2212	7874	0.760054225033891
GO:0005227	calcium activated cation channel activity	  5	0.710033128778248	1	1	4	2212	7875	0.912065070040669
GO:0005229	intracellular calcium activated chloride channel activity	  9	0.313783026377615	1	3	6	2210	7873	1.52010845006778
GO:0005230	extracellular ligand-gated ion channel activity	 17	0.754769220253611	1	3	14	2210	7865	0.804763297094708
GO:0005231	excitatory extracellular ligand-gated ion channel activity	  5	0.302606661467939	1	2	3	2211	7876	1.82413014008134
GO:0005234	extracellular-glutamate-gated ion channel activity	 12	0.9488167484775	1	1	11	2212	7868	0.380027112516945
GO:0005242	inward rectifier potassium channel activity	 12	1	1	0	12	2213	7867	0
GO:0005243	gap junction channel activity	  6	0.773649336373543	1	1	5	2212	7874	0.760054225033891
GO:0005244	voltage-gated ion channel activity	 89	0.904896004892313	1	15	74	2198	7805	0.768594160146631
GO:0005245	voltage-gated calcium channel activity	 22	0.189989135641112	1	7	15	2206	7864	1.45101261142834
GO:0005246	calcium channel regulator activity	 20	0.847343512007977	1	3	17	2210	7862	0.684048802530502
GO:0005247	voltage-gated chloride channel activity	  7	1	1	0	7	2213	7872	0
GO:0005248	voltage-gated sodium channel activity	 14	0.846032978004182	1	2	12	2211	7867	0.651475050029049
GO:0005249	voltage-gated potassium channel activity	 41	0.826067643558699	1	7	34	2206	7845	0.778592132961547
GO:0005251	delayed rectifier potassium channel activity	 12	0.508975472817498	1	3	9	2210	7870	1.14008133755084
GO:0005254	chloride channel activity	 35	0.355345167744352	1	9	26	2204	7853	1.17265509005229
GO:0005261	cation channel activity	 15	0.217236222744526	1	5	10	2208	7869	1.52010845006778
GO:0005262	calcium channel activity	 50	0.064407422046919	1	16	34	2197	7845	1.45930411206507
GO:0005267	potassium channel activity	 52	0.732318772105666	1	10	42	2203	7837	0.876985644269874
GO:0005272	sodium channel activity	 19	0.990977776999059	1	1	18	2212	7861	0.240017123694913
GO:0005313	L-glutamate transmembrane transporter activity	  9	0.619953536302463	1	2	7	2211	7872	1.01340563337852
GO:0005314	high-affinity glutamate transmembrane transporter activity	  5	0.710033128778248	1	1	4	2212	7875	0.912065070040669
GO:0005319	lipid transporter activity	  9	0.113156370629833	1	4	5	2209	7874	2.02681126675704
GO:0005328	neurotransmitter:sodium symporter activity	 10	0.915977754641309	1	1	9	2212	7870	0.456032535020334
GO:0005351	sugar:proton symporter activity	  8	1	1	0	8	2213	7871	0
GO:0005355	glucose transmembrane transporter activity	 10	0.915977754641309	1	1	9	2212	7870	0.456032535020334
GO:0005385	zinc ion transmembrane transporter activity	 17	0.530544543161278	1	4	13	2209	7866	1.07301772945961
GO:0005388	calcium-transporting ATPase activity	 10	0.679711898251496	1	2	8	2211	7871	0.912065070040669
GO:0005391	sodium:potassium-exchanging ATPase activity	  5	1	1	0	5	2213	7874	0
GO:0005432	calcium:sodium antiporter activity	  5	0.710033128778248	1	1	4	2212	7875	0.912065070040669
GO:0005452	inorganic anion exchanger activity	 11	0.446445648052706	1	3	8	2210	7871	1.24372509551
GO:0005484	SNAP receptor activity	 32	0.144448868211616	1	10	22	2203	7857	1.42510167193854
GO:0005487	nucleocytoplasmic transporter activity	 14	0.369358500517811	1	4	10	2209	7869	1.3029501000581
GO:0005496	steroid binding	 13	0.960053706376239	1	1	12	2212	7867	0.35079425770795
GO:0005504	fatty acid binding	  9	0.892351169002328	1	1	8	2212	7871	0.50670281668926
GO:0005506	iron ion binding	 63	0.999219282899303	1	5	58	2208	7821	0.361930583349472
GO:0005507	copper ion binding	 27	0.873852824362164	1	4	23	2209	7856	0.675603755585681
GO:0005513	detection of calcium ion	  8	0.862084765369009	1	1	7	2212	7872	0.570040668775418
GO:0005518	collagen binding	 37	0.169762303860024	1	11	26	2202	7853	1.35577240141181
GO:0005520	insulin-like growth factor binding	 15	0.872984249747857	1	2	13	2211	7866	0.608043380027113
GO:0005521	lamin binding	 12	0.258856173758332	1	4	8	2209	7871	1.52010845006778
GO:0005522	profilin binding	  8	0.862084765369009	1	1	7	2212	7872	0.570040668775418
GO:0005523	tropomyosin binding	  8	0.551915645208052	1	2	6	2211	7873	1.14008133755084
GO:0005528	FK506 binding	 10	1	1	0	10	2213	7869	0
GO:0005536	glucose binding	  7	1	1	0	7	2213	7872	0
GO:0005537	mannose binding	 10	0.380920088506331	1	3	7	2210	7872	1.368097605061
GO:0005539	glycosaminoglycan binding	 15	0.872984249747857	1	2	13	2211	7866	0.608043380027113
GO:0005540	hyaluronic acid binding	 12	0.77606351672464	1	2	10	2211	7869	0.760054225033891
GO:0005542	folic acid binding	  5	0.710033128778248	1	1	4	2212	7875	0.912065070040669
GO:0005543	phospholipid binding	 59	0.924530470717024	1	9	50	2204	7829	0.695642850031019
GO:0005544	calcium-dependent phospholipid binding	 30	0.920699322541832	1	4	26	2209	7853	0.608043380027113
GO:0005545	1-phosphatidylinositol binding	 14	0.369358500517811	1	4	10	2209	7869	1.3029501000581
GO:0005546	phosphatidylinositol-4,5-bisphosphate binding	 38	0.994546506294472	1	3	35	2210	7844	0.360025685542369
GO:0005547	phosphatidylinositol-3,4,5-trisphosphate binding	 27	0.22495881299362	1	8	19	2205	7860	1.35120751117136
GO:0005548	phospholipid transporter activity	  8	0.862084765369009	1	1	7	2212	7872	0.570040668775418
GO:0005577	fibrinogen complex	  5	1	1	0	5	2213	7874	0
GO:0005581	collagen trimer	 46	0.706395188938174	1	9	37	2204	7842	0.892237568518046
GO:0005604	basement membrane	 57	0.831825175368986	1	10	47	2203	7832	0.800057078983043
GO:0005605	basal lamina	 12	0.9488167484775	1	1	11	2212	7868	0.380027112516945
GO:0005614	interstitial matrix	  5	1	1	0	5	2213	7874	0
GO:0005623	cell	 52	0.474450349408856	1	12	40	2201	7839	1.05238277312385
GO:0005637	nuclear inner membrane	 25	0.163222101207481	1	8	17	2205	7862	1.45930411206507
GO:0005639	integral component of nuclear inner membrane	  7	0.182673311502561	1	3	4	2210	7875	1.95442515008715
GO:0005640	nuclear outer membrane	 15	0.217236222744526	1	5	10	2208	7869	1.52010845006778
GO:0005641	nuclear envelope lumen	  7	0.475663602521461	1	2	5	2211	7874	1.3029501000581
GO:0005643	nuclear pore	 52	0.732318772105666	1	10	42	2203	7837	0.876985644269874
GO:0005657	replication fork	 11	0.934420645831428	1	1	10	2212	7869	0.414575031836668
GO:0005662	DNA replication factor A complex	 11	0.206185263049328	1	4	7	2209	7872	1.65830012734667
GO:0005663	DNA replication factor C complex	  6	0.391952090801775	1	2	4	2211	7875	1.52010845006778
GO:0005664	nuclear origin of replication recognition complex	  5	1	1	0	5	2213	7874	0
GO:0005665	DNA-directed RNA polymerase II, core complex	 10	0.679711898251496	1	2	8	2211	7871	0.912065070040669
GO:0005666	DNA-directed RNA polymerase III complex	 14	0.846032978004182	1	2	12	2211	7867	0.651475050029049
GO:0005669	transcription factor TFIID complex	 24	0.630818426079107	1	5	19	2208	7860	0.950067781292363
GO:0005671	Ada2/Gcn5/Ada3 transcription activator complex	 14	0.621614907823308	1	3	11	2210	7868	0.977212575043574
GO:0005675	holo TFIIH complex	  7	0.182673311502561	1	3	4	2210	7875	1.95442515008715
GO:0005680	anaphase-promoting complex	 10	0.915977754641309	1	1	9	2212	7870	0.456032535020334
GO:0005681	spliceosomal complex	100	0.000874995947219511	0.293623640002662	36	64	2177	7815	1.6417171260732
GO:0005682	U5 snRNP	  9	1	1	0	9	2213	7870	0
GO:0005684	U2-type spliceosomal complex	  6	0.0235893709784742	1	4	2	2209	7877	3.04021690013556
GO:0005685	U1 snRNP	 12	0.258856173758332	1	4	8	2209	7871	1.52010845006778
GO:0005686	U2 snRNP	 13	0.0454386598426596	1	6	7	2207	7872	2.1047655462477
GO:0005688	U6 snRNP	  5	0.302606661467939	1	2	3	2211	7876	1.82413014008134
GO:0005689	U12-type spliceosomal complex	 16	0.478664437350441	1	4	12	2209	7867	1.14008133755084
GO:0005697	telomerase holoenzyme complex	 12	0.77606351672464	1	2	10	2211	7869	0.760054225033891
GO:0005719	nuclear euchromatin	 18	0.929856630121416	1	2	16	2211	7863	0.50670281668926
GO:0005720	nuclear heterochromatin	 11	0.731548842740116	1	2	9	2211	7870	0.829150063673335
GO:0005721	pericentric heterochromatin	  8	0.551915645208052	1	2	6	2211	7873	1.14008133755084
GO:0005736	DNA-directed RNA polymerase I complex	  8	0.551915645208052	1	2	6	2211	7873	1.14008133755084
GO:0005740	mitochondrial envelope	 11	1	1	0	11	2213	7868	0
GO:0005742	mitochondrial outer membrane translocase complex	  5	1	1	0	5	2213	7874	0
GO:0005744	mitochondrial inner membrane presequence translocase complex	  7	0.82331362534889	1	1	6	2212	7873	0.651475050029049
GO:0005746	mitochondrial respiratory chain	  9	1	1	0	9	2213	7870	0
GO:0005747	mitochondrial respiratory chain complex I	 25	0.983626289752331	1	2	23	2211	7856	0.364826028016268
GO:0005750	mitochondrial respiratory chain complex III	  8	0.551915645208052	1	2	6	2211	7873	1.14008133755084
GO:0005751	mitochondrial respiratory chain complex IV	  5	0.302606661467939	1	2	3	2211	7876	1.82413014008134
GO:0005753	mitochondrial proton-transporting ATP synthase complex	 11	1	1	0	11	2213	7868	0
GO:0005758	mitochondrial intermembrane space	 47	0.986270089361792	1	5	42	2208	7837	0.485140994702483
GO:0005761	mitochondrial ribosome	 21	0.707764107729648	1	4	17	2209	7862	0.868633400038732
GO:0005762	mitochondrial large ribosomal subunit	 37	0.731974947087403	1	7	30	2206	7849	0.862764255443876
GO:0005763	mitochondrial small ribosomal subunit	 15	0.872984249747857	1	2	13	2211	7866	0.608043380027113
GO:0005770	late endosome	 94	0.90290162064579	1	16	78	2197	7801	0.776225591523973
GO:0005771	multivesicular body	 14	0.621614907823308	1	3	11	2210	7868	0.977212575043574
GO:0005773	vacuole	 16	0.895524834056086	1	2	14	2211	7865	0.570040668775418
GO:0005774	vacuolar membrane	 11	1	1	0	11	2213	7868	0
GO:0005776	autophagosome	 49	0.997264229469655	1	4	45	2209	7834	0.372271457159457
GO:0005777	peroxisome	 72	0.0918607304042103	1	21	51	2192	7828	1.33009489380931
GO:0005778	peroxisomal membrane	 43	0.0707630689965458	1	14	29	2199	7850	1.48475709076388
GO:0005779	integral component of peroxisomal membrane	 10	0.380920088506331	1	3	7	2210	7872	1.368097605061
GO:0005782	peroxisomal matrix	 23	0.110753792313656	1	8	15	2205	7864	1.58620012180986
GO:0005786	signal recognition particle, endoplasmic reticulum targeting	  5	0.302606661467939	1	2	3	2211	7876	1.82413014008134
GO:0005787	signal peptidase complex	  5	0.302606661467939	1	2	3	2211	7876	1.82413014008134
GO:0005790	smooth endoplasmic reticulum	 21	0.962023298212517	1	2	19	2211	7860	0.434316700019366
GO:0005791	rough endoplasmic reticulum	 32	0.0328531538160317	1	12	20	2201	7859	1.71012200632625
GO:0005793	endoplasmic reticulum-Golgi intermediate compartment	 53	0.259922659294357	1	14	39	2199	7840	1.20461424344994
GO:0005795	Golgi stack	 26	0.704465957620568	1	5	21	2208	7858	0.876985644269874
GO:0005796	Golgi lumen	 46	0.904750999077418	1	7	39	2206	7840	0.693962553291813
GO:0005797	Golgi medial cisterna	  5	0.073752586889371	1	3	2	2210	7877	2.73619521012201
GO:0005798	Golgi-associated vesicle	 10	0.679711898251496	1	2	8	2211	7871	0.912065070040669
GO:0005801	cis-Golgi network	 37	0.00298891267752978	0.540073529193651	16	21	2197	7858	1.97203258387172
GO:0005802	trans-Golgi network	 96	0.0583591890363016	1	28	68	2185	7811	1.33009489380931
GO:0005811	lipid droplet	 50	0.943610380440113	1	7	43	2206	7836	0.638445549028468
GO:0005814	centriole	 74	3.18723147104769e-05	0.0748680672549102	32	42	2181	7837	1.97203258387172
GO:0005827	polar microtubule	  5	0.710033128778248	1	1	4	2212	7875	0.912065070040669
GO:0005832	chaperonin-containing T-complex	  9	1	1	0	9	2213	7870	0
GO:0005834	heterotrimeric G-protein complex	 24	0.435238773442835	1	6	18	2207	7861	1.14008133755084
GO:0005838	proteasome regulatory particle	 12	1	1	0	12	2213	7867	0
GO:0005839	proteasome core complex	 16	0.478664437350441	1	4	12	2209	7867	1.14008133755084
GO:0005840	ribosome	 92	0.558677614549795	1	20	72	2193	7807	0.991375076131162
GO:0005844	polysome	 26	0.704465957620568	1	5	21	2208	7858	0.876985644269874
GO:0005845	mRNA cap binding complex	  8	0.246907474461687	1	3	5	2210	7874	1.71012200632625
GO:0005847	mRNA cleavage and polyadenylation specificity factor complex	 11	0.731548842740116	1	2	9	2211	7870	0.829150063673335
GO:0005849	mRNA cleavage factor complex	  5	0.073752586889371	1	3	2	2210	7877	2.73619521012201
GO:0005851	eukaryotic translation initiation factor 2B complex	  6	0.773649336373543	1	1	5	2212	7874	0.760054225033891
GO:0005852	eukaryotic translation initiation factor 3 complex	 12	0.258856173758332	1	4	8	2209	7871	1.52010845006778
GO:0005859	muscle myosin complex	  7	1	1	0	7	2213	7872	0
GO:0005865	striated muscle thin filament	  5	0.710033128778248	1	1	4	2212	7875	0.912065070040669
GO:0005868	cytoplasmic dynein complex	 20	0.0181052565511552	1	9	11	2204	7868	2.05214640759151
GO:0005869	dynactin complex	  7	1	1	0	7	2213	7872	0
GO:0005871	kinesin complex	 29	0.907170755858537	1	4	25	2209	7854	0.629010393131496
GO:0005875	microtubule associated complex	 28	0.140901212312353	1	9	19	2204	7860	1.46581886256536
GO:0005876	spindle microtubule	 21	0.962023298212517	1	2	19	2211	7860	0.434316700019366
GO:0005881	cytoplasmic microtubule	 26	0.0960735964534642	1	9	17	2204	7862	1.57857415968577
GO:0005882	intermediate filament	 28	0.258581853266127	1	8	20	2205	7859	1.3029501000581
GO:0005883	neurofilament	  9	0.892351169002328	1	1	8	2212	7871	0.50670281668926
GO:0005884	actin filament	 49	0.656654731731796	1	10	39	2203	7840	0.930678642898642
GO:0005885	Arp2/3 protein complex	  7	0.82331362534889	1	1	6	2212	7873	0.651475050029049
GO:0005890	sodium:potassium-exchanging ATPase complex	  5	1	1	0	5	2213	7874	0
GO:0005891	voltage-gated calcium channel complex	 17	0.754769220253611	1	3	14	2210	7865	0.804763297094708
GO:0005892	acetylcholine-gated channel complex	  5	1	1	0	5	2213	7874	0
GO:0005901	caveola	 47	0.731574187483124	1	9	38	2204	7841	0.87325379046447
GO:0005902	microvillus	 39	0.646581088656118	1	8	31	2205	7848	0.935451353887865
GO:0005903	brush border	 35	0.909084510759699	1	5	30	2208	7849	0.651475050029049
GO:0005905	clathrin-coated pit	 52	0.607934738694342	1	11	41	2202	7838	0.964684208696861
GO:0005912	adherens junction	 52	0.607934738694342	1	11	41	2202	7838	0.964684208696861
GO:0005913	cell-cell adherens junction	 56	0.814568597339521	1	10	46	2203	7833	0.814343812536311
GO:0005915	zonula adherens	  6	0.391952090801775	1	2	4	2211	7875	1.52010845006778
GO:0005916	fascia adherens	  8	0.862084765369009	1	1	7	2212	7872	0.570040668775418
GO:0005921	gap junction	 16	0.98101329485619	1	1	15	2212	7864	0.285020334387709
GO:0005922	connexin complex	  9	0.892351169002328	1	1	8	2212	7871	0.50670281668926
GO:0005923	bicellular tight junction	 73	0.43430062774042	1	17	56	2196	7823	1.06199357470489
GO:0005930	axoneme	 45	0.1697957412009	1	13	32	2200	7847	1.31742732339208
GO:0005938	cell cortex	 97	0.210489013033758	1	25	72	2188	7807	1.17534158510395
GO:0005942	phosphatidylinositol 3-kinase complex	  6	0.773649336373543	1	1	5	2212	7874	0.760054225033891
GO:0005952	cAMP-dependent protein kinase complex	  5	0.302606661467939	1	2	3	2211	7876	1.82413014008134
GO:0005977	glycogen metabolic process	 26	0.704465957620568	1	5	21	2208	7858	0.876985644269874
GO:0005978	glycogen biosynthetic process	 19	0.625808905960736	1	4	15	2209	7864	0.960068494779651
GO:0005980	glycogen catabolic process	 13	0.813973253692629	1	2	11	2211	7868	0.701588515415899
GO:0006000	fructose metabolic process	  5	1	1	0	5	2213	7874	0
GO:0006002	fructose 6-phosphate metabolic process	  6	1	1	0	6	2213	7873	0
GO:0006004	fucose metabolic process	  5	1	1	0	5	2213	7874	0
GO:0006006	glucose metabolic process	 45	0.801160370211347	1	8	37	2205	7842	0.810724506702817
GO:0006012	galactose metabolic process	  8	0.551915645208052	1	2	6	2211	7873	1.14008133755084
GO:0006013	mannose metabolic process	  5	0.073752586889371	1	3	2	2210	7877	2.73619521012201
GO:0006020	inositol metabolic process	  7	0.475663602521461	1	2	5	2211	7874	1.3029501000581
GO:0006024	glycosaminoglycan biosynthetic process	 23	0.907908096067233	1	3	20	2210	7859	0.594825045678697
GO:0006027	glycosaminoglycan catabolic process	 18	0.929856630121416	1	2	16	2211	7863	0.50670281668926
GO:0006044	N-acetylglucosamine metabolic process	 11	0.731548842740116	1	2	9	2211	7870	0.829150063673335
GO:0006047	UDP-N-acetylglucosamine metabolic process	  6	1	1	0	6	2213	7873	0
GO:0006048	UDP-N-acetylglucosamine biosynthetic process	  8	0.551915645208052	1	2	6	2211	7873	1.14008133755084
GO:0006069	ethanol oxidation	  5	1	1	0	5	2213	7874	0
GO:0006071	glycerol metabolic process	  5	1	1	0	5	2213	7874	0
GO:0006081	cellular aldehyde metabolic process	  5	1	1	0	5	2213	7874	0
GO:0006090	pyruvate metabolic process	 17	0.914292249229749	1	2	15	2211	7864	0.536508864729805
GO:0006091	generation of precursor metabolites and energy	 30	0.670839407999931	1	6	24	2207	7855	0.912065070040669
GO:0006094	gluconeogenesis	 30	0.920699322541832	1	4	26	2209	7853	0.608043380027113
GO:0006096	glycolytic process	 20	0.992959925266813	1	1	19	2212	7860	0.228016267510167
GO:0006098	pentose-phosphate shunt	 10	0.679711898251496	1	2	8	2211	7871	0.912065070040669
GO:0006099	tricarboxylic acid cycle	 23	0.996655774514918	1	1	22	2212	7857	0.198275015226232
GO:0006101	citrate metabolic process	  5	1	1	0	5	2213	7874	0
GO:0006103	2-oxoglutarate metabolic process	 14	0.846032978004182	1	2	12	2211	7867	0.651475050029049
GO:0006105	succinate metabolic process	  6	1	1	0	6	2213	7873	0
GO:0006107	oxaloacetate metabolic process	 11	0.934420645831428	1	1	10	2212	7869	0.414575031836668
GO:0006108	malate metabolic process	  7	0.475663602521461	1	2	5	2211	7874	1.3029501000581
GO:0006110	regulation of glycolytic process	 28	0.418293834832541	1	7	21	2206	7858	1.14008133755084
GO:0006111	regulation of gluconeogenesis	  8	0.246907474461687	1	3	5	2210	7874	1.71012200632625
GO:0006112	energy reserve metabolic process	  9	0.892351169002328	1	1	8	2212	7871	0.50670281668926
GO:0006119	oxidative phosphorylation	 10	0.915977754641309	1	1	9	2212	7870	0.456032535020334
GO:0006120	mitochondrial electron transport, NADH to ubiquinone	 24	0.979750646601004	1	2	22	2211	7857	0.380027112516945
GO:0006122	mitochondrial electron transport, ubiquinol to cytochrome c	  8	0.246907474461687	1	3	5	2210	7874	1.71012200632625
GO:0006123	mitochondrial electron transport, cytochrome c to oxygen	  7	0.475663602521461	1	2	5	2211	7874	1.3029501000581
GO:0006139	nucleobase-containing compound metabolic process	 39	0.345214975320134	1	10	29	2203	7850	1.16931419235983
GO:0006164	purine nucleotide biosynthetic process	 13	0.813973253692629	1	2	11	2211	7868	0.701588515415899
GO:0006165	nucleoside diphosphate phosphorylation	  9	0.892351169002328	1	1	8	2212	7871	0.50670281668926
GO:0006167	AMP biosynthetic process	  5	1	1	0	5	2213	7874	0
GO:0006171	cAMP biosynthetic process	 13	0.813973253692629	1	2	11	2211	7868	0.701588515415899
GO:0006182	cGMP biosynthetic process	 15	0.872984249747857	1	2	13	2211	7866	0.608043380027113
GO:0006183	GTP biosynthetic process	  5	1	1	0	5	2213	7874	0
GO:0006195	purine nucleotide catabolic process	  5	0.710033128778248	1	1	4	2212	7875	0.912065070040669
GO:0006198	cAMP catabolic process	 12	0.00668545289624784	0.725336048177351	7	5	2206	7874	2.66018978761862
GO:0006221	pyrimidine nucleotide biosynthetic process	  6	1	1	0	6	2213	7873	0
GO:0006241	CTP biosynthetic process	  6	1	1	0	6	2213	7873	0
GO:0006259	DNA metabolic process	 14	0.621614907823308	1	3	11	2210	7868	0.977212575043574
GO:0006260	DNA replication	 87	0.885640676860529	1	15	72	2198	7807	0.78626299141437
GO:0006261	DNA-dependent DNA replication	 12	0.258856173758332	1	4	8	2209	7871	1.52010845006778
GO:0006264	mitochondrial DNA replication	  7	0.82331362534889	1	1	6	2212	7873	0.651475050029049
GO:0006265	DNA topological change	  6	0.123915802800268	1	3	3	2210	7876	2.28016267510167
GO:0006266	DNA ligation	  5	0.710033128778248	1	1	4	2212	7875	0.912065070040669
GO:0006268	DNA unwinding involved in DNA replication	  6	0.773649336373543	1	1	5	2212	7874	0.760054225033891
GO:0006270	DNA replication initiation	 21	0.962023298212517	1	2	19	2211	7860	0.434316700019366
GO:0006271	DNA strand elongation involved in DNA replication	  5	0.710033128778248	1	1	4	2212	7875	0.912065070040669
GO:0006275	regulation of DNA replication	 14	0.621614907823308	1	3	11	2210	7868	0.977212575043574
GO:0006283	transcription-coupled nucleotide-excision repair	 48	0.239718384400654	1	13	35	2200	7844	1.23508811568007
GO:0006284	base-excision repair	 21	0.707764107729648	1	4	17	2209	7862	0.868633400038732
GO:0006289	nucleotide-excision repair	 27	0.22495881299362	1	8	19	2205	7860	1.35120751117136
GO:0006293	nucleotide-excision repair, preincision complex stabilization	 15	0.217236222744526	1	5	10	2208	7869	1.52010845006778
GO:0006294	nucleotide-excision repair, preincision complex assembly	 19	0.101712346019139	1	7	12	2206	7867	1.68011986586439
GO:0006295	nucleotide-excision repair, DNA incision, 3	 15	0.217236222744526	1	5	10	2208	7869	1.52010845006778
GO:0006296	nucleotide-excision repair, DNA incision, 5	 24	0.135708125227478	1	8	16	2205	7863	1.52010845006778
GO:0006297	nucleotide-excision repair, DNA gap filling	 13	0.313693837540153	1	4	9	2209	7870	1.4031770308318
GO:0006298	mismatch repair	 15	0.670849711670293	1	3	12	2210	7867	0.912065070040669
GO:0006301	postreplication repair	  8	0.551915645208052	1	2	6	2211	7873	1.14008133755084
GO:0006302	double-strand break repair	 36	0.548236499857312	1	8	28	2205	7851	1.01340563337852
GO:0006303	double-strand break repair via nonhomologous end joining	 32	0.572063532355993	1	7	25	2206	7854	0.997571170356981
GO:0006306	DNA methylation	 15	0.424675692435369	1	4	11	2209	7868	1.21608676005423
GO:0006307	DNA dealkylation involved in DNA repair	  7	1	1	0	7	2213	7872	0
GO:0006309	apoptotic DNA fragmentation	 11	0.206185263049328	1	4	7	2209	7872	1.65830012734667
GO:0006310	DNA recombination	 52	0.149176927783351	1	15	37	2198	7842	1.31547846640481
GO:0006312	mitotic recombination	  5	0.710033128778248	1	1	4	2212	7875	0.912065070040669
GO:0006325	chromatin organization	 38	0.194336624801827	1	11	27	2202	7852	1.32009418032202
GO:0006334	nucleosome assembly	 35	0.811160108955759	1	6	29	2207	7850	0.781770060034859
GO:0006335	DNA replication-dependent nucleosome assembly	  6	0.391952090801775	1	2	4	2211	7875	1.52010845006778
GO:0006336	DNA replication-independent nucleosome assembly	 10	0.157129881410612	1	4	6	2209	7873	1.82413014008134
GO:0006337	nucleosome disassembly	 10	0.380920088506331	1	3	7	2210	7872	1.368097605061
GO:0006338	chromatin remodeling	 56	0.00574522837709904	0.674777072890282	21	35	2192	7844	1.71012200632625
GO:0006342	chromatin silencing	 14	0.174532180096009	1	5	9	2208	7870	1.62868762507262
GO:0006349	regulation of gene expression by genetic imprinting	  8	0.246907474461687	1	3	5	2210	7874	1.71012200632625
GO:0006352	DNA-templated transcription, initiation	 18	0.579729311039596	1	4	14	2209	7865	1.01340563337852
GO:0006353	DNA-templated transcription, termination	  6	0.773649336373543	1	1	5	2212	7874	0.760054225033891
GO:0006356	regulation of transcription from RNA polymerase I promoter	  7	0.82331362534889	1	1	6	2212	7873	0.651475050029049
GO:0006359	regulation of transcription from RNA polymerase III promoter	 10	0.157129881410612	1	4	6	2209	7873	1.82413014008134
GO:0006361	transcription initiation from RNA polymerase I promoter	 21	0.305021869322218	1	6	15	2207	7864	1.3029501000581
GO:0006362	transcription elongation from RNA polymerase I promoter	 18	0.184360311948163	1	6	12	2207	7867	1.52010845006778
GO:0006363	termination of RNA polymerase I transcription	 20	0.262931524136111	1	6	14	2207	7865	1.368097605061
GO:0006367	transcription initiation from RNA polymerase II promoter	 96	0.545350173706776	1	21	75	2192	7804	0.997571170356982
GO:0006368	transcription elongation from RNA polymerase II promoter	 66	0.0401047718361479	1	21	45	2192	7834	1.45101261142834
GO:0006369	termination of RNA polymerase II transcription	 49	0.00554236796148088	0.674777072890282	19	30	2194	7849	1.76828942150742
GO:0006370	7-methylguanosine mRNA capping	 19	0.222505526992328	1	6	13	2207	7866	1.44010274216948
GO:0006376	mRNA splice site selection	 15	3.095336859097e-05	0.0748680672549102	11	4	2202	7875	3.34423859014912
GO:0006378	mRNA polyadenylation	 24	0.261279616690155	1	7	17	2206	7862	1.33009489380931
GO:0006379	mRNA cleavage	  8	0.862084765369009	1	1	7	2212	7872	0.570040668775418
GO:0006383	transcription from RNA polymerase III promoter	 25	0.668990259355853	1	5	20	2208	7859	0.912065070040669
GO:0006384	transcription initiation from RNA polymerase III promoter	  5	1	1	0	5	2213	7874	0
GO:0006388	tRNA splicing, via endonucleolytic cleavage and ligation	 12	0.258856173758332	1	4	8	2209	7871	1.52010845006778
GO:0006390	transcription from mitochondrial promoter	  7	0.182673311502561	1	3	4	2210	7875	1.95442515008715
GO:0006396	RNA processing	 85	0.000123250528518877	0.138440874597367	34	51	2179	7828	1.82413014008134
GO:0006398	mRNA 3	  5	1	1	0	5	2213	7874	0
GO:0006400	tRNA modification	 24	0.135708125227478	1	8	16	2205	7863	1.52010845006778
GO:0006401	RNA catabolic process	 18	0.579729311039596	1	4	14	2209	7865	1.01340563337852
GO:0006402	mRNA catabolic process	 14	0.174532180096009	1	5	9	2208	7870	1.62868762507262
GO:0006405	RNA export from nucleus	 32	0.00150912446218371	0.368955511782578	15	17	2198	7862	2.13765250790782
GO:0006406	mRNA export from nucleus	 70	0.0116884333900748	0.921424037628202	24	46	2189	7833	1.56354012006972
GO:0006409	tRNA export from nucleus	 25	0.478131092972125	1	6	19	2207	7860	1.0944780840488
GO:0006413	translational initiation	 62	0.116550763366748	1	18	44	2195	7835	1.32396542425258
GO:0006414	translational elongation	 16	0.895524834056086	1	2	14	2211	7865	0.570040668775418
GO:0006415	translational termination	  7	0.00710205581442276	0.725336048177351	5	2	2208	7877	3.25737525014525
GO:0006417	regulation of translation	 99	0.0105827097616497	0.903955826549641	32	67	2181	7812	1.47404455764148
GO:0006418	tRNA aminoacylation for protein translation	 34	0.47700764043548	1	8	26	2205	7853	1.07301772945961
GO:0006446	regulation of translational initiation	 21	0.870606746054365	1	3	18	2210	7861	0.651475050029049
GO:0006450	regulation of translational fidelity	  9	0.619953536302463	1	2	7	2211	7872	1.01340563337852
GO:0006458	de novo	 12	1	1	0	12	2213	7867	0
GO:0006461	protein complex assembly	 94	0.779432565719316	1	18	76	2195	7803	0.87325379046447
GO:0006464	cellular protein modification process	 76	0.212264351285047	1	20	56	2193	7823	1.20008561847456
GO:0006465	signal peptide processing	 13	0.313693837540153	1	4	9	2209	7870	1.4031770308318
GO:0006469	negative regulation of protein kinase activity	 73	0.54695498791054	1	16	57	2197	7822	0.99952336442813
GO:0006471	protein ADP-ribosylation	 10	1	1	0	10	2213	7869	0
GO:0006473	protein acetylation	  7	0.82331362534889	1	1	6	2212	7873	0.651475050029049
GO:0006474	N-terminal protein amino acid acetylation	  6	0.0235893709784742	1	4	2	2209	7877	3.04021690013556
GO:0006476	protein deacetylation	  8	0.551915645208052	1	2	6	2211	7873	1.14008133755084
GO:0006479	protein methylation	 30	0.101800677260751	1	10	20	2203	7859	1.52010845006778
GO:0006487	protein N-linked glycosylation	 27	0.22495881299362	1	8	19	2205	7860	1.35120751117136
GO:0006488	dolichol-linked oligosaccharide biosynthetic process	 11	0.206185263049328	1	4	7	2209	7872	1.65830012734667
GO:0006489	dolichyl diphosphate biosynthetic process	  5	1	1	0	5	2213	7874	0
GO:0006491	N-glycan processing	 13	0.135471430249234	1	5	8	2208	7871	1.75397128853975
GO:0006493	protein O-linked glycosylation	 27	0.117320167846425	1	9	18	2204	7861	1.52010845006778
GO:0006497	protein lipidation	  8	0.246907474461687	1	3	5	2210	7874	1.71012200632625
GO:0006501	C-terminal protein lipidation	 36	0.998522002436445	1	2	34	2211	7845	0.25335140834463
GO:0006506	GPI anchor biosynthetic process	 23	0.590072665113217	1	5	18	2208	7861	0.991375076131162
GO:0006509	membrane protein ectodomain proteolysis	 16	0.000540700644133235	0.243487974149252	10	6	2203	7873	2.85020334387709
GO:0006513	protein monoubiquitination	 24	0.435238773442835	1	6	18	2207	7861	1.14008133755084
GO:0006515	protein quality control for misfolded or incompletely synthesized proteins	  9	0.313783026377615	1	3	6	2210	7873	1.52010845006778
GO:0006516	glycoprotein catabolic process	  9	0.113156370629833	1	4	5	2209	7874	2.02681126675704
GO:0006517	protein deglycosylation	  8	0.0020461638088357	0.436948980632278	6	2	2207	7877	3.42024401265251
GO:0006518	peptide metabolic process	  6	0.391952090801775	1	2	4	2211	7875	1.52010845006778
GO:0006520	cellular amino acid metabolic process	 21	0.962023298212517	1	2	19	2211	7860	0.434316700019366
GO:0006521	regulation of cellular amino acid metabolic process	 41	0.997023005450032	1	3	38	2210	7841	0.333682342697806
GO:0006531	aspartate metabolic process	  5	1	1	0	5	2213	7874	0
GO:0006536	glutamate metabolic process	 12	0.258856173758332	1	4	8	2209	7871	1.52010845006778
GO:0006541	glutamine metabolic process	 18	0.988437873742338	1	1	17	2212	7862	0.25335140834463
GO:0006552	leucine catabolic process	  5	0.073752586889371	1	3	2	2210	7877	2.73619521012201
GO:0006554	lysine catabolic process	 10	0.679711898251496	1	2	8	2211	7871	0.912065070040669
GO:0006555	methionine metabolic process	  5	0.302606661467939	1	2	3	2211	7876	1.82413014008134
GO:0006559	L-phenylalanine catabolic process	  7	0.82331362534889	1	1	6	2212	7873	0.651475050029049
GO:0006564	L-serine biosynthetic process	  6	0.773649336373543	1	1	5	2212	7874	0.760054225033891
GO:0006595	polyamine metabolic process	  6	1	1	0	6	2213	7873	0
GO:0006596	polyamine biosynthetic process	  9	1	1	0	9	2213	7870	0
GO:0006600	creatine metabolic process	  7	1	1	0	7	2213	7872	0
GO:0006605	protein targeting	 28	0.891630301489211	1	4	24	2209	7855	0.651475050029049
GO:0006606	protein import into nucleus	 37	0.731974947087403	1	7	30	2206	7849	0.862764255443876
GO:0006607	NLS-bearing protein import into nucleus	 17	0.914292249229749	1	2	15	2211	7864	0.536508864729805
GO:0006610	ribosomal protein import into nucleus	  5	0.710033128778248	1	1	4	2212	7875	0.912065070040669
GO:0006611	protein export from nucleus	 14	0.621614907823308	1	3	11	2210	7868	0.977212575043574
GO:0006612	protein targeting to membrane	 18	0.184360311948163	1	6	12	2207	7867	1.52010845006778
GO:0006613	cotranslational protein targeting to membrane	  7	0.00710205581442276	0.725336048177351	5	2	2208	7877	3.25737525014525
GO:0006614	SRP-dependent cotranslational protein targeting to membrane	 23	0.0468511529165853	1	9	14	2204	7865	1.78447513703609
GO:0006616	SRP-dependent cotranslational protein targeting to membrane, translocation	  5	0.073752586889371	1	3	2	2210	7877	2.73619521012201
GO:0006621	protein retention in ER lumen	  7	0.82331362534889	1	1	6	2212	7873	0.651475050029049
GO:0006622	protein targeting to lysosome	 11	0.446445648052706	1	3	8	2210	7871	1.24372509551
GO:0006625	protein targeting to peroxisome	  7	0.182673311502561	1	3	4	2210	7875	1.95442515008715
GO:0006626	protein targeting to mitochondrion	 22	0.890676450832607	1	3	19	2210	7860	0.621862547755001
GO:0006631	fatty acid metabolic process	 88	0.369722012693755	1	21	67	2192	7812	1.08825945857125
GO:0006633	fatty acid biosynthetic process	 40	0.0401315179774287	1	14	26	2199	7853	1.59611387257117
GO:0006635	fatty acid beta-oxidation	 34	0.194803410270231	1	10	24	2203	7855	1.34127216182451
GO:0006636	unsaturated fatty acid biosynthetic process	  9	0.0286913764967491	1	5	4	2208	7875	2.5335140834463
GO:0006637	acyl-CoA metabolic process	 13	0.960053706376239	1	1	12	2212	7867	0.35079425770795
GO:0006641	triglyceride metabolic process	 18	0.579729311039596	1	4	14	2209	7865	1.01340563337852
GO:0006644	phospholipid metabolic process	 38	0.869733087252702	1	6	32	2207	7847	0.720051371084738
GO:0006646	phosphatidylethanolamine biosynthetic process	 10	0.679711898251496	1	2	8	2211	7871	0.912065070040669
GO:0006650	glycerophospholipid metabolic process	  5	1	1	0	5	2213	7874	0
GO:0006654	phosphatidic acid biosynthetic process	 23	0.907908096067233	1	3	20	2210	7859	0.594825045678697
GO:0006655	phosphatidylglycerol biosynthetic process	  5	0.302606661467939	1	2	3	2211	7876	1.82413014008134
GO:0006656	phosphatidylcholine biosynthetic process	 21	0.305021869322218	1	6	15	2207	7864	1.3029501000581
GO:0006657	CDP-choline pathway	  5	0.073752586889371	1	3	2	2210	7877	2.73619521012201
GO:0006658	phosphatidylserine metabolic process	  5	1	1	0	5	2213	7874	0
GO:0006661	phosphatidylinositol biosynthetic process	 55	0.796012055866919	1	10	45	2203	7834	0.829150063673335
GO:0006665	sphingolipid metabolic process	 23	0.391748984254665	1	6	17	2207	7862	1.18965009135739
GO:0006672	ceramide metabolic process	 13	0.567559963400701	1	3	10	2210	7869	1.05238277312385
GO:0006687	glycosphingolipid metabolic process	 32	0.861473005548451	1	5	27	2208	7852	0.712550835969272
GO:0006688	glycosphingolipid biosynthetic process	  7	1	1	0	7	2213	7872	0
GO:0006689	ganglioside catabolic process	  5	0.710033128778248	1	1	4	2212	7875	0.912065070040669
GO:0006691	leukotriene metabolic process	  8	0.862084765369009	1	1	7	2212	7872	0.570040668775418
GO:0006693	prostaglandin metabolic process	 11	0.934420645831428	1	1	10	2212	7869	0.414575031836668
GO:0006694	steroid biosynthetic process	 36	0.146801343783188	1	11	25	2202	7854	1.39343274589547
GO:0006695	cholesterol biosynthetic process	 29	0.293590262580069	1	8	21	2205	7858	1.25802078626299
GO:0006699	bile acid biosynthetic process	 13	0.135471430249234	1	5	8	2208	7871	1.75397128853975
GO:0006700	C21-steroid hormone biosynthetic process	  7	1	1	0	7	2213	7872	0
GO:0006702	androgen biosynthetic process	  7	0.82331362534889	1	1	6	2212	7873	0.651475050029049
GO:0006706	steroid catabolic process	  5	1	1	0	5	2213	7874	0
GO:0006707	cholesterol catabolic process	  5	1	1	0	5	2213	7874	0
GO:0006729	tetrahydrobiopterin biosynthetic process	  6	0.773649336373543	1	1	5	2212	7874	0.760054225033891
GO:0006730	one-carbon metabolic process	 18	0.789777202096414	1	3	15	2210	7864	0.760054225033891
GO:0006734	NADH metabolic process	  8	0.551915645208052	1	2	6	2211	7873	1.14008133755084
GO:0006739	NADP metabolic process	  6	1	1	0	6	2213	7873	0
GO:0006744	ubiquinone biosynthetic process	  9	0.892351169002328	1	1	8	2212	7871	0.50670281668926
GO:0006749	glutathione metabolic process	 23	0.391748984254665	1	6	17	2207	7862	1.18965009135739
GO:0006750	glutathione biosynthetic process	 11	0.206185263049328	1	4	7	2209	7872	1.65830012734667
GO:0006754	ATP biosynthetic process	 19	0.820521257621854	1	3	16	2210	7863	0.720051371084738
GO:0006768	biotin metabolic process	  7	0.475663602521461	1	2	5	2211	7874	1.3029501000581
GO:0006779	porphyrin-containing compound biosynthetic process	  6	0.773649336373543	1	1	5	2212	7874	0.760054225033891
GO:0006782	protoporphyrinogen IX biosynthetic process	  7	0.82331362534889	1	1	6	2212	7873	0.651475050029049
GO:0006783	heme biosynthetic process	 15	0.872984249747857	1	2	13	2211	7866	0.608043380027113
GO:0006790	sulfur compound metabolic process	  7	1	1	0	7	2213	7872	0
GO:0006796	phosphate-containing compound metabolic process	 14	0.846032978004182	1	2	12	2211	7867	0.651475050029049
GO:0006801	superoxide metabolic process	 15	0.975670266056184	1	1	14	2212	7865	0.304021690013556
GO:0006805	xenobiotic metabolic process	 33	0.997122497181859	1	2	31	2211	7848	0.276383354557778
GO:0006807	nitrogen compound metabolic process	 15	0.670849711670293	1	3	12	2210	7867	0.912065070040669
GO:0006809	nitric oxide biosynthetic process	 10	0.679711898251496	1	2	8	2211	7871	0.912065070040669
GO:0006812	cation transport	 43	0.622268909324522	1	9	34	2204	7845	0.954486701205351
GO:0006813	potassium ion transport	 87	0.931082531475213	1	14	73	2199	7806	0.733845458653412
GO:0006814	sodium ion transport	 68	0.949941827837073	1	10	58	2203	7821	0.670636080912256
GO:0006816	calcium ion transport	 84	0.378957748829714	1	20	64	2193	7815	1.08579175004842
GO:0006817	phosphate ion transport	  5	0.710033128778248	1	1	4	2212	7875	0.912065070040669
GO:0006820	anion transport	 13	0.813973253692629	1	2	11	2211	7868	0.701588515415899
GO:0006821	chloride transport	 46	0.570204983257395	1	10	36	2203	7843	0.991375076131162
GO:0006825	copper ion transport	  8	0.551915645208052	1	2	6	2211	7873	1.14008133755084
GO:0006826	iron ion transport	  9	0.619953536302463	1	2	7	2211	7872	1.01340563337852
GO:0006829	zinc II ion transport	 20	0.668528482767157	1	4	16	2209	7863	0.912065070040669
GO:0006833	water transport	  6	0.773649336373543	1	1	5	2212	7874	0.760054225033891
GO:0006836	neurotransmitter transport	 30	0.920699322541832	1	4	26	2209	7853	0.608043380027113
GO:0006839	mitochondrial transport	 34	0.958790818058356	1	4	30	2209	7849	0.536508864729805
GO:0006851	mitochondrial calcium ion transmembrane transport	 14	0.968824531635628	1	1	13	2212	7866	0.325737525014525
GO:0006853	carnitine shuttle	  8	0.551915645208052	1	2	6	2211	7873	1.14008133755084
GO:0006855	drug transmembrane transport	 11	0.446445648052706	1	3	8	2210	7871	1.24372509551
GO:0006865	amino acid transport	 34	0.641364935399031	1	7	27	2206	7852	0.938890513277159
GO:0006868	glutamine transport	  5	0.710033128778248	1	1	4	2212	7875	0.912065070040669
GO:0006869	lipid transport	 75	0.375043692470027	1	18	57	2195	7822	1.0944780840488
GO:0006874	cellular calcium ion homeostasis	 62	0.622146083405943	1	13	49	2200	7830	0.956197250849088
GO:0006878	cellular copper ion homeostasis	  8	0.246907474461687	1	3	5	2210	7874	1.71012200632625
GO:0006879	cellular iron ion homeostasis	 38	0.979295776749504	1	4	34	2209	7845	0.480034247389826
GO:0006882	cellular zinc ion homeostasis	 11	0.446445648052706	1	3	8	2210	7871	1.24372509551
GO:0006883	cellular sodium ion homeostasis	  9	0.892351169002328	1	1	8	2212	7871	0.50670281668926
GO:0006884	cell volume homeostasis	  9	0.619953536302463	1	2	7	2211	7872	1.01340563337852
GO:0006885	regulation of pH	 12	0.9488167484775	1	1	11	2212	7868	0.380027112516945
GO:0006887	exocytosis	 77	0.640706045864035	1	16	61	2197	7818	0.947600072769526
GO:0006890	retrograde vesicle-mediated transport, Golgi to ER	 53	0.374423476621071	1	13	40	2200	7839	1.1185703689178
GO:0006891	intra-Golgi vesicle-mediated transport	 21	0.501777076676569	1	5	16	2208	7863	1.08579175004842
GO:0006892	post-Golgi vesicle-mediated transport	 13	0.135471430249234	1	5	8	2208	7871	1.75397128853975
GO:0006893	Golgi to plasma membrane transport	 15	0.424675692435369	1	4	11	2209	7868	1.21608676005423
GO:0006895	Golgi to endosome transport	 13	0.313693837540153	1	4	9	2209	7870	1.4031770308318
GO:0006898	receptor-mediated endocytosis	 81	0.876806132404551	1	14	67	2199	7812	0.788204381516627
GO:0006900	vesicle budding from membrane	  5	0.302606661467939	1	2	3	2211	7876	1.82413014008134
GO:0006903	vesicle targeting	  6	0.773649336373543	1	1	5	2212	7874	0.760054225033891
GO:0006904	vesicle docking involved in exocytosis	 22	0.890676450832607	1	3	19	2210	7860	0.621862547755001
GO:0006906	vesicle fusion	 39	0.782801581806597	1	7	32	2206	7847	0.818519934651882
GO:0006909	phagocytosis	 43	0.86224828224711	1	7	36	2206	7843	0.74237854538194
GO:0006910	phagocytosis, recognition	  5	1	1	0	5	2213	7874	0
GO:0006911	phagocytosis, engulfment	 14	0.621614907823308	1	3	11	2210	7868	0.977212575043574
GO:0006913	nucleocytoplasmic transport	 19	0.625808905960736	1	4	15	2209	7864	0.960068494779651
GO:0006919	activation of cysteine-type endopeptidase activity involved in apoptotic process	 55	0.880518411021416	1	9	46	2204	7833	0.746235057306002
GO:0006928	movement of cell or subcellular component	 54	0.866690098359771	1	9	45	2204	7834	0.760054225033891
GO:0006930	substrate-dependent cell migration, cell extension	  5	0.710033128778248	1	1	4	2212	7875	0.912065070040669
GO:0006935	chemotaxis	 79	0.949253286620287	1	12	67	2201	7812	0.692707648132153
GO:0006936	muscle contraction	 63	0.997189419419294	1	6	57	2207	7822	0.434316700019366
GO:0006937	regulation of muscle contraction	 10	0.915977754641309	1	1	9	2212	7870	0.456032535020334
GO:0006939	smooth muscle contraction	 11	0.934420645831428	1	1	10	2212	7869	0.414575031836668
GO:0006940	regulation of smooth muscle contraction	 10	1	1	0	10	2213	7869	0
GO:0006941	striated muscle contraction	 10	0.915977754641309	1	1	9	2212	7870	0.456032535020334
GO:0006950	response to stress	 43	0.86224828224711	1	7	36	2206	7843	0.74237854538194
GO:0006952	defense response	 48	0.996690080909967	1	4	44	2209	7835	0.380027112516945
GO:0006953	acute-phase response	 17	1	1	0	17	2213	7862	0
GO:0006956	complement activation	 19	1	1	0	19	2213	7860	0
GO:0006957	complement activation, alternative pathway	  6	1	1	0	6	2213	7873	0
GO:0006958	complement activation, classical pathway	 16	0.895524834056086	1	2	14	2211	7865	0.570040668775418
GO:0006959	humoral immune response	 20	0.992959925266813	1	1	19	2212	7860	0.228016267510167
GO:0006968	cellular defense response	 21	1	1	0	21	2213	7858	0
GO:0006970	response to osmotic stress	 13	0.960053706376239	1	1	12	2212	7867	0.35079425770795
GO:0006972	hyperosmotic response	  6	0.391952090801775	1	2	4	2211	7875	1.52010845006778
GO:0006977	DNA damage response, signal transduction by p53 class mediator resulting in cell cycle arrest	 35	0.222497121987772	1	10	25	2203	7854	1.3029501000581
GO:0006978	DNA damage response, signal transduction by p53 class mediator resulting in transcription of p21 class mediator	  6	0.391952090801775	1	2	4	2211	7875	1.52010845006778
GO:0006979	response to oxidative stress	 79	0.470726745714221	1	18	61	2195	7818	1.03906147219823
GO:0006983	ER overload response	  7	0.475663602521461	1	2	5	2211	7874	1.3029501000581
GO:0006986	response to unfolded protein	 43	0.973400610903774	1	5	38	2208	7841	0.530270389558528
GO:0006995	cellular response to nitrogen starvation	  9	1	1	0	9	2213	7870	0
GO:0006996	organelle organization	 12	0.258856173758332	1	4	8	2209	7871	1.52010845006778
GO:0006997	nucleus organization	 16	0.0423390763570133	1	7	9	2206	7870	1.99514234071396
GO:0006998	nuclear envelope organization	 13	0.567559963400701	1	3	10	2210	7869	1.05238277312385
GO:0006999	nuclear pore organization	  5	0.710033128778248	1	1	4	2212	7875	0.912065070040669
GO:0007004	telomere maintenance via telomerase	  8	0.551915645208052	1	2	6	2211	7873	1.14008133755084
GO:0007005	mitochondrion organization	 54	0.967689030998185	1	7	47	2206	7832	0.591153286137471
GO:0007009	plasma membrane organization	 12	0.508975472817498	1	3	9	2210	7870	1.14008133755084
GO:0007015	actin filament organization	 53	0.503726507297963	1	12	41	2201	7838	1.03252649438566
GO:0007016	cytoskeletal anchoring at plasma membrane	 10	0.380920088506331	1	3	7	2210	7872	1.368097605061
GO:0007017	microtubule-based process	 22	0.890676450832607	1	3	19	2210	7860	0.621862547755001
GO:0007018	microtubule-based movement	 54	0.402772512433388	1	13	41	2200	7838	1.09785610282673
GO:0007020	microtubule nucleation	 14	0.846032978004182	1	2	12	2211	7867	0.651475050029049
GO:0007021	tubulin complex assembly	  5	0.710033128778248	1	1	4	2212	7875	0.912065070040669
GO:0007026	negative regulation of microtubule depolymerization	 12	0.77606351672464	1	2	10	2211	7869	0.760054225033891
GO:0007029	endoplasmic reticulum organization	 18	0.184360311948163	1	6	12	2207	7867	1.52010845006778
GO:0007030	Golgi organization	 58	0.116339194778387	1	17	41	2196	7838	1.33664708540443
GO:0007031	peroxisome organization	 17	0.0587351915934414	1	7	10	2206	7869	1.87778102655432
GO:0007032	endosome organization	 28	0.891630301489211	1	4	24	2209	7855	0.651475050029049
GO:0007034	vacuolar transport	 10	0.679711898251496	1	2	8	2211	7871	0.912065070040669
GO:0007035	vacuolar acidification	 10	0.157129881410612	1	4	6	2209	7873	1.82413014008134
GO:0007040	lysosome organization	 26	0.51999232664405	1	6	20	2207	7859	1.05238277312385
GO:0007041	lysosomal transport	  8	0.551915645208052	1	2	6	2211	7873	1.14008133755084
GO:0007043	cell-cell junction assembly	 11	0.934420645831428	1	1	10	2212	7869	0.414575031836668
GO:0007044	cell-substrate junction assembly	  5	0.710033128778248	1	1	4	2212	7875	0.912065070040669
GO:0007050	cell cycle arrest	 97	0.285931445298667	1	24	73	2189	7806	1.1283279216998
GO:0007051	spindle organization	  9	0.892351169002328	1	1	8	2212	7871	0.50670281668926
GO:0007052	mitotic spindle organization	 20	0.262931524136111	1	6	14	2207	7865	1.368097605061
GO:0007059	chromosome segregation	 46	0.706395188938174	1	9	37	2204	7842	0.892237568518046
GO:0007062	sister chromatid cohesion	 60	0.933059480920486	1	9	51	2204	7828	0.684048802530502
GO:0007064	mitotic sister chromatid cohesion	  9	0.0286913764967491	1	5	4	2208	7875	2.5335140834463
GO:0007076	mitotic chromosome condensation	  8	0.246907474461687	1	3	5	2210	7874	1.71012200632625
GO:0007077	mitotic nuclear envelope disassembly	 33	0.440343311319523	1	8	25	2205	7854	1.10553341823111
GO:0007080	mitotic metaphase plate congression	 20	0.847343512007977	1	3	17	2210	7862	0.684048802530502
GO:0007084	mitotic nuclear envelope reassembly	  9	0.619953536302463	1	2	7	2211	7872	1.01340563337852
GO:0007088	regulation of mitotic nuclear division	 13	0.813973253692629	1	2	11	2211	7868	0.701588515415899
GO:0007093	mitotic cell cycle checkpoint	 19	0.820521257621854	1	3	16	2210	7863	0.720051371084738
GO:0007094	mitotic spindle assembly checkpoint	 11	0.206185263049328	1	4	7	2209	7872	1.65830012734667
GO:0007095	mitotic G2 DNA damage checkpoint	  7	0.475663602521461	1	2	5	2211	7874	1.3029501000581
GO:0007096	regulation of exit from mitosis	  7	0.475663602521461	1	2	5	2211	7874	1.3029501000581
GO:0007097	nuclear migration	  9	0.892351169002328	1	1	8	2212	7871	0.50670281668926
GO:0007098	centrosome cycle	 25	0.077240926269973	1	9	16	2204	7863	1.6417171260732
GO:0007099	centriole replication	  8	0.0756163732373509	1	4	4	2209	7875	2.28016267510167
GO:0007129	synapsis	  6	0.123915802800268	1	3	3	2210	7876	2.28016267510167
GO:0007130	synaptonemal complex assembly	  7	0.475663602521461	1	2	5	2211	7874	1.3029501000581
GO:0007131	reciprocal meiotic recombination	 12	0.258856173758332	1	4	8	2209	7871	1.52010845006778
GO:0007140	male meiotic nuclear division	 10	0.380920088506331	1	3	7	2210	7872	1.368097605061
GO:0007141	male meiosis I	  7	0.475663602521461	1	2	5	2211	7874	1.3029501000581
GO:0007143	female meiotic nuclear division	  5	0.302606661467939	1	2	3	2211	7876	1.82413014008134
GO:0007154	cell communication	 30	0.819235072417117	1	5	25	2208	7854	0.760054225033891
GO:0007156	homophilic cell adhesion via plasma membrane adhesion molecules	 69	0.991235881515979	1	8	61	2205	7818	0.52873337393662
GO:0007157	heterophilic cell-cell adhesion via plasma membrane cell adhesion molecules	 35	0.96520453512915	1	4	31	2209	7848	0.521180040023239
GO:0007158	neuron cell-cell adhesion	 14	0.621614907823308	1	3	11	2210	7868	0.977212575043574
GO:0007159	leukocyte cell-cell adhesion	 13	0.813973253692629	1	2	11	2211	7868	0.701588515415899
GO:0007160	cell-matrix adhesion	 51	0.444886046580119	1	12	39	2201	7840	1.07301772945961
GO:0007162	negative regulation of cell adhesion	 29	0.4579722441856	1	7	22	2206	7857	1.10076818798012
GO:0007163	establishment or maintenance of cell polarity	 21	0.870606746054365	1	3	18	2210	7861	0.651475050029049
GO:0007167	enzyme linked receptor protein signaling pathway	  6	0.773649336373543	1	1	5	2212	7874	0.760054225033891
GO:0007169	transmembrane receptor protein tyrosine kinase signaling pathway	 65	0.793648093459588	1	12	53	2201	7826	0.841906218499079
GO:0007171	activation of transmembrane receptor protein tyrosine kinase activity	  8	0.246907474461687	1	3	5	2210	7874	1.71012200632625
GO:0007173	epidermal growth factor receptor signaling pathway	 42	0.305641488459175	1	11	31	2202	7848	1.19437092505326
GO:0007175	negative regulation of epidermal growth factor-activated receptor activity	  9	0.619953536302463	1	2	7	2211	7872	1.01340563337852
GO:0007178	transmembrane receptor protein serine/threonine kinase signaling pathway	 14	0.968824531635628	1	1	13	2212	7866	0.325737525014525
GO:0007179	transforming growth factor beta receptor signaling pathway	 66	0.60420265031004	1	14	52	2199	7827	0.967341740952224
GO:0007182	common-partner SMAD protein phosphorylation	  6	0.773649336373543	1	1	5	2212	7874	0.760054225033891
GO:0007183	SMAD protein complex assembly	  7	0.182673311502561	1	3	4	2210	7875	1.95442515008715
GO:0007184	SMAD protein import into nucleus	  7	1	1	0	7	2213	7872	0
GO:0007185	transmembrane receptor protein tyrosine phosphatase signaling pathway	  5	0.302606661467939	1	2	3	2211	7876	1.82413014008134
GO:0007187	G-protein coupled receptor signaling pathway, coupled to cyclic nucleotide second messenger	 22	0.969157982950508	1	2	20	2211	7859	0.414575031836668
GO:0007188	adenylate cyclase-modulating G-protein coupled receptor signaling pathway	 22	0.743498615792167	1	4	18	2209	7861	0.829150063673335
GO:0007189	adenylate cyclase-activating G-protein coupled receptor signaling pathway	 22	0.348159144452633	1	6	16	2207	7863	1.24372509551
GO:0007190	activation of adenylate cyclase activity	 23	0.775798815935103	1	4	19	2209	7860	0.793100060904929
GO:0007191	adenylate cyclase-activating dopamine receptor signaling pathway	  8	0.862084765369009	1	1	7	2212	7872	0.570040668775418
GO:0007193	adenylate cyclase-inhibiting G-protein coupled receptor signaling pathway	 36	0.970678706741602	1	4	32	2209	7847	0.50670281668926
GO:0007194	negative regulation of adenylate cyclase activity	 11	0.731548842740116	1	2	9	2211	7870	0.829150063673335
GO:0007200	phospholipase C-activating G-protein coupled receptor signaling pathway	 26	0.99841180254083	1	1	25	2212	7854	0.175397128853975
GO:0007202	activation of phospholipase C activity	 15	0.872984249747857	1	2	13	2211	7866	0.608043380027113
GO:0007204	positive regulation of cytosolic calcium ion concentration	 72	0.825720470744786	1	13	59	2200	7820	0.823392077120048
GO:0007205	protein kinase C-activating G-protein coupled receptor signaling pathway	 16	0.98101329485619	1	1	15	2212	7864	0.285020334387709
GO:0007212	dopamine receptor signaling pathway	 14	0.968824531635628	1	1	13	2212	7866	0.325737525014525
GO:0007213	G-protein coupled acetylcholine receptor signaling pathway	 11	0.731548842740116	1	2	9	2211	7870	0.829150063673335
GO:0007214	gamma-aminobutyric acid signaling pathway	 17	0.530544543161278	1	4	13	2209	7866	1.07301772945961
GO:0007215	glutamate receptor signaling pathway	  9	0.619953536302463	1	2	7	2211	7872	1.01340563337852
GO:0007218	neuropeptide signaling pathway	 41	0.999519382645369	1	2	39	2211	7840	0.22245489513187
GO:0007219	Notch signaling pathway	 73	0.840490718206899	1	13	60	2200	7819	0.812112733597856
GO:0007220	Notch receptor processing	 13	0.135471430249234	1	5	8	2208	7871	1.75397128853975
GO:0007221	positive regulation of transcription of Notch receptor target	  5	1	1	0	5	2213	7874	0
GO:0007223	Wnt signaling pathway, calcium modulating pathway	 28	0.140901212312353	1	9	19	2204	7860	1.46581886256536
GO:0007224	smoothened signaling pathway	 50	0.415188651151613	1	12	38	2201	7841	1.0944780840488
GO:0007229	integrin-mediated signaling pathway	 54	0.18823031710923	1	15	39	2198	7840	1.26675704172315
GO:0007249	I-kappaB kinase/NF-kappaB signaling	 36	0.389923262713907	1	9	27	2204	7852	1.14008133755084
GO:0007250	activation of NF-kappaB-inducing kinase activity	 10	0.679711898251496	1	2	8	2211	7871	0.912065070040669
GO:0007252	I-kappaB phosphorylation	  8	0.246907474461687	1	3	5	2210	7874	1.71012200632625
GO:0007254	JNK cascade	 31	0.932431012084879	1	4	27	2209	7852	0.588429077445593
GO:0007257	activation of JUN kinase activity	 18	0.579729311039596	1	4	14	2209	7865	1.01340563337852
GO:0007259	JAK-STAT cascade	 23	0.391748984254665	1	6	17	2207	7862	1.18965009135739
GO:0007260	tyrosine phosphorylation of STAT protein	  5	0.710033128778248	1	1	4	2212	7875	0.912065070040669
GO:0007263	nitric oxide mediated signal transduction	 12	0.508975472817498	1	3	9	2210	7870	1.14008133755084
GO:0007265	Ras protein signal transduction	 53	0.635227370726728	1	11	42	2202	7837	0.946482619853524
GO:0007266	Rho protein signal transduction	 43	0.756322999415262	1	8	35	2205	7844	0.848432623293645
GO:0007269	neurotransmitter secretion	 42	0.923526919487512	1	6	36	2207	7843	0.651475050029049
GO:0007270	neuron-neuron synaptic transmission	  7	0.475663602521461	1	2	5	2211	7874	1.3029501000581
GO:0007271	synaptic transmission, cholinergic	 10	0.915977754641309	1	1	9	2212	7870	0.456032535020334
GO:0007274	neuromuscular synaptic transmission	 14	0.968824531635628	1	1	13	2212	7866	0.325737525014525
GO:0007276	gamete generation	 11	0.446445648052706	1	3	8	2210	7871	1.24372509551
GO:0007281	germ cell development	 18	0.579729311039596	1	4	14	2209	7865	1.01340563337852
GO:0007286	spermatid development	 45	0.0113512173961846	0.921424037628202	17	28	2196	7851	1.72278957674349
GO:0007288	sperm axoneme assembly	  7	0.82331362534889	1	1	6	2212	7873	0.651475050029049
GO:0007289	spermatid nucleus differentiation	  6	0.391952090801775	1	2	4	2211	7875	1.52010845006778
GO:0007292	female gamete generation	  7	0.475663602521461	1	2	5	2211	7874	1.3029501000581
GO:0007338	single fertilization	 20	0.1281782003235	1	7	13	2206	7866	1.59611387257117
GO:0007339	binding of sperm to zona pellucida	 12	0.77606351672464	1	2	10	2211	7869	0.760054225033891
GO:0007340	acrosome reaction	  7	1	1	0	7	2213	7872	0
GO:0007346	regulation of mitotic cell cycle	 56	0.337215966145826	1	14	42	2199	7837	1.14008133755084
GO:0007368	determination of left/right symmetry	 38	0.313206795110684	1	10	28	2203	7851	1.20008561847456
GO:0007369	gastrulation	 18	0.0276347658788338	1	8	10	2205	7869	2.02681126675704
GO:0007389	pattern specification process	 34	0.997693872876568	1	2	32	2211	7847	0.268254432364903
GO:0007398	ectoderm development	  7	0.82331362534889	1	1	6	2212	7873	0.651475050029049
GO:0007405	neuroblast proliferation	 15	0.670849711670293	1	3	12	2210	7867	0.912065070040669
GO:0007409	axonogenesis	 78	0.758821672219869	1	15	63	2198	7816	0.876985644269874
GO:0007413	axonal fasciculation	 16	0.895524834056086	1	2	14	2211	7865	0.570040668775418
GO:0007416	synapse assembly	 40	0.527013831960622	1	9	31	2204	7848	1.02607320379575
GO:0007417	central nervous system development	 78	0.446775151863515	1	18	60	2195	7819	1.05238277312385
GO:0007422	peripheral nervous system development	 18	0.579729311039596	1	4	14	2209	7865	1.01340563337852
GO:0007435	salivary gland morphogenesis	  7	0.475663602521461	1	2	5	2211	7874	1.3029501000581
GO:0007492	endoderm development	 14	0.369358500517811	1	4	10	2209	7869	1.3029501000581
GO:0007494	midgut development	  6	1	1	0	6	2213	7873	0
GO:0007498	mesoderm development	 26	0.945820770982062	1	3	23	2210	7856	0.526191386561924
GO:0007512	adult heart development	  6	0.773649336373543	1	1	5	2212	7874	0.760054225033891
GO:0007517	muscle organ development	 60	0.445898986659101	1	14	46	2199	7833	1.06407591504745
GO:0007519	skeletal muscle tissue development	 32	0.403346264259878	1	8	24	2205	7855	1.14008133755084
GO:0007520	myoblast fusion	  6	0.391952090801775	1	2	4	2211	7875	1.52010845006778
GO:0007528	neuromuscular junction development	 24	0.435238773442835	1	6	18	2207	7861	1.14008133755084
GO:0007548	sex differentiation	 10	0.915977754641309	1	1	9	2212	7870	0.456032535020334
GO:0007565	female pregnancy	 48	0.755260268826758	1	9	39	2204	7840	0.855061003163127
GO:0007566	embryo implantation	 26	0.704465957620568	1	5	21	2208	7858	0.876985644269874
GO:0007569	cell aging	 16	0.895524834056086	1	2	14	2211	7865	0.570040668775418
GO:0007584	response to nutrient	 48	0.239718384400654	1	13	35	2200	7844	1.23508811568007
GO:0007585	respiratory gaseous exchange	 21	0.707764107729648	1	4	17	2209	7862	0.868633400038732
GO:0007586	digestion	 13	0.960053706376239	1	1	12	2212	7867	0.35079425770795
GO:0007588	excretion	  9	0.892351169002328	1	1	8	2212	7871	0.50670281668926
GO:0007589	body fluid secretion	  5	1	1	0	5	2213	7874	0
GO:0007595	lactation	 22	0.995713841079957	1	1	21	2212	7858	0.207287515918334
GO:0007596	blood coagulation	 98	0.765078528320382	1	19	79	2194	7800	0.884144710753709
GO:0007597	blood coagulation, intrinsic pathway	  9	1	1	0	9	2213	7870	0
GO:0007599	hemostasis	 27	0.954816764309549	1	3	24	2210	7855	0.50670281668926
GO:0007600	sensory perception	  7	1	1	0	7	2213	7872	0
GO:0007601	visual perception	 74	0.976425994480269	1	10	64	2203	7815	0.616260182459911
GO:0007602	phototransduction	 10	0.679711898251496	1	2	8	2211	7871	0.912065070040669
GO:0007605	sensory perception of sound	 72	0.738371732064656	1	14	58	2199	7821	0.886729929206206
GO:0007608	sensory perception of smell	 21	0.870606746054365	1	3	18	2210	7861	0.651475050029049
GO:0007610	behavior	  8	0.862084765369009	1	1	7	2212	7872	0.570040668775418
GO:0007611	learning or memory	 35	0.811160108955759	1	6	29	2207	7850	0.781770060034859
GO:0007612	learning	 51	0.817373713282944	1	9	42	2204	7837	0.804763297094708
GO:0007613	memory	 51	0.817373713282944	1	9	42	2204	7837	0.804763297094708
GO:0007614	short-term memory	  7	1	1	0	7	2213	7872	0
GO:0007616	long-term memory	 27	0.873852824362164	1	4	23	2209	7856	0.675603755585681
GO:0007617	mating behavior	  6	1	1	0	6	2213	7873	0
GO:0007623	circadian rhythm	 52	0.34633837048433	1	13	39	2200	7840	1.14008133755084
GO:0007625	grooming behavior	  8	1	1	0	8	2213	7871	0
GO:0007626	locomotory behavior	 60	0.794563200276812	1	11	49	2202	7830	0.83605964753728
GO:0007628	adult walking behavior	 20	0.953316959911741	1	2	18	2211	7861	0.456032535020334
GO:0007631	feeding behavior	 19	1	1	0	19	2213	7860	0
GO:0008009	chemokine activity	 16	0.98101329485619	1	1	15	2212	7864	0.285020334387709
GO:0008013	beta-catenin binding	 64	0.920070466079971	1	10	54	2203	7825	0.712550835969272
GO:0008015	blood circulation	 22	0.743498615792167	1	4	18	2209	7861	0.829150063673335
GO:0008016	regulation of heart contraction	 19	0.942719615121364	1	2	17	2211	7862	0.480034247389826
GO:0008021	synaptic vesicle	 83	0.984377586130253	1	11	72	2202	7807	0.604380468099238
GO:0008023	transcription elongation factor complex	 17	0.149082331829991	1	6	11	2207	7868	1.60952659418942
GO:0008024	cyclin/CDK positive transcription elongation factor complex	  8	0.0756163732373509	1	4	4	2209	7875	2.28016267510167
GO:0008026	ATP-dependent helicase activity	  5	0.710033128778248	1	1	4	2212	7875	0.912065070040669
GO:0008028	monocarboxylic acid transmembrane transporter activity	  8	0.862084765369009	1	1	7	2212	7872	0.570040668775418
GO:0008033	tRNA processing	 68	0.0301995634145132	1	22	46	2191	7833	1.47539937800696
GO:0008035	high-density lipoprotein particle binding	  5	1	1	0	5	2213	7874	0
GO:0008037	cell recognition	 15	1	1	0	15	2213	7864	0
GO:0008045	motor neuron axon guidance	 14	0.369358500517811	1	4	10	2209	7869	1.3029501000581
GO:0008046	axon guidance receptor activity	  5	0.710033128778248	1	1	4	2212	7875	0.912065070040669
GO:0008047	enzyme activator activity	 31	0.366328610951871	1	8	23	2205	7856	1.17685815489119
GO:0008053	mitochondrial fusion	 11	0.934420645831428	1	1	10	2212	7869	0.414575031836668
GO:0008061	chitin binding	  5	0.710033128778248	1	1	4	2212	7875	0.912065070040669
GO:0008064	regulation of actin polymerization or depolymerization	  8	1	1	0	8	2213	7871	0
GO:0008066	glutamate receptor activity	  7	1	1	0	7	2213	7872	0
GO:0008074	guanylate cyclase complex, soluble	 13	0.813973253692629	1	2	11	2211	7868	0.701588515415899
GO:0008076	voltage-gated potassium channel complex	 64	0.959334397515577	1	9	55	2204	7824	0.641295752372345
GO:0008080	N-acetyltransferase activity	 18	0.579729311039596	1	4	14	2209	7865	1.01340563337852
GO:0008081	phosphoric diester hydrolase activity	 38	0.109443516093778	1	12	26	2201	7853	1.44010274216948
GO:0008083	growth factor activity	 74	0.912767415401126	1	12	62	2201	7817	0.739512218951894
GO:0008089	anterograde axonal transport	 16	0.478664437350441	1	4	12	2209	7867	1.14008133755084
GO:0008090	retrograde axonal transport	  6	0.391952090801775	1	2	4	2211	7875	1.52010845006778
GO:0008091	spectrin	  6	0.773649336373543	1	1	5	2212	7874	0.760054225033891
GO:0008092	cytoskeletal protein binding	 52	0.0877315970930628	1	16	36	2197	7843	1.4031770308318
GO:0008093	cytoskeletal adaptor activity	  8	0.246907474461687	1	3	5	2210	7874	1.71012200632625
GO:0008094	DNA-dependent ATPase activity	 19	0.222505526992328	1	6	13	2207	7866	1.44010274216948
GO:0008104	protein localization	 42	0.923526919487512	1	6	36	2207	7843	0.651475050029049
GO:0008135	translation factor activity, RNA binding	 17	0.0587351915934414	1	7	10	2206	7869	1.87778102655432
GO:0008137	NADH dehydrogenase (ubiquinone) activity	 19	0.942719615121364	1	2	17	2211	7862	0.480034247389826
GO:0008138	protein tyrosine/serine/threonine phosphatase activity	 33	0.440343311319523	1	8	25	2205	7854	1.10553341823111
GO:0008139	nuclear localization sequence binding	 14	0.369358500517811	1	4	10	2209	7869	1.3029501000581
GO:0008140	cAMP response element binding protein binding	  6	0.773649336373543	1	1	5	2212	7874	0.760054225033891
GO:0008143	poly(A) binding	 12	0.100843441631321	1	5	7	2208	7872	1.90013556258473
GO:0008144	drug binding	 36	0.548236499857312	1	8	28	2205	7851	1.01340563337852
GO:0008146	sulfotransferase activity	 23	0.775798815935103	1	4	19	2209	7860	0.793100060904929
GO:0008154	actin polymerization or depolymerization	  9	0.892351169002328	1	1	8	2212	7871	0.50670281668926
GO:0008156	negative regulation of DNA replication	 14	0.621614907823308	1	3	11	2210	7868	0.977212575043574
GO:0008157	protein phosphatase 1 binding	 10	0.157129881410612	1	4	6	2209	7873	1.82413014008134
GO:0008171	O-methyltransferase activity	  6	1	1	0	6	2213	7873	0
GO:0008173	RNA methyltransferase activity	  7	0.182673311502561	1	3	4	2210	7875	1.95442515008715
GO:0008175	tRNA methyltransferase activity	  5	0.302606661467939	1	2	3	2211	7876	1.82413014008134
GO:0008179	adenylate cyclase binding	  7	1	1	0	7	2213	7872	0
GO:0008180	COP9 signalosome	 25	0.935180750360745	1	3	22	2210	7857	0.547239042024401
GO:0008188	neuropeptide receptor activity	  7	1	1	0	7	2213	7872	0
GO:0008190	eukaryotic initiation factor 4E binding	  5	0.710033128778248	1	1	4	2212	7875	0.912065070040669
GO:0008191	metalloendopeptidase inhibitor activity	 10	0.915977754641309	1	1	9	2212	7870	0.456032535020334
GO:0008195	phosphatidate phosphatase activity	  9	0.892351169002328	1	1	8	2212	7871	0.50670281668926
GO:0008198	ferrous iron binding	 13	0.567559963400701	1	3	10	2210	7869	1.05238277312385
GO:0008201	heparin binding	 84	0.687779610446274	1	17	67	2196	7812	0.922922987541153
GO:0008202	steroid metabolic process	 60	0.445898986659101	1	14	46	2199	7833	1.06407591504745
GO:0008203	cholesterol metabolic process	 54	0.5325705058307	1	12	42	2201	7837	1.01340563337852
GO:0008206	bile acid metabolic process	  5	0.302606661467939	1	2	3	2211	7876	1.82413014008134
GO:0008209	androgen metabolic process	  9	0.892351169002328	1	1	8	2212	7871	0.50670281668926
GO:0008210	estrogen metabolic process	  6	0.773649336373543	1	1	5	2212	7874	0.760054225033891
GO:0008217	regulation of blood pressure	 40	0.985481747346329	1	4	36	2209	7843	0.456032535020334
GO:0008219	cell death	 25	0.997964300506561	1	1	24	2212	7855	0.182413014008134
GO:0008234	cysteine-type peptidase activity	 91	0.0514204341141891	1	27	64	2186	7815	1.35306356544495
GO:0008235	metalloexopeptidase activity	  6	0.123915802800268	1	3	3	2210	7876	2.28016267510167
GO:0008236	serine-type peptidase activity	 63	0.910566524848693	1	10	53	2203	7826	0.723861166698944
GO:0008237	metallopeptidase activity	 73	0.54695498791054	1	16	57	2197	7822	0.99952336442813
GO:0008250	oligosaccharyltransferase complex	  9	0.619953536302463	1	2	7	2211	7872	1.01340563337852
GO:0008253	5	  5	0.302606661467939	1	2	3	2211	7876	1.82413014008134
GO:0008266	poly(U) RNA binding	 15	0.424675692435369	1	4	11	2209	7868	1.21608676005423
GO:0008271	secondary active sulfate transmembrane transporter activity	  5	0.710033128778248	1	1	4	2212	7875	0.912065070040669
GO:0008272	sulfate transport	  8	0.862084765369009	1	1	7	2212	7872	0.570040668775418
GO:0008274	gamma-tubulin ring complex	  5	0.710033128778248	1	1	4	2212	7875	0.912065070040669
GO:0008276	protein methyltransferase activity	  9	0.892351169002328	1	1	8	2212	7871	0.50670281668926
GO:0008277	regulation of G-protein coupled receptor protein signaling pathway	 32	0.996412341420815	1	2	30	2211	7849	0.285020334387709
GO:0008278	cohesin complex	  6	0.391952090801775	1	2	4	2211	7875	1.52010845006778
GO:0008286	insulin receptor signaling pathway	 52	0.0479102359771124	1	17	35	2196	7844	1.49087559525879
GO:0008290	F-actin capping protein complex	  5	0.710033128778248	1	1	4	2212	7875	0.912065070040669
GO:0008299	isoprenoid biosynthetic process	  9	0.619953536302463	1	2	7	2211	7872	1.01340563337852
GO:0008301	DNA binding, bending	  9	0.313783026377615	1	3	6	2210	7873	1.52010845006778
GO:0008305	integrin complex	 16	0.478664437350441	1	4	12	2209	7867	1.14008133755084
GO:0008306	associative learning	 18	0.579729311039596	1	4	14	2209	7865	1.01340563337852
GO:0008307	structural constituent of muscle	 25	0.830662443344484	1	4	21	2209	7858	0.729652056032535
GO:0008312	7S RNA binding	  6	0.391952090801775	1	2	4	2211	7875	1.52010845006778
GO:0008324	cation transmembrane transporter activity	 13	0.567559963400701	1	3	10	2210	7869	1.05238277312385
GO:0008327	methyl-CpG binding	 11	0.206185263049328	1	4	7	2209	7872	1.65830012734667
GO:0008328	ionotropic glutamate receptor complex	 10	0.679711898251496	1	2	8	2211	7871	0.912065070040669
GO:0008329	signaling pattern recognition receptor activity	  5	1	1	0	5	2213	7874	0
GO:0008331	high voltage-gated calcium channel activity	  8	0.862084765369009	1	1	7	2212	7872	0.570040668775418
GO:0008333	endosome to lysosome transport	 31	0.703403274729522	1	6	25	2207	7854	0.882643616168389
GO:0008334	histone mRNA metabolic process	  8	0.551915645208052	1	2	6	2211	7873	1.14008133755084
GO:0008340	determination of adult lifespan	  7	0.182673311502561	1	3	4	2210	7875	1.95442515008715
GO:0008344	adult locomotory behavior	 33	0.879280019060404	1	5	28	2208	7851	0.690958386394446
GO:0008347	glial cell migration	 11	0.731548842740116	1	2	9	2211	7870	0.829150063673335
GO:0008349	MAP kinase kinase kinase kinase activity	  8	0.0756163732373509	1	4	4	2209	7875	2.28016267510167
GO:0008353	RNA polymerase II carboxy-terminal domain kinase activity	 10	0.0471961044586633	1	5	5	2208	7874	2.28016267510167
GO:0008354	germ cell migration	  8	1	1	0	8	2213	7871	0
GO:0008361	regulation of cell size	 13	0.567559963400701	1	3	10	2210	7869	1.05238277312385
GO:0008366	axon ensheathment	  8	0.246907474461687	1	3	5	2210	7874	1.71012200632625
GO:0008373	sialyltransferase activity	 13	0.813973253692629	1	2	11	2211	7868	0.701588515415899
GO:0008374	O-acyltransferase activity	  5	0.710033128778248	1	1	4	2212	7875	0.912065070040669
GO:0008375	acetylglucosaminyltransferase activity	 14	0.846032978004182	1	2	12	2211	7867	0.651475050029049
GO:0008376	acetylgalactosaminyltransferase activity	  8	0.862084765369009	1	1	7	2212	7872	0.570040668775418
GO:0008378	galactosyltransferase activity	 15	0.975670266056184	1	1	14	2212	7865	0.304021690013556
GO:0008379	thioredoxin peroxidase activity	  5	0.710033128778248	1	1	4	2212	7875	0.912065070040669
GO:0008385	IkappaB kinase complex	  8	0.551915645208052	1	2	6	2211	7873	1.14008133755084
GO:0008392	arachidonic acid epoxygenase activity	  5	1	1	0	5	2213	7874	0
GO:0008395	steroid hydroxylase activity	  9	1	1	0	9	2213	7870	0
GO:0008406	gonad development	  5	0.710033128778248	1	1	4	2212	7875	0.912065070040669
GO:0008408	3	 10	0.380920088506331	1	3	7	2210	7872	1.368097605061
GO:0008409	5	  9	0.113156370629833	1	4	5	2209	7874	2.02681126675704
GO:0008417	fucosyltransferase activity	  5	0.710033128778248	1	1	4	2212	7875	0.912065070040669
GO:0008420	CTD phosphatase activity	  5	1	1	0	5	2213	7874	0
GO:0008429	phosphatidylethanolamine binding	  7	0.182673311502561	1	3	4	2210	7875	1.95442515008715
GO:0008430	selenium binding	  6	0.773649336373543	1	1	5	2212	7874	0.760054225033891
GO:0008432	JUN kinase binding	  7	0.0455724578638761	1	4	3	2209	7876	2.6059002001162
GO:0008440	inositol-1,4,5-trisphosphate 3-kinase activity	  6	0.773649336373543	1	1	5	2212	7874	0.760054225033891
GO:0008469	histone-arginine N-methyltransferase activity	  7	0.475663602521461	1	2	5	2211	7874	1.3029501000581
GO:0008483	transaminase activity	 15	0.217236222744526	1	5	10	2208	7869	1.52010845006778
GO:0008484	sulfuric ester hydrolase activity	  9	0.619953536302463	1	2	7	2211	7872	1.01340563337852
GO:0008499	UDP-galactose:beta-N-acetylglucosamine beta-1,3-galactosyltransferase activity	  7	1	1	0	7	2213	7872	0
GO:0008509	anion transmembrane transporter activity	  9	0.0286913764967491	1	5	4	2208	7875	2.5335140834463
GO:0008514	organic anion transmembrane transporter activity	 12	0.508975472817498	1	3	9	2210	7870	1.14008133755084
GO:0008519	ammonium transmembrane transporter activity	  5	0.710033128778248	1	1	4	2212	7875	0.912065070040669
GO:0008526	phosphatidylinositol transporter activity	  6	0.773649336373543	1	1	5	2212	7874	0.760054225033891
GO:0008528	G-protein coupled peptide receptor activity	  7	1	1	0	7	2213	7872	0
GO:0008535	respiratory chain complex IV assembly	  5	0.302606661467939	1	2	3	2211	7876	1.82413014008134
GO:0008536	Ran GTPase binding	 20	0.847343512007977	1	3	17	2210	7862	0.684048802530502
GO:0008540	proteasome regulatory particle, base subcomplex	 11	1	1	0	11	2213	7868	0
GO:0008541	proteasome regulatory particle, lid subcomplex	  7	1	1	0	7	2213	7872	0
GO:0008542	visual learning	 36	0.832659271646731	1	6	30	2207	7849	0.760054225033891
GO:0008543	fibroblast growth factor receptor signaling pathway	 45	0.0113512173961846	0.921424037628202	17	28	2196	7851	1.72278957674349
GO:0008544	epidermis development	 29	0.993082002387709	1	2	27	2211	7852	0.314505196565748
GO:0008565	protein transporter activity	 51	0.57969765634549	1	11	40	2202	7839	0.983599585337976
GO:0008568	microtubule-severing ATPase activity	  5	1	1	0	5	2213	7874	0
GO:0008569	ATP-dependent microtubule motor activity, minus-end-directed	  8	0.0155285424904012	1	5	3	2208	7876	2.85020334387709
GO:0008574	ATP-dependent microtubule motor activity, plus-end-directed	 14	0.174532180096009	1	5	9	2208	7870	1.62868762507262
GO:0008584	male gonad development	 59	0.206414180476635	1	16	43	2197	7836	1.23669840005514
GO:0008585	female gonad development	  8	0.0756163732373509	1	4	4	2209	7875	2.28016267510167
GO:0008589	regulation of smoothened signaling pathway	 17	0.31005409346522	1	5	12	2208	7867	1.34127216182451
GO:0008593	regulation of Notch signaling pathway	  8	0.246907474461687	1	3	5	2210	7874	1.71012200632625
GO:0008603	cAMP-dependent protein kinase regulator activity	  7	0.182673311502561	1	3	4	2210	7875	1.95442515008715
GO:0008610	lipid biosynthetic process	 14	0.174532180096009	1	5	9	2208	7870	1.62868762507262
GO:0008625	extrinsic apoptotic signaling pathway via death domain receptors	 22	0.743498615792167	1	4	18	2209	7861	0.829150063673335
GO:0008630	intrinsic apoptotic signaling pathway in response to DNA damage	 35	0.909084510759699	1	5	30	2208	7849	0.651475050029049
GO:0008631	intrinsic apoptotic signaling pathway in response to oxidative stress	 11	0.731548842740116	1	2	9	2211	7870	0.829150063673335
GO:0008635	activation of cysteine-type endopeptidase activity involved in apoptotic process by cytochrome c	  6	1	1	0	6	2213	7873	0
GO:0008637	apoptotic mitochondrial changes	 16	0.478664437350441	1	4	12	2209	7867	1.14008133755084
GO:0008641	ubiquitin-like modifier activating enzyme activity	  8	0.551915645208052	1	2	6	2211	7873	1.14008133755084
GO:0008643	carbohydrate transport	 23	0.97499130551082	1	2	21	2211	7858	0.396550030452465
GO:0008645	hexose transport	  5	0.710033128778248	1	1	4	2212	7875	0.912065070040669
GO:0008652	cellular amino acid biosynthetic process	 32	0.144448868211616	1	10	22	2203	7857	1.42510167193854
GO:0008654	phospholipid biosynthetic process	 43	0.756322999415262	1	8	35	2205	7844	0.848432623293645
GO:0008656	cysteine-type endopeptidase activator activity involved in apoptotic process	 12	0.9488167484775	1	1	11	2212	7868	0.380027112516945
GO:0008757	S-adenosylmethionine-dependent methyltransferase activity	  9	0.892351169002328	1	1	8	2212	7871	0.50670281668926
GO:0008889	glycerophosphodiester phosphodiesterase activity	  5	0.710033128778248	1	1	4	2212	7875	0.912065070040669
GO:0008970	phosphatidylcholine 1-acylhydrolase activity	  6	0.123915802800268	1	3	3	2210	7876	2.28016267510167
GO:0009055	electron carrier activity	 41	0.963372306668285	1	5	36	2208	7843	0.556137237829676
GO:0009058	biosynthetic process	 25	0.0316970379811876	1	10	15	2203	7864	1.82413014008134
GO:0009060	aerobic respiration	 20	0.953316959911741	1	2	18	2211	7861	0.456032535020334
GO:0009062	fatty acid catabolic process	 10	0.679711898251496	1	2	8	2211	7871	0.912065070040669
GO:0009083	branched-chain amino acid catabolic process	 17	0.000180224172161665	0.141115526802584	11	6	2202	7873	2.95079875601393
GO:0009086	methionine biosynthetic process	  8	0.0756163732373509	1	4	4	2209	7875	2.28016267510167
GO:0009100	glycoprotein metabolic process	  6	0.773649336373543	1	1	5	2212	7874	0.760054225033891
GO:0009108	coenzyme biosynthetic process	  5	1	1	0	5	2213	7874	0
GO:0009116	nucleoside metabolic process	 14	0.846032978004182	1	2	12	2211	7867	0.651475050029049
GO:0009117	nucleotide metabolic process	 18	0.358397855587164	1	5	13	2208	7866	1.26675704172315
GO:0009142	nucleoside triphosphate biosynthetic process	  5	0.710033128778248	1	1	4	2212	7875	0.912065070040669
GO:0009156	ribonucleoside monophosphate biosynthetic process	  5	0.710033128778248	1	1	4	2212	7875	0.912065070040669
GO:0009165	nucleotide biosynthetic process	 11	0.731548842740116	1	2	9	2211	7870	0.829150063673335
GO:0009168	purine ribonucleoside monophosphate biosynthetic process	 12	0.508975472817498	1	3	9	2210	7870	1.14008133755084
GO:0009190	cyclic nucleotide biosynthetic process	 13	0.813973253692629	1	2	11	2211	7868	0.701588515415899
GO:0009235	cobalamin metabolic process	 12	0.258856173758332	1	4	8	2209	7871	1.52010845006778
GO:0009249	protein lipoylation	  5	0.710033128778248	1	1	4	2212	7875	0.912065070040669
GO:0009267	cellular response to starvation	 42	0.99757215379138	1	3	39	2210	7840	0.325737525014525
GO:0009268	response to pH	  9	0.619953536302463	1	2	7	2211	7872	1.01340563337852
GO:0009303	rRNA transcription	  9	0.619953536302463	1	2	7	2211	7872	1.01340563337852
GO:0009306	protein secretion	 25	0.299413094933418	1	7	18	2206	7861	1.27689109805694
GO:0009311	oligosaccharide metabolic process	 13	0.813973253692629	1	2	11	2211	7868	0.701588515415899
GO:0009312	oligosaccharide biosynthetic process	  8	1	1	0	8	2213	7871	0
GO:0009313	oligosaccharide catabolic process	  9	0.619953536302463	1	2	7	2211	7872	1.01340563337852
GO:0009314	response to radiation	 25	0.983626289752331	1	2	23	2211	7856	0.364826028016268
GO:0009395	phospholipid catabolic process	  7	0.475663602521461	1	2	5	2211	7874	1.3029501000581
GO:0009404	toxin metabolic process	  5	0.710033128778248	1	1	4	2212	7875	0.912065070040669
GO:0009408	response to heat	 35	0.909084510759699	1	5	30	2208	7849	0.651475050029049
GO:0009409	response to cold	 30	0.974113014931937	1	3	27	2210	7852	0.456032535020334
GO:0009411	response to UV	 32	0.144448868211616	1	10	22	2203	7857	1.42510167193854
GO:0009414	response to water deprivation	  5	0.710033128778248	1	1	4	2212	7875	0.912065070040669
GO:0009416	response to light stimulus	 15	0.670849711670293	1	3	12	2210	7867	0.912065070040669
GO:0009435	NAD biosynthetic process	  7	0.475663602521461	1	2	5	2211	7874	1.3029501000581
GO:0009437	carnitine metabolic process	  6	0.773649336373543	1	1	5	2212	7874	0.760054225033891
GO:0009451	RNA modification	 10	0.679711898251496	1	2	8	2211	7871	0.912065070040669
GO:0009566	fertilization	 21	0.501777076676569	1	5	16	2208	7863	1.08579175004842
GO:0009607	response to biotic stimulus	  8	1	1	0	8	2213	7871	0
GO:0009611	response to wounding	 54	0.987379210884391	1	6	48	2207	7831	0.50670281668926
GO:0009612	response to mechanical stimulus	 42	0.923526919487512	1	6	36	2207	7843	0.651475050029049
GO:0009615	response to virus	 71	0.718237431462501	1	14	57	2199	7822	0.899219083138687
GO:0009617	response to bacterium	 19	0.820521257621854	1	3	16	2210	7863	0.720051371084738
GO:0009629	response to gravity	  6	0.773649336373543	1	1	5	2212	7874	0.760054225033891
GO:0009636	response to toxic substance	 56	0.231646356680706	1	15	41	2198	7838	1.22151571880447
GO:0009649	entrainment of circadian clock	  5	0.302606661467939	1	2	3	2211	7876	1.82413014008134
GO:0009650	UV protection	 10	0.915977754641309	1	1	9	2212	7870	0.456032535020334
GO:0009653	anatomical structure morphogenesis	 59	0.86259337746064	1	10	49	2203	7830	0.772936500034465
GO:0009725	response to hormone	 35	0.96520453512915	1	4	31	2209	7848	0.521180040023239
GO:0009743	response to carbohydrate	  5	1	1	0	5	2213	7874	0
GO:0009749	response to glucose	 48	0.926392673555478	1	7	41	2206	7838	0.665047446904654
GO:0009755	hormone-mediated signaling pathway	  9	0.313783026377615	1	3	6	2210	7873	1.52010845006778
GO:0009790	embryo development	 24	0.804794893906303	1	4	20	2209	7859	0.760054225033891
GO:0009791	post-embryonic development	 59	0.0229647048043779	1	20	39	2193	7840	1.54587300006893
GO:0009880	embryonic pattern specification	 13	0.0454386598426596	1	6	7	2207	7872	2.1047655462477
GO:0009887	animal organ morphogenesis	 69	0.999021717989426	1	6	63	2207	7816	0.396550030452465
GO:0009888	tissue development	  6	0.773649336373543	1	1	5	2212	7874	0.760054225033891
GO:0009898	cytoplasmic side of plasma membrane	 31	0.535156629959967	1	7	24	2206	7855	1.02975088552979
GO:0009922	fatty acid elongase activity	  5	0.073752586889371	1	3	2	2210	7877	2.73619521012201
GO:0009925	basal plasma membrane	 16	0.0423390763570133	1	7	9	2206	7870	1.99514234071396
GO:0009931	calcium-dependent protein serine/threonine kinase activity	  7	0.82331362534889	1	1	6	2212	7873	0.651475050029049
GO:0009948	anterior/posterior axis specification	 11	0.934420645831428	1	1	10	2212	7869	0.414575031836668
GO:0009950	dorsal/ventral axis specification	  5	1	1	0	5	2213	7874	0
GO:0009952	anterior/posterior pattern specification	 51	0.444886046580119	1	12	39	2201	7840	1.07301772945961
GO:0009953	dorsal/ventral pattern formation	 28	0.891630301489211	1	4	24	2209	7855	0.651475050029049
GO:0009954	proximal/distal pattern formation	 15	0.670849711670293	1	3	12	2210	7867	0.912065070040669
GO:0009966	regulation of signal transduction	 24	0.979750646601004	1	2	22	2211	7857	0.380027112516945
GO:0009967	positive regulation of signal transduction	 42	0.305641488459175	1	11	31	2202	7848	1.19437092505326
GO:0009968	negative regulation of signal transduction	 47	0.60008386174838	1	10	37	2203	7842	0.970281989404967
GO:0009982	pseudouridine synthase activity	  8	0.551915645208052	1	2	6	2211	7873	1.14008133755084
GO:0009987	cellular process	 10	1	1	0	10	2213	7869	0
GO:0010001	glial cell differentiation	 10	0.679711898251496	1	2	8	2211	7871	0.912065070040669
GO:0010033	response to organic substance	 58	0.982011005889389	1	7	51	2206	7828	0.550384093990059
GO:0010035	response to inorganic substance	 13	0.813973253692629	1	2	11	2211	7868	0.701588515415899
GO:0010038	response to metal ion	 12	0.77606351672464	1	2	10	2211	7869	0.760054225033891
GO:0010039	response to iron ion	 13	0.813973253692629	1	2	11	2211	7868	0.701588515415899
GO:0010040	response to iron(II) ion	  5	1	1	0	5	2213	7874	0
GO:0010043	response to zinc ion	 22	0.546958821448314	1	5	17	2208	7862	1.03643757959167
GO:0010107	potassium ion import	 16	1	1	0	16	2213	7863	0
GO:0010165	response to X-ray	 13	0.567559963400701	1	3	10	2210	7869	1.05238277312385
GO:0010181	FMN binding	  5	0.710033128778248	1	1	4	2212	7875	0.912065070040669
GO:0010212	response to ionizing radiation	 31	0.224105618360784	1	9	22	2204	7857	1.32396542425258
GO:0010225	response to UV-C	  6	1	1	0	6	2213	7873	0
GO:0010226	response to lithium ion	  6	0.773649336373543	1	1	5	2212	7874	0.760054225033891
GO:0010243	response to organonitrogen compound	 26	0.704465957620568	1	5	21	2208	7858	0.876985644269874
GO:0010248	establishment or maintenance of transmembrane electrochemical gradient	  8	1	1	0	8	2213	7871	0
GO:0010259	multicellular organism aging	  9	0.313783026377615	1	3	6	2210	7873	1.52010845006778
GO:0010265	SCF complex assembly	  6	1	1	0	6	2213	7873	0
GO:0010288	response to lead ion	 12	0.77606351672464	1	2	10	2211	7869	0.760054225033891
GO:0010314	phosphatidylinositol-5-phosphate binding	  7	0.182673311502561	1	3	4	2210	7875	1.95442515008715
GO:0010332	response to gamma radiation	 20	0.454930598735057	1	5	15	2208	7864	1.14008133755084
GO:0010369	chromocenter	  6	0.391952090801775	1	2	4	2211	7875	1.52010845006778
GO:0010389	regulation of G2/M transition of mitotic cell cycle	 57	0.0312129584204755	1	19	38	2194	7841	1.52010845006778
GO:0010390	histone monoubiquitination	  6	0.773649336373543	1	1	5	2212	7874	0.760054225033891
GO:0010447	response to acidic pH	  7	1	1	0	7	2213	7872	0
GO:0010457	centriole-centriole cohesion	  5	0.710033128778248	1	1	4	2212	7875	0.912065070040669
GO:0010458	exit from mitosis	  6	1	1	0	6	2213	7873	0
GO:0010459	negative regulation of heart rate	  7	1	1	0	7	2213	7872	0
GO:0010460	positive regulation of heart rate	 10	0.679711898251496	1	2	8	2211	7871	0.912065070040669
GO:0010466	negative regulation of peptidase activity	 48	0.999299469205673	1	3	45	2210	7834	0.285020334387709
GO:0010467	gene expression	  5	0.073752586889371	1	3	2	2210	7877	2.73619521012201
GO:0010469	regulation of receptor activity	 10	0.915977754641309	1	1	9	2212	7870	0.456032535020334
GO:0010470	regulation of gastrulation	  6	0.773649336373543	1	1	5	2212	7874	0.760054225033891
GO:0010485	H4 histone acetyltransferase activity	  6	0.123915802800268	1	3	3	2210	7876	2.28016267510167
GO:0010494	cytoplasmic stress granule	 30	0.194492250912578	1	9	21	2204	7858	1.368097605061
GO:0010498	proteasomal protein catabolic process	 12	0.258856173758332	1	4	8	2209	7871	1.52010845006778
GO:0010501	RNA secondary structure unwinding	 30	0.194492250912578	1	9	21	2204	7858	1.368097605061
GO:0010506	regulation of autophagy	 42	0.591600213805964	1	9	33	2204	7846	0.977212575043574
GO:0010507	negative regulation of autophagy	 17	0.754769220253611	1	3	14	2210	7865	0.804763297094708
GO:0010508	positive regulation of autophagy	 32	0.572063532355993	1	7	25	2206	7854	0.997571170356981
GO:0010510	regulation of acetyl-CoA biosynthetic process from pyruvate	 12	0.77606351672464	1	2	10	2211	7869	0.760054225033891
GO:0010518	positive regulation of phospholipase activity	  7	0.182673311502561	1	3	4	2210	7875	1.95442515008715
GO:0010524	positive regulation of calcium ion transport into cytosol	  8	0.862084765369009	1	1	7	2212	7872	0.570040668775418
GO:0010544	negative regulation of platelet activation	  7	1	1	0	7	2213	7872	0
GO:0010569	regulation of double-strand break repair via homologous recombination	  6	0.391952090801775	1	2	4	2211	7875	1.52010845006778
GO:0010575	positive regulation of vascular endothelial growth factor production	 15	0.670849711670293	1	3	12	2210	7867	0.912065070040669
GO:0010579	positive regulation of adenylate cyclase activity involved in G-protein coupled receptor signaling pathway	  5	1	1	0	5	2213	7874	0
GO:0010586	miRNA metabolic process	 11	0.206185263049328	1	4	7	2209	7872	1.65830012734667
GO:0010591	regulation of lamellipodium assembly	  9	1	1	0	9	2213	7870	0
GO:0010592	positive regulation of lamellipodium assembly	  8	0.862084765369009	1	1	7	2212	7872	0.570040668775418
GO:0010595	positive regulation of endothelial cell migration	 33	0.607526668788888	1	7	26	2206	7853	0.967341740952224
GO:0010596	negative regulation of endothelial cell migration	 10	0.915977754641309	1	1	9	2212	7870	0.456032535020334
GO:0010608	posttranscriptional regulation of gene expression	 13	0.567559963400701	1	3	10	2210	7869	1.05238277312385
GO:0010613	positive regulation of cardiac muscle hypertrophy	 11	0.206185263049328	1	4	7	2209	7872	1.65830012734667
GO:0010633	negative regulation of epithelial cell migration	 13	0.567559963400701	1	3	10	2210	7869	1.05238277312385
GO:0010634	positive regulation of epithelial cell migration	 23	0.391748984254665	1	6	17	2207	7862	1.18965009135739
GO:0010642	negative regulation of platelet-derived growth factor receptor signaling pathway	  5	1	1	0	5	2213	7874	0
GO:0010644	cell communication by electrical coupling	  5	1	1	0	5	2213	7874	0
GO:0010666	positive regulation of cardiac muscle cell apoptotic process	 10	1	1	0	10	2213	7869	0
GO:0010667	negative regulation of cardiac muscle cell apoptotic process	 14	0.369358500517811	1	4	10	2209	7869	1.3029501000581
GO:0010694	positive regulation of alkaline phosphatase activity	  5	0.302606661467939	1	2	3	2211	7876	1.82413014008134
GO:0010700	negative regulation of norepinephrine secretion	  5	1	1	0	5	2213	7874	0
GO:0010717	regulation of epithelial to mesenchymal transition	 10	0.679711898251496	1	2	8	2211	7871	0.912065070040669
GO:0010718	positive regulation of epithelial to mesenchymal transition	 25	0.668990259355853	1	5	20	2208	7859	0.912065070040669
GO:0010719	negative regulation of epithelial to mesenchymal transition	 14	0.621614907823308	1	3	11	2210	7868	0.977212575043574
GO:0010738	regulation of protein kinase A signaling	  9	0.892351169002328	1	1	8	2212	7871	0.50670281668926
GO:0010739	positive regulation of protein kinase A signaling	  5	1	1	0	5	2213	7874	0
GO:0010744	positive regulation of macrophage derived foam cell differentiation	  7	1	1	0	7	2213	7872	0
GO:0010745	negative regulation of macrophage derived foam cell differentiation	  7	0.182673311502561	1	3	4	2210	7875	1.95442515008715
GO:0010759	positive regulation of macrophage chemotaxis	  8	1	1	0	8	2213	7871	0
GO:0010761	fibroblast migration	  9	1	1	0	9	2213	7870	0
GO:0010762	regulation of fibroblast migration	  8	0.551915645208052	1	2	6	2211	7873	1.14008133755084
GO:0010763	positive regulation of fibroblast migration	 10	0.915977754641309	1	1	9	2212	7870	0.456032535020334
GO:0010765	positive regulation of sodium ion transport	 13	0.567559963400701	1	3	10	2210	7869	1.05238277312385
GO:0010793	regulation of mRNA export from nucleus	  6	0.123915802800268	1	3	3	2210	7876	2.28016267510167
GO:0010800	positive regulation of peptidyl-threonine phosphorylation	 16	0.895524834056086	1	2	14	2211	7865	0.570040668775418
GO:0010801	negative regulation of peptidyl-threonine phosphorylation	  8	0.862084765369009	1	1	7	2212	7872	0.570040668775418
GO:0010803	regulation of tumor necrosis factor-mediated signaling pathway	 21	0.501777076676569	1	5	16	2208	7863	1.08579175004842
GO:0010804	negative regulation of tumor necrosis factor-mediated signaling pathway	  7	0.182673311502561	1	3	4	2210	7875	1.95442515008715
GO:0010811	positive regulation of cell-substrate adhesion	 20	0.454930598735057	1	5	15	2208	7864	1.14008133755084
GO:0010812	negative regulation of cell-substrate adhesion	 10	1	1	0	10	2213	7869	0
GO:0010821	regulation of mitochondrion organization	  7	1	1	0	7	2213	7872	0
GO:0010824	regulation of centrosome duplication	 12	0.508975472817498	1	3	9	2210	7870	1.14008133755084
GO:0010832	negative regulation of myotube differentiation	  9	0.892351169002328	1	1	8	2212	7871	0.50670281668926
GO:0010835	regulation of protein ADP-ribosylation	  5	1	1	0	5	2213	7874	0
GO:0010839	negative regulation of keratinocyte proliferation	  7	0.82331362534889	1	1	6	2212	7873	0.651475050029049
GO:0010842	retina layer formation	 14	0.621614907823308	1	3	11	2210	7868	0.977212575043574
GO:0010862	positive regulation of pathway-restricted SMAD protein phosphorylation	 20	0.847343512007977	1	3	17	2210	7862	0.684048802530502
GO:0010863	positive regulation of phospholipase C activity	  6	0.391952090801775	1	2	4	2211	7875	1.52010845006778
GO:0010867	positive regulation of triglyceride biosynthetic process	  8	1	1	0	8	2213	7871	0
GO:0010870	positive regulation of receptor biosynthetic process	  6	0.391952090801775	1	2	4	2211	7875	1.52010845006778
GO:0010873	positive regulation of cholesterol esterification	  5	0.710033128778248	1	1	4	2212	7875	0.912065070040669
GO:0010875	positive regulation of cholesterol efflux	  8	0.862084765369009	1	1	7	2212	7872	0.570040668775418
GO:0010880	regulation of release of sequestered calcium ion into cytosol by sarcoplasmic reticulum	 12	1	1	0	12	2213	7867	0
GO:0010881	regulation of cardiac muscle contraction by regulation of the release of sequestered calcium ion	 12	0.9488167484775	1	1	11	2212	7868	0.380027112516945
GO:0010882	regulation of cardiac muscle contraction by calcium ion signaling	  6	0.773649336373543	1	1	5	2212	7874	0.760054225033891
GO:0010884	positive regulation of lipid storage	  5	1	1	0	5	2213	7874	0
GO:0010888	negative regulation of lipid storage	  5	0.302606661467939	1	2	3	2211	7876	1.82413014008134
GO:0010906	regulation of glucose metabolic process	 14	0.846032978004182	1	2	12	2211	7867	0.651475050029049
GO:0010907	positive regulation of glucose metabolic process	  8	0.246907474461687	1	3	5	2210	7874	1.71012200632625
GO:0010917	negative regulation of mitochondrial membrane potential	  8	0.862084765369009	1	1	7	2212	7872	0.570040668775418
GO:0010918	positive regulation of mitochondrial membrane potential	  7	0.82331362534889	1	1	6	2212	7873	0.651475050029049
GO:0010923	negative regulation of phosphatase activity	 33	0.0416288019511491	1	12	21	2201	7858	1.65830012734667
GO:0010941	regulation of cell death	  7	1	1	0	7	2213	7872	0
GO:0010942	positive regulation of cell death	 29	0.636078361210927	1	6	23	2207	7856	0.943515589697243
GO:0010944	negative regulation of transcription by competitive promoter binding	  7	1	1	0	7	2213	7872	0
GO:0010950	positive regulation of endopeptidase activity	  6	1	1	0	6	2213	7873	0
GO:0010951	negative regulation of endopeptidase activity	 53	0.999756722992747	1	3	50	2210	7829	0.258131623596416
GO:0010952	positive regulation of peptidase activity	 10	0.915977754641309	1	1	9	2212	7870	0.456032535020334
GO:0010955	negative regulation of protein processing	  8	0.862084765369009	1	1	7	2212	7872	0.570040668775418
GO:0010971	positive regulation of G2/M transition of mitotic cell cycle	 15	0.670849711670293	1	3	12	2210	7867	0.912065070040669
GO:0010972	negative regulation of G2/M transition of mitotic cell cycle	 44	0.992992588927621	1	4	40	2209	7839	0.414575031836668
GO:0010975	regulation of neuron projection development	 18	0.0785263715936463	1	7	11	2206	7868	1.77345985841241
GO:0010976	positive regulation of neuron projection development	 75	0.867134063345353	1	13	62	2200	7817	0.790456394035246
GO:0010977	negative regulation of neuron projection development	 45	0.679749279131065	1	9	36	2204	7843	0.912065070040669
GO:0010996	response to auditory stimulus	  8	0.246907474461687	1	3	5	2210	7874	1.71012200632625
GO:0012501	programmed cell death	 16	0.478664437350441	1	4	12	2209	7867	1.14008133755084
GO:0012505	endomembrane system	 89	0.943930307254726	1	14	75	2199	7804	0.717354549470189
GO:0012506	vesicle membrane	 18	0.789777202096414	1	3	15	2210	7864	0.760054225033891
GO:0012507	ER to Golgi transport vesicle membrane	 38	0.194336624801827	1	11	27	2202	7852	1.32009418032202
GO:0014002	astrocyte development	 11	0.206185263049328	1	4	7	2209	7872	1.65830012734667
GO:0014003	oligodendrocyte development	 21	0.707764107729648	1	4	17	2209	7862	0.868633400038732
GO:0014009	glial cell proliferation	  5	1	1	0	5	2213	7874	0
GO:0014029	neural crest formation	  7	0.475663602521461	1	2	5	2211	7874	1.3029501000581
GO:0014032	neural crest cell development	 18	0.988437873742338	1	1	17	2212	7862	0.25335140834463
GO:0014037	Schwann cell differentiation	  5	0.302606661467939	1	2	3	2211	7876	1.82413014008134
GO:0014044	Schwann cell development	  8	0.862084765369009	1	1	7	2212	7872	0.570040668775418
GO:0014047	glutamate secretion	 22	0.743498615792167	1	4	18	2209	7861	0.829150063673335
GO:0014059	regulation of dopamine secretion	  8	0.862084765369009	1	1	7	2212	7872	0.570040668775418
GO:0014065	phosphatidylinositol 3-kinase signaling	 25	0.668990259355853	1	5	20	2208	7859	0.912065070040669
GO:0014066	regulation of phosphatidylinositol 3-kinase signaling	 48	0.239718384400654	1	13	35	2200	7844	1.23508811568007
GO:0014067	negative regulation of phosphatidylinositol 3-kinase signaling	  8	1	1	0	8	2213	7871	0
GO:0014068	positive regulation of phosphatidylinositol 3-kinase signaling	 44	0.877888950950871	1	7	37	2206	7842	0.725506305714168
GO:0014070	response to organic cyclic compound	 86	0.808837104344849	1	16	70	2197	7809	0.848432623293645
GO:0014075	response to amine	  7	0.475663602521461	1	2	5	2211	7874	1.3029501000581
GO:0014701	junctional sarcoplasmic reticulum membrane	  8	1	1	0	8	2213	7871	0
GO:0014704	intercalated disc	 39	0.995538041359709	1	3	36	2210	7843	0.35079425770795
GO:0014731	spectrin-associated cytoskeleton	  6	0.391952090801775	1	2	4	2211	7875	1.52010845006778
GO:0014807	regulation of somitogenesis	  6	0.391952090801775	1	2	4	2211	7875	1.52010845006778
GO:0014823	response to activity	 28	0.767187961599886	1	5	23	2208	7856	0.814343812536311
GO:0014824	artery smooth muscle contraction	  7	0.82331362534889	1	1	6	2212	7873	0.651475050029049
GO:0014842	regulation of skeletal muscle satellite cell proliferation	  6	0.123915802800268	1	3	3	2210	7876	2.28016267510167
GO:0014850	response to muscle activity	 13	0.813973253692629	1	2	11	2211	7868	0.701588515415899
GO:0014894	response to denervation involved in regulation of muscle adaptation	  8	0.246907474461687	1	3	5	2210	7874	1.71012200632625
GO:0014898	cardiac muscle hypertrophy in response to stress	  8	0.551915645208052	1	2	6	2211	7873	1.14008133755084
GO:0014902	myotube differentiation	  6	0.391952090801775	1	2	4	2211	7875	1.52010845006778
GO:0014909	smooth muscle cell migration	  8	0.862084765369009	1	1	7	2212	7872	0.570040668775418
GO:0014911	positive regulation of smooth muscle cell migration	 11	0.206185263049328	1	4	7	2209	7872	1.65830012734667
GO:0014912	negative regulation of smooth muscle cell migration	 11	0.934420645831428	1	1	10	2212	7869	0.414575031836668
GO:0015012	heparan sulfate proteoglycan biosynthetic process	 10	0.915977754641309	1	1	9	2212	7870	0.456032535020334
GO:0015020	glucuronosyltransferase activity	  7	1	1	0	7	2213	7872	0
GO:0015026	coreceptor activity	 17	0.985183360207843	1	1	16	2212	7863	0.268254432364903
GO:0015030	Cajal body	 32	0.572063532355993	1	7	25	2206	7854	0.997571170356981
GO:0015035	protein disulfide oxidoreductase activity	 15	0.0891240947989735	1	6	9	2207	7870	1.82413014008134
GO:0015036	disulfide oxidoreductase activity	  6	0.123915802800268	1	3	3	2210	7876	2.28016267510167
GO:0015037	peptide disulfide oxidoreductase activity	  6	1	1	0	6	2213	7873	0
GO:0015074	DNA integration	  7	0.182673311502561	1	3	4	2210	7875	1.95442515008715
GO:0015075	ion transmembrane transporter activity	  8	0.551915645208052	1	2	6	2211	7873	1.14008133755084
GO:0015078	hydrogen ion transmembrane transporter activity	 14	0.846032978004182	1	2	12	2211	7867	0.651475050029049
GO:0015095	magnesium ion transmembrane transporter activity	 13	0.313693837540153	1	4	9	2209	7870	1.4031770308318
GO:0015106	bicarbonate transmembrane transporter activity	  7	0.475663602521461	1	2	5	2211	7874	1.3029501000581
GO:0015116	sulfate transmembrane transporter activity	  6	0.773649336373543	1	1	5	2212	7874	0.760054225033891
GO:0015171	amino acid transmembrane transporter activity	 31	0.703403274729522	1	6	25	2207	7854	0.882643616168389
GO:0015175	neutral amino acid transmembrane transporter activity	  8	0.862084765369009	1	1	7	2212	7872	0.570040668775418
GO:0015179	L-amino acid transmembrane transporter activity	  7	0.82331362534889	1	1	6	2212	7873	0.651475050029049
GO:0015186	L-glutamine transmembrane transporter activity	  5	0.710033128778248	1	1	4	2212	7875	0.912065070040669
GO:0015194	L-serine transmembrane transporter activity	  8	0.862084765369009	1	1	7	2212	7872	0.570040668775418
GO:0015248	sterol transporter activity	  8	0.0756163732373509	1	4	4	2209	7875	2.28016267510167
GO:0015266	protein channel activity	  8	0.551915645208052	1	2	6	2211	7873	1.14008133755084
GO:0015267	channel activity	  8	0.551915645208052	1	2	6	2211	7873	1.14008133755084
GO:0015269	calcium-activated potassium channel activity	 11	0.731548842740116	1	2	9	2211	7870	0.829150063673335
GO:0015276	ligand-gated ion channel activity	 14	0.846032978004182	1	2	12	2211	7867	0.651475050029049
GO:0015278	calcium-release channel activity	 10	0.157129881410612	1	4	6	2209	7873	1.82413014008134
GO:0015293	symporter activity	 61	0.713076423234635	1	12	49	2201	7830	0.897113183646559
GO:0015297	antiporter activity	 29	0.968771645692927	1	3	26	2210	7853	0.471757794848622
GO:0015299	solute:proton antiporter activity	  6	0.773649336373543	1	1	5	2212	7874	0.760054225033891
GO:0015301	anion:anion antiporter activity	 10	0.915977754641309	1	1	9	2212	7870	0.456032535020334
GO:0015347	sodium-independent organic anion transmembrane transporter activity	 10	0.380920088506331	1	3	7	2210	7872	1.368097605061
GO:0015377	cation:chloride symporter activity	  5	0.710033128778248	1	1	4	2212	7875	0.912065070040669
GO:0015379	potassium:chloride symporter activity	  5	1	1	0	5	2213	7874	0
GO:0015385	sodium:proton antiporter activity	  5	1	1	0	5	2213	7874	0
GO:0015450	P-P-bond-hydrolysis-driven protein transmembrane transporter activity	  6	0.391952090801775	1	2	4	2211	7875	1.52010845006778
GO:0015459	potassium channel regulator activity	 29	0.968771645692927	1	3	26	2210	7853	0.471757794848622
GO:0015467	G-protein activated inward rectifier potassium channel activity	  8	1	1	0	8	2213	7871	0
GO:0015485	cholesterol binding	 26	0.193065881098155	1	8	18	2205	7861	1.4031770308318
GO:0015631	tubulin binding	 37	0.169762303860024	1	11	26	2202	7853	1.35577240141181
GO:0015643	toxic substance binding	  6	1	1	0	6	2213	7873	0
GO:0015671	oxygen transport	  5	1	1	0	5	2213	7874	0
GO:0015693	magnesium ion transport	 10	0.915977754641309	1	1	9	2212	7870	0.456032535020334
GO:0015695	organic cation transport	  9	0.892351169002328	1	1	8	2212	7871	0.50670281668926
GO:0015696	ammonium transport	  5	0.710033128778248	1	1	4	2212	7875	0.912065070040669
GO:0015698	inorganic anion transport	 12	0.508975472817498	1	3	9	2210	7870	1.14008133755084
GO:0015701	bicarbonate transport	 23	0.391748984254665	1	6	17	2207	7862	1.18965009135739
GO:0015711	organic anion transport	 11	0.446445648052706	1	3	8	2210	7871	1.24372509551
GO:0015718	monocarboxylic acid transport	  8	0.862084765369009	1	1	7	2212	7872	0.570040668775418
GO:0015721	bile acid and bile salt transport	  8	0.246907474461687	1	3	5	2210	7874	1.71012200632625
GO:0015758	glucose transport	 14	0.621614907823308	1	3	11	2210	7868	0.977212575043574
GO:0015804	neutral amino acid transport	  8	1	1	0	8	2213	7871	0
GO:0015807	L-amino acid transport	  6	0.773649336373543	1	1	5	2212	7874	0.760054225033891
GO:0015812	gamma-aminobutyric acid transport	  5	1	1	0	5	2213	7874	0
GO:0015813	L-glutamate transport	  9	0.313783026377615	1	3	6	2210	7873	1.52010845006778
GO:0015816	glycine transport	  5	0.710033128778248	1	1	4	2212	7875	0.912065070040669
GO:0015825	L-serine transport	  8	0.862084765369009	1	1	7	2212	7872	0.570040668775418
GO:0015833	peptide transport	  7	0.475663602521461	1	2	5	2211	7874	1.3029501000581
GO:0015866	ADP transport	  6	1	1	0	6	2213	7873	0
GO:0015867	ATP transport	  7	1	1	0	7	2213	7872	0
GO:0015871	choline transport	  6	0.391952090801775	1	2	4	2211	7875	1.52010845006778
GO:0015908	fatty acid transport	 10	0.915977754641309	1	1	9	2212	7870	0.456032535020334
GO:0015909	long-chain fatty acid transport	  7	0.82331362534889	1	1	6	2212	7873	0.651475050029049
GO:0015914	phospholipid transport	 31	0.0591636588260353	1	11	20	2202	7859	1.61817996297538
GO:0015918	sterol transport	  6	0.123915802800268	1	3	3	2210	7876	2.28016267510167
GO:0015934	large ribosomal subunit	  8	0.862084765369009	1	1	7	2212	7872	0.570040668775418
GO:0015935	small ribosomal subunit	  8	0.862084765369009	1	1	7	2212	7872	0.570040668775418
GO:0015937	coenzyme A biosynthetic process	  8	0.862084765369009	1	1	7	2212	7872	0.570040668775418
GO:0015939	pantothenate metabolic process	  5	1	1	0	5	2213	7874	0
GO:0015949	nucleobase-containing small molecule interconversion	 23	0.590072665113217	1	5	18	2208	7861	0.991375076131162
GO:0015986	ATP synthesis coupled proton transport	 10	0.915977754641309	1	1	9	2212	7870	0.456032535020334
GO:0015991	ATP hydrolysis coupled proton transport	 15	0.872984249747857	1	2	13	2211	7866	0.608043380027113
GO:0015992	proton transport	 51	0.998137179250737	1	4	47	2209	7832	0.357672576486537
GO:0016010	dystrophin-associated glycoprotein complex	 11	0.0712829635428583	1	5	6	2208	7873	2.07287515918334
GO:0016018	cyclosporin A binding	  9	0.313783026377615	1	3	6	2210	7873	1.52010845006778
GO:0016024	CDP-diacylglycerol biosynthetic process	  9	0.313783026377615	1	3	6	2210	7873	1.52010845006778
GO:0016042	lipid catabolic process	 57	0.831825175368986	1	10	47	2203	7832	0.800057078983043
GO:0016043	cellular component organization	  6	0.391952090801775	1	2	4	2211	7875	1.52010845006778
GO:0016049	cell growth	 34	0.787551328699188	1	6	28	2207	7851	0.804763297094708
GO:0016050	vesicle organization	 18	0.184360311948163	1	6	12	2207	7867	1.52010845006778
GO:0016051	carbohydrate biosynthetic process	  5	0.710033128778248	1	1	4	2212	7875	0.912065070040669
GO:0016064	immunoglobulin mediated immune response	  8	1	1	0	8	2213	7871	0
GO:0016070	RNA metabolic process	 38	0.0258650246612942	1	14	24	2199	7855	1.68011986586439
GO:0016075	rRNA catabolic process	  8	0.862084765369009	1	1	7	2212	7872	0.570040668775418
GO:0016079	synaptic vesicle exocytosis	 19	0.625808905960736	1	4	15	2209	7864	0.960068494779651
GO:0016081	synaptic vesicle docking	  7	0.475663602521461	1	2	5	2211	7874	1.3029501000581
GO:0016082	synaptic vesicle priming	  7	0.182673311502561	1	3	4	2210	7875	1.95442515008715
GO:0016125	sterol metabolic process	 10	0.679711898251496	1	2	8	2211	7871	0.912065070040669
GO:0016126	sterol biosynthetic process	 25	0.163222101207481	1	8	17	2205	7862	1.45930411206507
GO:0016176	superoxide-generating NADPH oxidase activator activity	  5	1	1	0	5	2213	7874	0
GO:0016180	snRNA processing	 10	0.380920088506331	1	3	7	2210	7872	1.368097605061
GO:0016188	synaptic vesicle maturation	  7	0.82331362534889	1	1	6	2212	7873	0.651475050029049
GO:0016197	endosomal transport	 42	0.193314492917718	1	12	30	2201	7849	1.3029501000581
GO:0016199	axon midline choice point recognition	  5	0.710033128778248	1	1	4	2212	7875	0.912065070040669
GO:0016208	AMP binding	  8	0.862084765369009	1	1	7	2212	7872	0.570040668775418
GO:0016209	antioxidant activity	 20	0.953316959911741	1	2	18	2211	7861	0.456032535020334
GO:0016226	iron-sulfur cluster assembly	  9	0.619953536302463	1	2	7	2211	7872	1.01340563337852
GO:0016233	telomere capping	  9	0.619953536302463	1	2	7	2211	7872	1.01340563337852
GO:0016234	inclusion body	 17	0.914292249229749	1	2	15	2211	7864	0.536508864729805
GO:0016235	aggresome	 21	0.707764107729648	1	4	17	2209	7862	0.868633400038732
GO:0016236	macroautophagy	 67	0.628650413811143	1	14	53	2199	7826	0.952903804520102
GO:0016239	positive regulation of macroautophagy	 20	0.454930598735057	1	5	15	2208	7864	1.14008133755084
GO:0016241	regulation of macroautophagy	 55	0.796012055866919	1	10	45	2203	7834	0.829150063673335
GO:0016242	negative regulation of macroautophagy	  8	0.551915645208052	1	2	6	2211	7873	1.14008133755084
GO:0016247	channel regulator activity	  5	1	1	0	5	2213	7874	0
GO:0016254	preassembly of GPI anchor in ER membrane	 12	0.9488167484775	1	1	11	2212	7868	0.380027112516945
GO:0016255	attachment of GPI anchor to protein	  5	0.710033128778248	1	1	4	2212	7875	0.912065070040669
GO:0016264	gap junction assembly	  7	0.475663602521461	1	2	5	2211	7874	1.3029501000581
GO:0016266	O-glycan processing	 26	0.51999232664405	1	6	20	2207	7859	1.05238277312385
GO:0016274	protein-arginine N-methyltransferase activity	  9	0.0286913764967491	1	5	4	2208	7875	2.5335140834463
GO:0016279	protein-lysine N-methyltransferase activity	  9	0.619953536302463	1	2	7	2211	7872	1.01340563337852
GO:0016282	eukaryotic 43S preinitiation complex	  6	1	1	0	6	2213	7873	0
GO:0016303	1-phosphatidylinositol-3-kinase activity	 19	0.000708208865817575	0.277263770967581	11	8	2202	7871	2.64018836064404
GO:0016307	phosphatidylinositol phosphate kinase activity	  8	0.862084765369009	1	1	7	2212	7872	0.570040668775418
GO:0016308	1-phosphatidylinositol-4-phosphate 5-kinase activity	  7	0.82331362534889	1	1	6	2212	7873	0.651475050029049
GO:0016322	neuron remodeling	  8	0.246907474461687	1	3	5	2210	7874	1.71012200632625
GO:0016327	apicolateral plasma membrane	 11	0.934420645831428	1	1	10	2212	7869	0.414575031836668
GO:0016328	lateral plasma membrane	 37	0.731974947087403	1	7	30	2206	7849	0.862764255443876
GO:0016331	morphogenesis of embryonic epithelium	 10	0.915977754641309	1	1	9	2212	7870	0.456032535020334
GO:0016338	calcium-independent cell-cell adhesion via plasma membrane cell-adhesion molecules	  5	1	1	0	5	2213	7874	0
GO:0016339	calcium-dependent cell-cell adhesion via plasma membrane cell adhesion molecules	 12	0.9488167484775	1	1	11	2212	7868	0.380027112516945
GO:0016342	catenin complex	  7	0.475663602521461	1	2	5	2211	7874	1.3029501000581
GO:0016358	dendrite development	 21	0.501777076676569	1	5	16	2208	7863	1.08579175004842
GO:0016363	nuclear matrix	 71	0.0140745025967451	1	24	47	2189	7832	1.54151842823775
GO:0016407	acetyltransferase activity	  7	0.0455724578638761	1	4	3	2209	7876	2.6059002001162
GO:0016409	palmitoyltransferase activity	 11	0.0182918735576292	1	6	5	2207	7874	2.48745019102001
GO:0016442	RISC complex	  8	0.551915645208052	1	2	6	2211	7873	1.14008133755084
GO:0016446	somatic hypermutation of immunoglobulin genes	  5	0.710033128778248	1	1	4	2212	7875	0.912065070040669
GO:0016447	somatic recombination of immunoglobulin gene segments	  5	0.710033128778248	1	1	4	2212	7875	0.912065070040669
GO:0016459	myosin complex	 23	0.110753792313656	1	8	15	2205	7864	1.58620012180986
GO:0016461	unconventional myosin complex	  6	0.123915802800268	1	3	3	2210	7876	2.28016267510167
GO:0016471	vacuolar proton-transporting V-type ATPase complex	  6	0.773649336373543	1	1	5	2212	7874	0.760054225033891
GO:0016485	protein processing	 42	0.11190640091395	1	13	29	2200	7850	1.41152927506294
GO:0016486	peptide hormone processing	 11	0.731548842740116	1	2	9	2211	7870	0.829150063673335
GO:0016494	C-X-C chemokine receptor activity	  6	1	1	0	6	2213	7873	0
GO:0016504	peptidase activator activity	  8	0.862084765369009	1	1	7	2212	7872	0.570040668775418
GO:0016514	SWI/SNF complex	 10	0.0471961044586633	1	5	5	2208	7874	2.28016267510167
GO:0016525	negative regulation of angiogenesis	 42	0.845004631553554	1	7	35	2206	7844	0.760054225033891
GO:0016528	sarcoplasm	  8	0.551915645208052	1	2	6	2211	7873	1.14008133755084
GO:0016529	sarcoplasmic reticulum	 38	0.615163392648386	1	8	30	2205	7849	0.960068494779651
GO:0016538	cyclin-dependent protein serine/threonine kinase regulator activity	 11	0.0712829635428583	1	5	6	2208	7873	2.07287515918334
GO:0016540	protein autoprocessing	  6	0.391952090801775	1	2	4	2211	7875	1.52010845006778
GO:0016558	protein import into peroxisome matrix	  5	0.302606661467939	1	2	3	2211	7876	1.82413014008134
GO:0016559	peroxisome fission	  6	1	1	0	6	2213	7873	0
GO:0016570	histone modification	  5	0.710033128778248	1	1	4	2212	7875	0.912065070040669
GO:0016571	histone methylation	 15	0.0292190591141408	1	7	8	2206	7871	2.12815183009489
GO:0016572	histone phosphorylation	  5	1	1	0	5	2213	7874	0
GO:0016573	histone acetylation	 23	0.391748984254665	1	6	17	2207	7862	1.18965009135739
GO:0016575	histone deacetylation	 35	0.96520453512915	1	4	31	2209	7848	0.521180040023239
GO:0016578	histone deubiquitination	 11	0.446445648052706	1	3	8	2210	7871	1.24372509551
GO:0016580	Sin3 complex	  9	0.619953536302463	1	2	7	2211	7872	1.01340563337852
GO:0016581	NuRD complex	 14	0.846032978004182	1	2	12	2211	7867	0.651475050029049
GO:0016591	DNA-directed RNA polymerase II, holoenzyme	  5	0.00951539520558073	0.843458993883364	4	1	2209	7878	3.64826028016268
GO:0016592	mediator complex	 27	0.56045703727351	1	6	21	2207	7858	1.01340563337852
GO:0016593	Cdc73/Paf1 complex	  5	0.710033128778248	1	1	4	2212	7875	0.912065070040669
GO:0016594	glycine binding	  7	1	1	0	7	2213	7872	0
GO:0016595	glutamate binding	  8	0.862084765369009	1	1	7	2212	7872	0.570040668775418
GO:0016597	amino acid binding	 11	0.934420645831428	1	1	10	2212	7869	0.414575031836668
GO:0016600	flotillin complex	  7	0.475663602521461	1	2	5	2211	7874	1.3029501000581
GO:0016601	Rac protein signal transduction	 16	0.715200159590258	1	3	13	2210	7866	0.855061003163127
GO:0016605	PML body	 66	0.181612079382895	1	18	48	2195	7831	1.24372509551
GO:0016614	oxidoreductase activity, acting on CH-OH group of donors	  5	0.710033128778248	1	1	4	2212	7875	0.912065070040669
GO:0016616	oxidoreductase activity, acting on the CH-OH group of donors, NAD or NADP as acceptor	 18	0.789777202096414	1	3	15	2210	7864	0.760054225033891
GO:0016627	oxidoreductase activity, acting on the CH-CH group of donors	 19	0.625808905960736	1	4	15	2209	7864	0.960068494779651
GO:0016628	oxidoreductase activity, acting on the CH-CH group of donors, NAD or NADP as acceptor	  6	0.123915802800268	1	3	3	2210	7876	2.28016267510167
GO:0016651	oxidoreductase activity, acting on NAD(P)H	 10	1	1	0	10	2213	7869	0
GO:0016671	oxidoreductase activity, acting on a sulfur group of donors, disulfide as acceptor	  8	0.0756163732373509	1	4	4	2209	7875	2.28016267510167
GO:0016702	oxidoreductase activity, acting on single donors with incorporation of molecular oxygen, incorporation of two atoms of oxygen	  6	1	1	0	6	2213	7873	0
GO:0016705	oxidoreductase activity, acting on paired donors, with incorporation or reduction of molecular oxygen	 30	0.994436930063121	1	2	28	2211	7851	0.304021690013556
GO:0016706	oxidoreductase activity, acting on paired donors, with incorporation or reduction of molecular oxygen, 2-oxoglutarate as one donor, and incorporation of one atom each of oxygen into both donors	 16	0.715200159590258	1	3	13	2210	7866	0.855061003163127
GO:0016709	oxidoreductase activity, acting on paired donors, with incorporation or reduction of molecular oxygen, NAD(P)H as one donor, and incorporation of one atom of oxygen	  7	0.475663602521461	1	2	5	2211	7874	1.3029501000581
GO:0016712	oxidoreductase activity, acting on paired donors, with incorporation or reduction of molecular oxygen, reduced flavin or flavoprotein as one donor, and incorporation of one atom of oxygen	  8	1	1	0	8	2213	7871	0
GO:0016746	transferase activity, transferring acyl groups	 98	0.0279404595294443	1	30	68	2183	7811	1.39601796434796
GO:0016747	transferase activity, transferring acyl groups other than amino-acyl groups	 10	0.157129881410612	1	4	6	2209	7873	1.82413014008134
GO:0016758	transferase activity, transferring hexosyl groups	  7	0.475663602521461	1	2	5	2211	7874	1.3029501000581
GO:0016763	transferase activity, transferring pentosyl groups	  6	0.391952090801775	1	2	4	2211	7875	1.52010845006778
GO:0016772	transferase activity, transferring phosphorus-containing groups	  8	0.551915645208052	1	2	6	2211	7873	1.14008133755084
GO:0016773	phosphotransferase activity, alcohol group as acceptor	  8	0.551915645208052	1	2	6	2211	7873	1.14008133755084
GO:0016779	nucleotidyltransferase activity	 52	0.34633837048433	1	13	39	2200	7840	1.14008133755084
GO:0016780	phosphotransferase activity, for other substituted phosphate groups	  6	0.391952090801775	1	2	4	2211	7875	1.52010845006778
GO:0016788	hydrolase activity, acting on ester bonds	 14	0.174532180096009	1	5	9	2208	7870	1.62868762507262
GO:0016791	phosphatase activity	 82	0.435178200361869	1	19	63	2194	7816	1.05666075187638
GO:0016798	hydrolase activity, acting on glycosyl bonds	 45	0.397476283575736	1	11	34	2202	7845	1.11474619671637
GO:0016799	hydrolase activity, hydrolyzing N-glycosyl compounds	  5	0.302606661467939	1	2	3	2211	7876	1.82413014008134
GO:0016805	dipeptidase activity	  7	0.475663602521461	1	2	5	2211	7874	1.3029501000581
GO:0016810	hydrolase activity, acting on carbon-nitrogen (but not peptide) bonds	 13	0.813973253692629	1	2	11	2211	7868	0.701588515415899
GO:0016817	hydrolase activity, acting on acid anhydrides	  6	0.773649336373543	1	1	5	2212	7874	0.760054225033891
GO:0016818	hydrolase activity, acting on acid anhydrides, in phosphorus-containing anhydrides	  8	0.551915645208052	1	2	6	2211	7873	1.14008133755084
GO:0016829	lyase activity	 92	0.65690050248459	1	19	73	2194	7806	0.941806322324604
GO:0016831	carboxy-lyase activity	 14	0.621614907823308	1	3	11	2210	7868	0.977212575043574
GO:0016849	phosphorus-oxygen lyase activity	 13	0.813973253692629	1	2	11	2211	7868	0.701588515415899
GO:0016853	isomerase activity	 76	0.212264351285047	1	20	56	2193	7823	1.20008561847456
GO:0016868	intramolecular transferase activity, phosphotransferases	  7	0.475663602521461	1	2	5	2211	7874	1.3029501000581
GO:0016918	retinal binding	  6	0.773649336373543	1	1	5	2212	7874	0.760054225033891
GO:0016922	ligand-dependent nuclear receptor binding	 17	0.754769220253611	1	3	14	2210	7865	0.804763297094708
GO:0016925	protein sumoylation	 49	0.385522464311084	1	12	37	2201	7842	1.11681437147837
GO:0016926	protein desumoylation	  6	0.391952090801775	1	2	4	2211	7875	1.52010845006778
GO:0016929	SUMO-specific protease activity	  5	0.302606661467939	1	2	3	2211	7876	1.82413014008134
GO:0016973	poly(A)+ mRNA export from nucleus	  9	0.619953536302463	1	2	7	2211	7872	1.01340563337852
GO:0017015	regulation of transforming growth factor beta receptor signaling pathway	 13	0.567559963400701	1	3	10	2210	7869	1.05238277312385
GO:0017016	Ras GTPase binding	 15	0.670849711670293	1	3	12	2210	7867	0.912065070040669
GO:0017017	MAP kinase tyrosine/serine/threonine phosphatase activity	 11	0.731548842740116	1	2	9	2211	7870	0.829150063673335
GO:0017022	myosin binding	 12	0.77606351672464	1	2	10	2211	7869	0.760054225033891
GO:0017025	TBP-class protein binding	 17	0.914292249229749	1	2	15	2211	7864	0.536508864729805
GO:0017034	Rap guanyl-nucleotide exchange factor activity	  5	1	1	0	5	2213	7874	0
GO:0017046	peptide hormone binding	 11	0.731548842740116	1	2	9	2211	7870	0.829150063673335
GO:0017048	Rho GTPase binding	 25	0.830662443344484	1	4	21	2209	7858	0.729652056032535
GO:0017049	GTP-Rho binding	  9	0.619953536302463	1	2	7	2211	7872	1.01340563337852
GO:0017053	transcriptional repressor complex	 42	0.731382703584426	1	8	34	2205	7845	0.868633400038732
GO:0017056	structural constituent of nuclear pore	 11	0.731548842740116	1	2	9	2211	7870	0.829150063673335
GO:0017069	snRNA binding	  6	0.391952090801775	1	2	4	2211	7875	1.52010845006778
GO:0017070	U6 snRNA binding	  6	0.773649336373543	1	1	5	2212	7874	0.760054225033891
GO:0017075	syntaxin-1 binding	 16	0.895524834056086	1	2	14	2211	7865	0.570040668775418
GO:0017080	sodium channel regulator activity	 22	0.743498615792167	1	4	18	2209	7861	0.829150063673335
GO:0017081	chloride channel regulator activity	  5	0.302606661467939	1	2	3	2211	7876	1.82413014008134
GO:0017091	AU-rich element binding	 15	0.670849711670293	1	3	12	2210	7867	0.912065070040669
GO:0017101	aminoacyl-tRNA synthetase multienzyme complex	 11	0.446445648052706	1	3	8	2210	7871	1.24372509551
GO:0017110	nucleoside-diphosphatase activity	  6	0.773649336373543	1	1	5	2212	7874	0.760054225033891
GO:0017111	nucleoside-triphosphatase activity	  7	0.475663602521461	1	2	5	2211	7874	1.3029501000581
GO:0017112	Rab guanyl-nucleotide exchange factor activity	 41	0.704757467436148	1	8	33	2205	7846	0.889819580527482
GO:0017119	Golgi transport complex	 10	0.380920088506331	1	3	7	2210	7872	1.368097605061
GO:0017124	SH3 domain binding	 94	0.31196712031244	1	23	71	2190	7808	1.11582428781571
GO:0017127	cholesterol transporter activity	  8	0.551915645208052	1	2	6	2211	7873	1.14008133755084
GO:0017128	phospholipid scramblase activity	  5	0.710033128778248	1	1	4	2212	7875	0.912065070040669
GO:0017134	fibroblast growth factor binding	 11	0.206185263049328	1	4	7	2209	7872	1.65830012734667
GO:0017137	Rab GTPase binding	 96	0.731752382315296	1	19	77	2194	7802	0.902564392227745
GO:0017144	drug metabolic process	  8	0.862084765369009	1	1	7	2212	7872	0.570040668775418
GO:0017145	stem cell division	  5	0.073752586889371	1	3	2	2210	7877	2.73619521012201
GO:0017146	NMDA selective glutamate receptor complex	  8	0.862084765369009	1	1	7	2212	7872	0.570040668775418
GO:0017147	Wnt-protein binding	 22	0.890676450832607	1	3	19	2210	7860	0.621862547755001
GO:0017148	negative regulation of translation	 46	0.0144095939198484	1	17	29	2196	7850	1.68533762942297
GO:0017151	DEAD/H-box RNA helicase binding	  6	0.391952090801775	1	2	4	2211	7875	1.52010845006778
GO:0017154	semaphorin receptor activity	  8	1	1	0	8	2213	7871	0
GO:0017156	calcium ion regulated exocytosis	 14	0.846032978004182	1	2	12	2211	7867	0.651475050029049
GO:0017157	regulation of exocytosis	 25	0.983626289752331	1	2	23	2211	7856	0.364826028016268
GO:0017158	regulation of calcium ion-dependent exocytosis	 15	0.975670266056184	1	1	14	2212	7865	0.304021690013556
GO:0017160	Ral GTPase binding	 11	0.731548842740116	1	2	9	2211	7870	0.829150063673335
GO:0017162	aryl hydrocarbon receptor binding	  7	0.82331362534889	1	1	6	2212	7873	0.651475050029049
GO:0017166	vinculin binding	  9	0.313783026377615	1	3	6	2210	7873	1.52010845006778
GO:0017183	peptidyl-diphthamide biosynthetic process from peptidyl-histidine	  5	0.710033128778248	1	1	4	2212	7875	0.912065070040669
GO:0017187	peptidyl-glutamic acid carboxylation	  5	0.710033128778248	1	1	4	2212	7875	0.912065070040669
GO:0017196	N-terminal peptidyl-methionine acetylation	  5	0.302606661467939	1	2	3	2211	7876	1.82413014008134
GO:0018024	histone-lysine N-methyltransferase activity	 26	0.0416681048122677	1	10	16	2203	7863	1.75397128853975
GO:0018026	peptidyl-lysine monomethylation	  5	0.302606661467939	1	2	3	2211	7876	1.82413014008134
GO:0018095	protein polyglutamylation	  7	0.82331362534889	1	1	6	2212	7873	0.651475050029049
GO:0018107	peptidyl-threonine phosphorylation	 49	0.169118608425346	1	14	35	2199	7844	1.3029501000581
GO:0018146	keratan sulfate biosynthetic process	 20	0.847343512007977	1	3	17	2210	7862	0.684048802530502
GO:0018149	peptide cross-linking	  9	1	1	0	9	2213	7870	0
GO:0018230	peptidyl-L-cysteine S-palmitoylation	  5	0.302606661467939	1	2	3	2211	7876	1.82413014008134
GO:0018279	protein N-linked glycosylation via asparagine	 32	0.0328531538160317	1	12	20	2201	7859	1.71012200632625
GO:0018344	protein geranylgeranylation	  6	0.123915802800268	1	3	3	2210	7876	2.28016267510167
GO:0018345	protein palmitoylation	 11	0.0712829635428583	1	5	6	2208	7873	2.07287515918334
GO:0019001	guanyl nucleotide binding	 13	0.0454386598426596	1	6	7	2207	7872	2.1047655462477
GO:0019003	GDP binding	 48	0.755260268826758	1	9	39	2204	7840	0.855061003163127
GO:0019005	SCF ubiquitin ligase complex	 36	0.251610882835689	1	10	26	2203	7853	1.26675704172315
GO:0019013	viral nucleocapsid	 17	0.00105566703266405	0.309970232465982	10	7	2203	7872	2.68254432364903
GO:0019058	viral life cycle	 18	0.184360311948163	1	6	12	2207	7867	1.52010845006778
GO:0019064	fusion of virus membrane with host plasma membrane	  5	1	1	0	5	2213	7874	0
GO:0019068	virion assembly	  5	0.710033128778248	1	1	4	2212	7875	0.912065070040669
GO:0019076	viral release from host cell	  5	1	1	0	5	2213	7874	0
GO:0019079	viral genome replication	 10	0.380920088506331	1	3	7	2210	7872	1.368097605061
GO:0019083	viral transcription	 37	0.281925171345196	1	10	27	2203	7852	1.23252036491982
GO:0019205	nucleobase-containing compound kinase activity	  7	0.475663602521461	1	2	5	2211	7874	1.3029501000581
GO:0019206	nucleoside kinase activity	  5	1	1	0	5	2213	7874	0
GO:0019208	phosphatase regulator activity	  6	0.773649336373543	1	1	5	2212	7874	0.760054225033891
GO:0019212	phosphatase inhibitor activity	  5	0.710033128778248	1	1	4	2212	7875	0.912065070040669
GO:0019213	deacetylase activity	  5	0.302606661467939	1	2	3	2211	7876	1.82413014008134
GO:0019216	regulation of lipid metabolic process	 60	0.570285437425831	1	13	47	2200	7832	0.988070492544058
GO:0019221	cytokine-mediated signaling pathway	 82	0.99888289057424	1	8	74	2205	7805	0.444909790263741
GO:0019226	transmission of nerve impulse	 14	0.968824531635628	1	1	13	2212	7866	0.325737525014525
GO:0019227	neuronal action potential propagation	  6	0.773649336373543	1	1	5	2212	7874	0.760054225033891
GO:0019228	neuronal action potential	 15	0.670849711670293	1	3	12	2210	7867	0.912065070040669
GO:0019229	regulation of vasoconstriction	 13	0.960053706376239	1	1	12	2212	7867	0.35079425770795
GO:0019233	sensory perception of pain	 32	0.942567870161511	1	4	28	2209	7851	0.570040668775418
GO:0019239	deaminase activity	  8	0.246907474461687	1	3	5	2210	7874	1.71012200632625
GO:0019363	pyridine nucleotide biosynthetic process	  6	0.773649336373543	1	1	5	2212	7874	0.760054225033891
GO:0019367	fatty acid elongation, saturated fatty acid	  5	0.073752586889371	1	3	2	2210	7877	2.73619521012201
GO:0019369	arachidonic acid metabolic process	 10	0.679711898251496	1	2	8	2211	7871	0.912065070040669
GO:0019370	leukotriene biosynthetic process	  5	1	1	0	5	2213	7874	0
GO:0019371	cyclooxygenase pathway	  6	0.773649336373543	1	1	5	2212	7874	0.760054225033891
GO:0019373	epoxygenase P450 pathway	  8	1	1	0	8	2213	7871	0
GO:0019388	galactose catabolic process	  6	0.391952090801775	1	2	4	2211	7875	1.52010845006778
GO:0019395	fatty acid oxidation	  9	0.619953536302463	1	2	7	2211	7872	1.01340563337852
GO:0019430	removal of superoxide radicals	 11	0.731548842740116	1	2	9	2211	7870	0.829150063673335
GO:0019432	triglyceride biosynthetic process	  6	0.773649336373543	1	1	5	2212	7874	0.760054225033891
GO:0019433	triglyceride catabolic process	 12	0.9488167484775	1	1	11	2212	7868	0.380027112516945
GO:0019511	peptidyl-proline hydroxylation	  5	1	1	0	5	2213	7874	0
GO:0019531	oxalate transmembrane transporter activity	  5	0.710033128778248	1	1	4	2212	7875	0.912065070040669
GO:0019532	oxalate transport	  5	0.710033128778248	1	1	4	2212	7875	0.912065070040669
GO:0019538	protein metabolic process	  7	0.82331362534889	1	1	6	2212	7873	0.651475050029049
GO:0019674	NAD metabolic process	 10	0.0471961044586633	1	5	5	2208	7874	2.28016267510167
GO:0019706	protein-cysteine S-palmitoyltransferase activity	 19	0.101712346019139	1	7	12	2206	7867	1.68011986586439
GO:0019722	calcium-mediated signaling	 33	0.287730492198488	1	9	24	2204	7855	1.24372509551
GO:0019725	cellular homeostasis	  9	0.313783026377615	1	3	6	2210	7873	1.52010845006778
GO:0019730	antimicrobial humoral response	 19	1	1	0	19	2213	7860	0
GO:0019731	antibacterial humoral response	  8	1	1	0	8	2213	7871	0
GO:0019752	carboxylic acid metabolic process	  9	0.113156370629833	1	4	5	2209	7874	2.02681126675704
GO:0019774	proteasome core complex, beta-subunit complex	  9	0.619953536302463	1	2	7	2211	7872	1.01340563337852
GO:0019784	NEDD8-specific protease activity	  5	1	1	0	5	2213	7874	0
GO:0019787	ubiquitin-like protein transferase activity	  8	0.862084765369009	1	1	7	2212	7872	0.570040668775418
GO:0019788	NEDD8 transferase activity	  5	1	1	0	5	2213	7874	0
GO:0019789	SUMO transferase activity	  9	0.619953536302463	1	2	7	2211	7872	1.01340563337852
GO:0019825	oxygen binding	 10	1	1	0	10	2213	7869	0
GO:0019827	stem cell population maintenance	 43	0.756322999415262	1	8	35	2205	7844	0.848432623293645
GO:0019829	cation-transporting ATPase activity	  5	0.710033128778248	1	1	4	2212	7875	0.912065070040669
GO:0019835	cytolysis	 10	0.915977754641309	1	1	9	2212	7870	0.456032535020334
GO:0019838	growth factor binding	 29	0.907170755858537	1	4	25	2209	7854	0.629010393131496
GO:0019841	retinol binding	  5	0.710033128778248	1	1	4	2212	7875	0.912065070040669
GO:0019843	rRNA binding	 23	0.775798815935103	1	4	19	2209	7860	0.793100060904929
GO:0019852	L-ascorbic acid metabolic process	  7	0.475663602521461	1	2	5	2211	7874	1.3029501000581
GO:0019855	calcium channel inhibitor activity	  5	0.073752586889371	1	3	2	2210	7877	2.73619521012201
GO:0019869	chloride channel inhibitor activity	  7	0.475663602521461	1	2	5	2211	7874	1.3029501000581
GO:0019870	potassium channel inhibitor activity	  5	0.302606661467939	1	2	3	2211	7876	1.82413014008134
GO:0019882	antigen processing and presentation	 27	0.998760966158666	1	1	26	2212	7853	0.16890093889642
GO:0019886	antigen processing and presentation of exogenous peptide antigen via MHC class II	 64	0.98172514092317	1	8	56	2205	7823	0.570040668775418
GO:0019888	protein phosphatase regulator activity	 36	0.251610882835689	1	10	26	2203	7853	1.26675704172315
GO:0019894	kinesin binding	 35	0.811160108955759	1	6	29	2207	7850	0.781770060034859
GO:0019896	axonal transport of mitochondrion	  5	0.710033128778248	1	1	4	2212	7875	0.912065070040669
GO:0019897	extrinsic component of plasma membrane	 16	0.895524834056086	1	2	14	2211	7865	0.570040668775418
GO:0019898	extrinsic component of membrane	 44	0.366473724682978	1	11	33	2202	7846	1.14008133755084
GO:0019900	kinase binding	 73	0.657548619142779	1	15	58	2198	7821	0.937053154151372
GO:0019902	phosphatase binding	 29	0.16668477881703	1	9	20	2204	7859	1.41527338454587
GO:0019903	protein phosphatase binding	 48	0.856320882559595	1	8	40	2205	7839	0.760054225033891
GO:0019905	syntaxin binding	 55	0.431232901302433	1	13	42	2200	7837	1.07789508277534
GO:0019911	structural constituent of myelin sheath	  7	0.0455724578638761	1	4	3	2209	7876	2.6059002001162
GO:0019915	lipid storage	 13	0.813973253692629	1	2	11	2211	7868	0.701588515415899
GO:0019919	peptidyl-arginine methylation, to asymmetrical-dimethyl arginine	  7	0.182673311502561	1	3	4	2210	7875	1.95442515008715
GO:0019933	cAMP-mediated signaling	 19	0.990977776999059	1	1	18	2212	7861	0.240017123694913
GO:0019934	cGMP-mediated signaling	  7	0.82331362534889	1	1	6	2212	7873	0.651475050029049
GO:0019955	cytokine binding	 12	0.9488167484775	1	1	11	2212	7868	0.380027112516945
GO:0019985	translesion synthesis	 22	0.0885267873059789	1	8	14	2205	7865	1.65830012734667
GO:0019992	diacylglycerol binding	  8	0.862084765369009	1	1	7	2212	7872	0.570040668775418
GO:0020037	heme binding	 52	0.909942935754375	1	8	44	2205	7835	0.701588515415899
GO:0021510	spinal cord development	 23	0.907908096067233	1	3	20	2210	7859	0.594825045678697
GO:0021517	ventral spinal cord development	  6	0.773649336373543	1	1	5	2212	7874	0.760054225033891
GO:0021522	spinal cord motor neuron differentiation	 12	0.258856173758332	1	4	8	2209	7871	1.52010845006778
GO:0021527	spinal cord association neuron differentiation	  7	0.82331362534889	1	1	6	2212	7873	0.651475050029049
GO:0021532	neural tube patterning	  6	0.773649336373543	1	1	5	2212	7874	0.760054225033891
GO:0021537	telencephalon development	 18	0.929856630121416	1	2	16	2211	7863	0.50670281668926
GO:0021542	dentate gyrus development	 15	0.670849711670293	1	3	12	2210	7867	0.912065070040669
GO:0021549	cerebellum development	 36	0.251610882835689	1	10	26	2203	7853	1.26675704172315
GO:0021591	ventricular system development	 11	0.206185263049328	1	4	7	2209	7872	1.65830012734667
GO:0021612	facial nerve structural organization	  5	1	1	0	5	2213	7874	0
GO:0021670	lateral ventricle development	  8	0.551915645208052	1	2	6	2211	7873	1.14008133755084
GO:0021675	nerve development	  7	0.82331362534889	1	1	6	2212	7873	0.651475050029049
GO:0021680	cerebellar Purkinje cell layer development	  9	1	1	0	9	2213	7870	0
GO:0021696	cerebellar cortex morphogenesis	  5	1	1	0	5	2213	7874	0
GO:0021702	cerebellar Purkinje cell differentiation	  9	0.892351169002328	1	1	8	2212	7871	0.50670281668926
GO:0021756	striatum development	 10	0.679711898251496	1	2	8	2211	7871	0.912065070040669
GO:0021762	substantia nigra development	 35	0.96520453512915	1	4	31	2209	7848	0.521180040023239
GO:0021766	hippocampus development	 49	0.385522464311084	1	12	37	2201	7842	1.11681437147837
GO:0021772	olfactory bulb development	 15	0.975670266056184	1	1	14	2212	7865	0.304021690013556
GO:0021785	branchiomotor neuron axon guidance	  5	1	1	0	5	2213	7874	0
GO:0021794	thalamus development	  8	0.246907474461687	1	3	5	2210	7874	1.71012200632625
GO:0021795	cerebral cortex cell migration	  7	0.475663602521461	1	2	5	2211	7874	1.3029501000581
GO:0021796	cerebral cortex regionalization	  5	0.710033128778248	1	1	4	2212	7875	0.912065070040669
GO:0021799	cerebral cortex radially oriented cell migration	  7	0.82331362534889	1	1	6	2212	7873	0.651475050029049
GO:0021819	layer formation in cerebral cortex	 13	0.813973253692629	1	2	11	2211	7868	0.701588515415899
GO:0021846	cell proliferation in forebrain	  7	0.82331362534889	1	1	6	2212	7873	0.651475050029049
GO:0021854	hypothalamus development	  9	0.619953536302463	1	2	7	2211	7872	1.01340563337852
GO:0021860	pyramidal neuron development	  6	0.391952090801775	1	2	4	2211	7875	1.52010845006778
GO:0021879	forebrain neuron differentiation	  7	1	1	0	7	2213	7872	0
GO:0021895	cerebral cortex neuron differentiation	  7	1	1	0	7	2213	7872	0
GO:0021902	commitment of neuronal cell to specific neuron type in forebrain	  6	0.391952090801775	1	2	4	2211	7875	1.52010845006778
GO:0021904	dorsal/ventral neural tube patterning	 10	0.915977754641309	1	1	9	2212	7870	0.456032535020334
GO:0021915	neural tube development	 36	0.832659271646731	1	6	30	2207	7849	0.760054225033891
GO:0021942	radial glia guided migration of Purkinje cell	  5	0.710033128778248	1	1	4	2212	7875	0.912065070040669
GO:0021952	central nervous system projection neuron axonogenesis	  6	0.391952090801775	1	2	4	2211	7875	1.52010845006778
GO:0021953	central nervous system neuron differentiation	  6	0.391952090801775	1	2	4	2211	7875	1.52010845006778
GO:0021954	central nervous system neuron development	 12	0.9488167484775	1	1	11	2212	7868	0.380027112516945
GO:0021983	pituitary gland development	 17	1	1	0	17	2213	7862	0
GO:0021987	cerebral cortex development	 53	0.851596357602745	1	9	44	2204	7835	0.774394870789247
GO:0022008	neurogenesis	 42	0.443194893916263	1	10	32	2203	7847	1.08579175004842
GO:0022010	central nervous system myelination	 10	0.157129881410612	1	4	6	2209	7873	1.82413014008134
GO:0022011	myelination in peripheral nervous system	 12	0.258856173758332	1	4	8	2209	7871	1.52010845006778
GO:0022027	interkinetic nuclear migration	  5	0.302606661467939	1	2	3	2211	7876	1.82413014008134
GO:0022038	corpus callosum development	  8	0.862084765369009	1	1	7	2212	7872	0.570040668775418
GO:0022400	regulation of rhodopsin mediated signaling pathway	  8	0.246907474461687	1	3	5	2210	7874	1.71012200632625
GO:0022407	regulation of cell-cell adhesion	  6	0.773649336373543	1	1	5	2212	7874	0.760054225033891
GO:0022408	negative regulation of cell-cell adhesion	 10	0.380920088506331	1	3	7	2210	7872	1.368097605061
GO:0022409	positive regulation of cell-cell adhesion	  8	0.551915645208052	1	2	6	2211	7873	1.14008133755084
GO:0022417	protein maturation by protein folding	  9	0.619953536302463	1	2	7	2211	7872	1.01340563337852
GO:0022604	regulation of cell morphogenesis	 23	0.110753792313656	1	8	15	2205	7864	1.58620012180986
GO:0022617	extracellular matrix disassembly	 38	0.979295776749504	1	4	34	2209	7845	0.480034247389826
GO:0022624	proteasome accessory complex	 15	1	1	0	15	2213	7864	0
GO:0022625	cytosolic large ribosomal subunit	 16	0.262709457690152	1	5	11	2208	7868	1.42510167193854
GO:0022626	cytosolic ribosome	  5	1	1	0	5	2213	7874	0
GO:0022627	cytosolic small ribosomal subunit	 11	0.206185263049328	1	4	7	2209	7872	1.65830012734667
GO:0022820	potassium ion symporter activity	  5	1	1	0	5	2213	7874	0
GO:0022841	potassium ion leak channel activity	  7	0.182673311502561	1	3	4	2210	7875	1.95442515008715
GO:0022851	GABA-gated chloride ion channel activity	  5	0.710033128778248	1	1	4	2212	7875	0.912065070040669
GO:0022857	transmembrane transporter activity	 44	0.999756660711162	1	2	42	2211	7837	0.207287515918334
GO:0022891	substrate-specific transmembrane transporter activity	 10	0.915977754641309	1	1	9	2212	7870	0.456032535020334
GO:0022904	respiratory electron transport chain	 11	0.934420645831428	1	1	10	2212	7869	0.414575031836668
GO:0023014	signal transduction by protein phosphorylation	 41	0.963372306668285	1	5	36	2208	7843	0.556137237829676
GO:0023019	signal transduction involved in regulation of gene expression	  6	0.391952090801775	1	2	4	2211	7875	1.52010845006778
GO:0023026	MHC class II protein complex binding	 11	0.934420645831428	1	1	10	2212	7869	0.414575031836668
GO:0023041	neuronal signal transduction	  5	1	1	0	5	2213	7874	0
GO:0023052	signaling	  6	1	1	0	6	2213	7873	0
GO:0030001	metal ion transport	 22	0.743498615792167	1	4	18	2209	7861	0.829150063673335
GO:0030007	cellular potassium ion homeostasis	  8	1	1	0	8	2213	7871	0
GO:0030008	TRAPP complex	 11	0.731548842740116	1	2	9	2211	7870	0.829150063673335
GO:0030010	establishment of cell polarity	 23	0.0468511529165853	1	9	14	2204	7865	1.78447513703609
GO:0030014	CCR4-NOT complex	 12	0.508975472817498	1	3	9	2210	7870	1.14008133755084
GO:0030016	myofibril	 15	0.872984249747857	1	2	13	2211	7866	0.608043380027113
GO:0030017	sarcomere	 22	0.743498615792167	1	4	18	2209	7861	0.829150063673335
GO:0030018	Z disc	 73	0.54695498791054	1	16	57	2197	7822	0.99952336442813
GO:0030032	lamellipodium assembly	 21	0.501777076676569	1	5	16	2208	7863	1.08579175004842
GO:0030033	microvillus assembly	  9	0.619953536302463	1	2	7	2211	7872	1.01340563337852
GO:0030035	microspike assembly	  5	0.710033128778248	1	1	4	2212	7875	0.912065070040669
GO:0030036	actin cytoskeleton organization	 99	0.608018909734166	1	21	78	2192	7801	0.967341740952224
GO:0030041	actin filament polymerization	 18	0.579729311039596	1	4	14	2209	7865	1.01340563337852
GO:0030042	actin filament depolymerization	  6	0.123915802800268	1	3	3	2210	7876	2.28016267510167
GO:0030048	actin filament-based movement	 10	0.679711898251496	1	2	8	2211	7871	0.912065070040669
GO:0030049	muscle filament sliding	 12	0.9488167484775	1	1	11	2212	7868	0.380027112516945
GO:0030050	vesicle transport along actin filament	  6	0.391952090801775	1	2	4	2211	7875	1.52010845006778
GO:0030056	hemidesmosome	  5	0.302606661467939	1	2	3	2211	7876	1.82413014008134
GO:0030057	desmosome	 15	0.670849711670293	1	3	12	2210	7867	0.912065070040669
GO:0030071	regulation of mitotic metaphase/anaphase transition	  5	0.710033128778248	1	1	4	2212	7875	0.912065070040669
GO:0030073	insulin secretion	 20	0.262931524136111	1	6	14	2207	7865	1.368097605061
GO:0030091	protein repair	  6	0.773649336373543	1	1	5	2212	7874	0.760054225033891
GO:0030097	hemopoiesis	 53	0.056624133424497	1	17	36	2196	7843	1.46274586704636
GO:0030099	myeloid cell differentiation	 16	0.895524834056086	1	2	14	2211	7865	0.570040668775418
GO:0030100	regulation of endocytosis	 22	0.743498615792167	1	4	18	2209	7861	0.829150063673335
GO:0030101	natural killer cell activation	  6	1	1	0	6	2213	7873	0
GO:0030111	regulation of Wnt signaling pathway	 18	0.988437873742338	1	1	17	2212	7862	0.25335140834463
GO:0030117	membrane coat	 24	0.979750646601004	1	2	22	2211	7857	0.380027112516945
GO:0030118	clathrin coat	  7	1	1	0	7	2213	7872	0
GO:0030119	AP-type membrane coat adaptor complex	  5	0.073752586889371	1	3	2	2210	7877	2.73619521012201
GO:0030121	AP-1 adaptor complex	  5	0.710033128778248	1	1	4	2212	7875	0.912065070040669
GO:0030122	AP-2 adaptor complex	 12	0.9488167484775	1	1	11	2212	7868	0.380027112516945
GO:0030123	AP-3 adaptor complex	  7	0.82331362534889	1	1	6	2212	7873	0.651475050029049
GO:0030126	COPI vesicle coat	 11	1	1	0	11	2213	7868	0
GO:0030127	COPII vesicle coat	 10	0.380920088506331	1	3	7	2210	7872	1.368097605061
GO:0030130	clathrin coat of trans-Golgi network vesicle	  5	1	1	0	5	2213	7874	0
GO:0030131	clathrin adaptor complex	 13	0.960053706376239	1	1	12	2212	7867	0.35079425770795
GO:0030132	clathrin coat of coated pit	  7	0.475663602521461	1	2	5	2211	7874	1.3029501000581
GO:0030133	transport vesicle	 73	0.657548619142779	1	15	58	2198	7821	0.937053154151372
GO:0030134	COPII-coated ER to Golgi transport vesicle	 23	0.907908096067233	1	3	20	2210	7859	0.594825045678697
GO:0030136	clathrin-coated vesicle	 46	0.298444656286576	1	12	34	2201	7845	1.18965009135739
GO:0030137	COPI-coated vesicle	 11	0.731548842740116	1	2	9	2211	7870	0.829150063673335
GO:0030139	endocytic vesicle	 35	0.222497121987772	1	10	25	2203	7854	1.3029501000581
GO:0030140	trans-Golgi network transport vesicle	 11	0.446445648052706	1	3	8	2210	7871	1.24372509551
GO:0030141	secretory granule	 58	0.998025101992156	1	5	53	2208	7826	0.393131495707185
GO:0030145	manganese ion binding	 38	0.459218702472665	1	9	29	2204	7850	1.08007705662711
GO:0030148	sphingolipid biosynthetic process	 37	0.0925299836015753	1	12	25	2201	7854	1.47902443790379
GO:0030150	protein import into mitochondrial matrix	 10	0.915977754641309	1	1	9	2212	7870	0.456032535020334
GO:0030155	regulation of cell adhesion	 29	0.968771645692927	1	3	26	2210	7853	0.471757794848622
GO:0030159	receptor signaling complex scaffold activity	 14	0.621614907823308	1	3	11	2210	7868	0.977212575043574
GO:0030162	regulation of proteolysis	 15	0.670849711670293	1	3	12	2210	7867	0.912065070040669
GO:0030163	protein catabolic process	 30	0.920699322541832	1	4	26	2209	7853	0.608043380027113
GO:0030165	PDZ domain binding	 66	0.810988163971401	1	12	54	2201	7825	0.829150063673335
GO:0030166	proteoglycan biosynthetic process	  6	1	1	0	6	2213	7873	0
GO:0030168	platelet activation	 67	0.736554363387706	1	13	54	2200	7825	0.88483924705438
GO:0030169	low-density lipoprotein particle binding	  5	0.710033128778248	1	1	4	2212	7875	0.912065070040669
GO:0030170	pyridoxal phosphate binding	 29	0.293590262580069	1	8	21	2205	7858	1.25802078626299
GO:0030173	integral component of Golgi membrane	 32	0.255275651027849	1	9	23	2204	7856	1.28259150474469
GO:0030175	filopodium	 56	0.459656625884664	1	13	43	2200	7836	1.0586469562972
GO:0030176	integral component of endoplasmic reticulum membrane	 66	0.181612079382895	1	18	48	2195	7831	1.24372509551
GO:0030177	positive regulation of Wnt signaling pathway	 27	0.22495881299362	1	8	19	2205	7860	1.35120751117136
GO:0030178	negative regulation of Wnt signaling pathway	 32	0.942567870161511	1	4	28	2209	7851	0.570040668775418
GO:0030182	neuron differentiation	 78	0.90035720820557	1	13	65	2200	7814	0.760054225033891
GO:0030183	B cell differentiation	 31	0.84151041812627	1	5	26	2208	7853	0.735536346806991
GO:0030193	regulation of blood coagulation	 10	1	1	0	10	2213	7869	0
GO:0030194	positive regulation of blood coagulation	  6	0.773649336373543	1	1	5	2212	7874	0.760054225033891
GO:0030195	negative regulation of blood coagulation	  8	0.862084765369009	1	1	7	2212	7872	0.570040668775418
GO:0030199	collagen fibril organization	 26	0.85360725893065	1	4	22	2209	7857	0.701588515415899
GO:0030203	glycosaminoglycan metabolic process	 21	0.962023298212517	1	2	19	2211	7860	0.434316700019366
GO:0030204	chondroitin sulfate metabolic process	  6	1	1	0	6	2213	7873	0
GO:0030206	chondroitin sulfate biosynthetic process	 18	0.929856630121416	1	2	16	2211	7863	0.50670281668926
GO:0030207	chondroitin sulfate catabolic process	 11	0.934420645831428	1	1	10	2212	7869	0.414575031836668
GO:0030208	dermatan sulfate biosynthetic process	 12	0.77606351672464	1	2	10	2211	7869	0.760054225033891
GO:0030212	hyaluronan metabolic process	  5	1	1	0	5	2213	7874	0
GO:0030214	hyaluronan catabolic process	  9	0.619953536302463	1	2	7	2211	7872	1.01340563337852
GO:0030215	semaphorin receptor binding	 10	0.380920088506331	1	3	7	2210	7872	1.368097605061
GO:0030216	keratinocyte differentiation	 25	0.830662443344484	1	4	21	2209	7858	0.729652056032535
GO:0030217	T cell differentiation	 17	0.914292249229749	1	2	15	2211	7864	0.536508864729805
GO:0030218	erythrocyte differentiation	 28	0.767187961599886	1	5	23	2208	7856	0.814343812536311
GO:0030220	platelet formation	 13	0.813973253692629	1	2	11	2211	7868	0.701588515415899
GO:0030224	monocyte differentiation	 12	1	1	0	12	2213	7867	0
GO:0030225	macrophage differentiation	 11	0.934420645831428	1	1	10	2212	7869	0.414575031836668
GO:0030234	enzyme regulator activity	 13	0.567559963400701	1	3	10	2210	7869	1.05238277312385
GO:0030246	carbohydrate binding	 93	0.580227716162689	1	20	73	2193	7806	0.980715129075988
GO:0030247	polysaccharide binding	  6	0.773649336373543	1	1	5	2212	7874	0.760054225033891
GO:0030261	chromosome condensation	  5	0.302606661467939	1	2	3	2211	7876	1.82413014008134
GO:0030274	LIM domain binding	  6	1	1	0	6	2213	7873	0
GO:0030275	LRR domain binding	  5	0.073752586889371	1	3	2	2210	7877	2.73619521012201
GO:0030276	clathrin binding	 32	0.942567870161511	1	4	28	2209	7851	0.570040668775418
GO:0030278	regulation of ossification	  9	0.313783026377615	1	3	6	2210	7873	1.52010845006778
GO:0030279	negative regulation of ossification	 13	1	1	0	13	2213	7866	0
GO:0030282	bone mineralization	 19	0.820521257621854	1	3	16	2210	7863	0.720051371084738
GO:0030285	integral component of synaptic vesicle membrane	 15	0.670849711670293	1	3	12	2210	7867	0.912065070040669
GO:0030286	dynein complex	 22	0.03516713844378	1	9	13	2204	7866	1.865587643265
GO:0030291	protein serine/threonine kinase inhibitor activity	  7	0.475663602521461	1	2	5	2211	7874	1.3029501000581
GO:0030295	protein kinase activator activity	 20	0.262931524136111	1	6	14	2207	7865	1.368097605061
GO:0030296	protein tyrosine kinase activator activity	  6	0.773649336373543	1	1	5	2212	7874	0.760054225033891
GO:0030297	transmembrane receptor protein tyrosine kinase activator activity	  5	0.302606661467939	1	2	3	2211	7876	1.82413014008134
GO:0030301	cholesterol transport	 12	0.77606351672464	1	2	10	2211	7869	0.760054225033891
GO:0030306	ADP-ribosylation factor binding	  7	0.475663602521461	1	2	5	2211	7874	1.3029501000581
GO:0030307	positive regulation of cell growth	 46	0.904750999077418	1	7	39	2206	7840	0.693962553291813
GO:0030308	negative regulation of cell growth	 75	0.793006416593138	1	14	61	2199	7818	0.851260732037958
GO:0030314	junctional membrane complex	  6	1	1	0	6	2213	7873	0
GO:0030315	T-tubule	 27	0.22495881299362	1	8	19	2205	7860	1.35120751117136
GO:0030316	osteoclast differentiation	 15	0.670849711670293	1	3	12	2210	7867	0.912065070040669
GO:0030317	flagellated sperm motility	 21	0.305021869322218	1	6	15	2207	7864	1.3029501000581
GO:0030318	melanocyte differentiation	 15	0.872984249747857	1	2	13	2211	7866	0.608043380027113
GO:0030322	stabilization of membrane potential	  7	0.182673311502561	1	3	4	2210	7875	1.95442515008715
GO:0030323	respiratory tube development	  5	0.302606661467939	1	2	3	2211	7876	1.82413014008134
GO:0030324	lung development	 59	0.543335039759706	1	13	46	2200	7833	1.0048174500448
GO:0030325	adrenal gland development	 12	0.508975472817498	1	3	9	2210	7870	1.14008133755084
GO:0030326	embryonic limb morphogenesis	 27	0.22495881299362	1	8	19	2205	7860	1.35120751117136
GO:0030330	DNA damage response, signal transduction by p53 class mediator	 10	0.679711898251496	1	2	8	2211	7871	0.912065070040669
GO:0030331	estrogen receptor binding	 26	0.193065881098155	1	8	18	2205	7861	1.4031770308318
GO:0030332	cyclin binding	 15	0.424675692435369	1	4	11	2209	7868	1.21608676005423
GO:0030334	regulation of cell migration	 52	0.732318772105666	1	10	42	2203	7837	0.876985644269874
GO:0030336	negative regulation of cell migration	 71	0.809949170705318	1	13	58	2200	7821	0.834989148628781
GO:0030346	protein phosphatase 2B binding	  5	0.710033128778248	1	1	4	2212	7875	0.912065070040669
GO:0030368	interleukin-17 receptor activity	  5	1	1	0	5	2213	7874	0
GO:0030371	translation repressor activity	  8	0.551915645208052	1	2	6	2211	7873	1.14008133755084
GO:0030374	ligand-dependent nuclear receptor transcription coactivator activity	 39	0.646581088656118	1	8	31	2205	7848	0.935451353887865
GO:0030414	peptidase inhibitor activity	 47	0.999136382437191	1	3	44	2210	7835	0.29108459682149
GO:0030422	production of siRNA involved in RNA interference	  6	0.773649336373543	1	1	5	2212	7874	0.760054225033891
GO:0030426	growth cone	 95	0.714037252631374	1	19	76	2194	7803	0.912065070040669
GO:0030431	sleep	  8	1	1	0	8	2213	7871	0
GO:0030433	ubiquitin-dependent ERAD pathway	 54	0.0663757889329641	1	17	37	2196	7842	1.43565798061957
GO:0030449	regulation of complement activation	 24	0.922638553518794	1	3	21	2210	7858	0.570040668775418
GO:0030488	tRNA methylation	 20	0.0181052565511552	1	9	11	2204	7868	2.05214640759151
GO:0030490	maturation of SSU-rRNA	  9	0.313783026377615	1	3	6	2210	7873	1.52010845006778
GO:0030497	fatty acid elongation	  5	0.073752586889371	1	3	2	2210	7877	2.73619521012201
GO:0030500	regulation of bone mineralization	 11	0.934420645831428	1	1	10	2212	7869	0.414575031836668
GO:0030501	positive regulation of bone mineralization	 24	0.979750646601004	1	2	22	2211	7857	0.380027112516945
GO:0030502	negative regulation of bone mineralization	  9	0.619953536302463	1	2	7	2211	7872	1.01340563337852
GO:0030506	ankyrin binding	 15	0.872984249747857	1	2	13	2211	7866	0.608043380027113
GO:0030507	spectrin binding	 17	0.31005409346522	1	5	12	2208	7867	1.34127216182451
GO:0030509	BMP signaling pathway	 49	0.656654731731796	1	10	39	2203	7840	0.930678642898642
GO:0030510	regulation of BMP signaling pathway	  5	1	1	0	5	2213	7874	0
GO:0030511	positive regulation of transforming growth factor beta receptor signaling pathway	 20	0.262931524136111	1	6	14	2207	7865	1.368097605061
GO:0030512	negative regulation of transforming growth factor beta receptor signaling pathway	 43	0.756322999415262	1	8	35	2205	7844	0.848432623293645
GO:0030513	positive regulation of BMP signaling pathway	 27	0.873852824362164	1	4	23	2209	7856	0.675603755585681
GO:0030514	negative regulation of BMP signaling pathway	 30	0.670839407999931	1	6	24	2207	7855	0.912065070040669
GO:0030515	snoRNA binding	 10	0.380920088506331	1	3	7	2210	7872	1.368097605061
GO:0030516	regulation of axon extension	  8	0.551915645208052	1	2	6	2211	7873	1.14008133755084
GO:0030517	negative regulation of axon extension	 14	0.846032978004182	1	2	12	2211	7867	0.651475050029049
GO:0030518	intracellular steroid hormone receptor signaling pathway	 15	0.872984249747857	1	2	13	2211	7866	0.608043380027113
GO:0030520	intracellular estrogen receptor signaling pathway	 13	0.313693837540153	1	4	9	2209	7870	1.4031770308318
GO:0030521	androgen receptor signaling pathway	 32	0.403346264259878	1	8	24	2205	7855	1.14008133755084
GO:0030522	intracellular receptor signaling pathway	 22	0.348159144452633	1	6	16	2207	7863	1.24372509551
GO:0030532	small nuclear ribonucleoprotein complex	 12	0.100843441631321	1	5	7	2208	7872	1.90013556258473
GO:0030534	adult behavior	 23	0.224654598346874	1	7	16	2206	7863	1.38792510658363
GO:0030539	male genitalia development	  9	0.619953536302463	1	2	7	2211	7872	1.01340563337852
GO:0030544	Hsp70 protein binding	 29	0.794502461680919	1	5	24	2208	7855	0.78626299141437
GO:0030552	cAMP binding	 18	0.579729311039596	1	4	14	2209	7865	1.01340563337852
GO:0030553	cGMP binding	  6	0.123915802800268	1	3	3	2210	7876	2.28016267510167
GO:0030574	collagen catabolic process	 32	0.733712446046491	1	6	26	2207	7853	0.855061003163127
GO:0030579	ubiquitin-dependent SMAD protein catabolic process	  5	1	1	0	5	2213	7874	0
GO:0030593	neutrophil chemotaxis	 25	0.997964300506561	1	1	24	2212	7855	0.182413014008134
GO:0030594	neurotransmitter receptor activity	  5	1	1	0	5	2213	7874	0
GO:0030595	leukocyte chemotaxis	  7	0.82331362534889	1	1	6	2212	7873	0.651475050029049
GO:0030619	U1 snRNA binding	  6	0.391952090801775	1	2	4	2211	7875	1.52010845006778
GO:0030658	transport vesicle membrane	 26	0.338593647399041	1	7	19	2206	7860	1.22777990197782
GO:0030660	Golgi-associated vesicle membrane	 13	0.0117678676580869	0.921424037628202	7	6	2206	7873	2.45555980395565
GO:0030663	COPI-coated vesicle membrane	 10	1	1	0	10	2213	7869	0
GO:0030665	clathrin-coated vesicle membrane	 35	0.0637867213362776	1	12	23	2201	7856	1.56354012006972
GO:0030666	endocytic vesicle membrane	 42	0.968756818449471	1	5	37	2208	7842	0.542895875024208
GO:0030667	secretory granule membrane	 64	0.997636317271907	1	6	58	2207	7821	0.427530501581563
GO:0030669	clathrin-coated endocytic vesicle membrane	 25	0.935180750360745	1	3	22	2210	7857	0.547239042024401
GO:0030670	phagocytic vesicle membrane	 48	0.856320882559595	1	8	40	2205	7839	0.760054225033891
GO:0030672	synaptic vesicle membrane	 56	0.999299713010482	1	4	52	2209	7827	0.325737525014525
GO:0030673	axolemma	 15	0.670849711670293	1	3	12	2210	7867	0.912065070040669
GO:0030674	protein binding, bridging	 52	0.957151530064226	1	7	45	2206	7834	0.613889950988912
GO:0030676	Rac guanyl-nucleotide exchange factor activity	 11	0.446445648052706	1	3	8	2210	7871	1.24372509551
GO:0030686	90S preribosome	  7	0.82331362534889	1	1	6	2212	7873	0.651475050029049
GO:0030687	preribosome, large subunit precursor	 11	0.446445648052706	1	3	8	2210	7871	1.24372509551
GO:0030695	GTPase regulator activity	 14	0.846032978004182	1	2	12	2211	7867	0.651475050029049
GO:0030705	cytoskeleton-dependent intracellular transport	 14	0.174532180096009	1	5	9	2208	7870	1.62868762507262
GO:0030728	ovulation	  5	0.710033128778248	1	1	4	2212	7875	0.912065070040669
GO:0030742	GTP-dependent protein binding	 17	0.914292249229749	1	2	15	2211	7864	0.536508864729805
GO:0030816	positive regulation of cAMP metabolic process	  7	1	1	0	7	2213	7872	0
GO:0030818	negative regulation of cAMP biosynthetic process	 12	0.9488167484775	1	1	11	2212	7868	0.380027112516945
GO:0030819	positive regulation of cAMP biosynthetic process	 23	0.775798815935103	1	4	19	2209	7860	0.793100060904929
GO:0030828	positive regulation of cGMP biosynthetic process	  7	0.82331362534889	1	1	6	2212	7873	0.651475050029049
GO:0030833	regulation of actin filament polymerization	 12	0.9488167484775	1	1	11	2212	7868	0.380027112516945
GO:0030837	negative regulation of actin filament polymerization	 11	1	1	0	11	2213	7868	0
GO:0030838	positive regulation of actin filament polymerization	 28	0.767187961599886	1	5	23	2208	7856	0.814343812536311
GO:0030850	prostate gland development	  9	1	1	0	9	2213	7870	0
GO:0030851	granulocyte differentiation	  8	0.862084765369009	1	1	7	2212	7872	0.570040668775418
GO:0030855	epithelial cell differentiation	 39	0.646581088656118	1	8	31	2205	7848	0.935451353887865
GO:0030856	regulation of epithelial cell differentiation	  5	0.710033128778248	1	1	4	2212	7875	0.912065070040669
GO:0030857	negative regulation of epithelial cell differentiation	  7	0.82331362534889	1	1	6	2212	7873	0.651475050029049
GO:0030863	cortical cytoskeleton	 18	0.929856630121416	1	2	16	2211	7863	0.50670281668926
GO:0030864	cortical actin cytoskeleton	 29	0.16668477881703	1	9	20	2204	7859	1.41527338454587
GO:0030866	cortical actin cytoskeleton organization	 18	0.358397855587164	1	5	13	2208	7866	1.26675704172315
GO:0030867	rough endoplasmic reticulum membrane	  6	0.773649336373543	1	1	5	2212	7874	0.760054225033891
GO:0030870	Mre11 complex	  5	0.710033128778248	1	1	4	2212	7875	0.912065070040669
GO:0030877	beta-catenin destruction complex	 10	0.679711898251496	1	2	8	2211	7871	0.912065070040669
GO:0030878	thyroid gland development	  7	0.82331362534889	1	1	6	2212	7873	0.651475050029049
GO:0030879	mammary gland development	 21	0.707764107729648	1	4	17	2209	7862	0.868633400038732
GO:0030889	negative regulation of B cell proliferation	 10	0.915977754641309	1	1	9	2212	7870	0.456032535020334
GO:0030890	positive regulation of B cell proliferation	 19	0.222505526992328	1	6	13	2207	7866	1.44010274216948
GO:0030897	HOPS complex	 10	0.915977754641309	1	1	9	2212	7870	0.456032535020334
GO:0030898	actin-dependent ATPase activity	  6	0.391952090801775	1	2	4	2211	7875	1.52010845006778
GO:0030900	forebrain development	 50	0.550620642474527	1	11	39	2202	7840	1.00327157704474
GO:0030901	midbrain development	 17	0.149082331829991	1	6	11	2207	7868	1.60952659418942
GO:0030902	hindbrain development	 13	0.313693837540153	1	4	9	2209	7870	1.4031770308318
GO:0030904	retromer complex	 16	0.262709457690152	1	5	11	2208	7868	1.42510167193854
GO:0030911	TPR domain binding	  6	1	1	0	6	2213	7873	0
GO:0030913	paranodal junction assembly	  6	0.773649336373543	1	1	5	2212	7874	0.760054225033891
GO:0030914	STAGA complex	 10	0.679711898251496	1	2	8	2211	7871	0.912065070040669
GO:0030915	Smc5-Smc6 complex	  5	0.073752586889371	1	3	2	2210	7877	2.73619521012201
GO:0030948	negative regulation of vascular endothelial growth factor receptor signaling pathway	  6	0.773649336373543	1	1	5	2212	7874	0.760054225033891
GO:0030949	positive regulation of vascular endothelial growth factor receptor signaling pathway	  7	0.82331362534889	1	1	6	2212	7873	0.651475050029049
GO:0030953	astral microtubule organization	  5	1	1	0	5	2213	7874	0
GO:0030955	potassium ion binding	 10	0.380920088506331	1	3	7	2210	7872	1.368097605061
GO:0030957	Tat protein binding	  8	0.551915645208052	1	2	6	2211	7873	1.14008133755084
GO:0030968	endoplasmic reticulum unfolded protein response	 31	0.122104019372521	1	10	21	2203	7858	1.47107269361398
GO:0030970	retrograde protein transport, ER to cytosol	 11	0.0182918735576292	1	6	5	2207	7874	2.48745019102001
GO:0030971	receptor tyrosine kinase binding	 33	0.440343311319523	1	8	25	2205	7854	1.10553341823111
GO:0030983	mismatched DNA binding	  6	0.391952090801775	1	2	4	2211	7875	1.52010845006778
GO:0030991	intraciliary transport particle A	  7	0.475663602521461	1	2	5	2211	7874	1.3029501000581
GO:0030992	intraciliary transport particle B	 16	0.0423390763570133	1	7	9	2206	7870	1.99514234071396
GO:0031000	response to caffeine	  6	0.391952090801775	1	2	4	2211	7875	1.52010845006778
GO:0031005	filamin binding	  9	0.0286913764967491	1	5	4	2208	7875	2.5335140834463
GO:0031011	Ino80 complex	  9	1	1	0	9	2213	7870	0
GO:0031016	pancreas development	 16	0.895524834056086	1	2	14	2211	7865	0.570040668775418
GO:0031018	endocrine pancreas development	 17	0.985183360207843	1	1	16	2212	7863	0.268254432364903
GO:0031023	microtubule organizing center organization	  8	0.246907474461687	1	3	5	2210	7874	1.71012200632625
GO:0031032	actomyosin structure organization	 20	0.1281782003235	1	7	13	2206	7866	1.59611387257117
GO:0031045	dense core granule	 12	0.9488167484775	1	1	11	2212	7868	0.380027112516945
GO:0031047	gene silencing by RNA	 33	0.0886036269141952	1	11	22	2202	7857	1.52010845006778
GO:0031053	primary miRNA processing	  7	0.0455724578638761	1	4	3	2209	7876	2.6059002001162
GO:0031054	pre-miRNA processing	  9	0.113156370629833	1	4	5	2209	7874	2.02681126675704
GO:0031063	regulation of histone deacetylation	  5	0.710033128778248	1	1	4	2212	7875	0.912065070040669
GO:0031065	positive regulation of histone deacetylation	  9	0.313783026377615	1	3	6	2210	7873	1.52010845006778
GO:0031069	hair follicle morphogenesis	 12	0.77606351672464	1	2	10	2211	7869	0.760054225033891
GO:0031072	heat shock protein binding	 39	0.949963075080934	1	5	34	2208	7845	0.584657096179916
GO:0031076	embryonic camera-type eye development	 10	0.915977754641309	1	1	9	2212	7870	0.456032535020334
GO:0031080	nuclear pore outer ring	  8	0.551915645208052	1	2	6	2211	7873	1.14008133755084
GO:0031083	BLOC-1 complex	 12	0.258856173758332	1	4	8	2209	7871	1.52010845006778
GO:0031089	platelet dense granule lumen	  7	1	1	0	7	2213	7872	0
GO:0031090	organelle membrane	 51	0.950796526984054	1	7	44	2206	7835	0.625927008851439
GO:0031091	platelet alpha granule	  9	0.313783026377615	1	3	6	2210	7873	1.52010845006778
GO:0031092	platelet alpha granule membrane	 10	0.157129881410612	1	4	6	2209	7873	1.82413014008134
GO:0031093	platelet alpha granule lumen	 43	0.933463995796766	1	6	37	2207	7842	0.636324467470234
GO:0031095	platelet dense tubular network membrane	  7	0.82331362534889	1	1	6	2212	7873	0.651475050029049
GO:0031098	stress-activated protein kinase signaling cascade	 20	0.262931524136111	1	6	14	2207	7865	1.368097605061
GO:0031100	animal organ regeneration	 31	0.978578943808408	1	3	28	2210	7851	0.441321808084195
GO:0031102	neuron projection regeneration	  6	0.773649336373543	1	1	5	2212	7874	0.760054225033891
GO:0031103	axon regeneration	  9	0.113156370629833	1	4	5	2209	7874	2.02681126675704
GO:0031105	septin complex	  5	0.073752586889371	1	3	2	2210	7877	2.73619521012201
GO:0031110	regulation of microtubule polymerization or depolymerization	  7	0.82331362534889	1	1	6	2212	7873	0.651475050029049
GO:0031113	regulation of microtubule polymerization	  5	0.710033128778248	1	1	4	2212	7875	0.912065070040669
GO:0031115	negative regulation of microtubule polymerization	 10	0.915977754641309	1	1	9	2212	7870	0.456032535020334
GO:0031116	positive regulation of microtubule polymerization	 11	0.731548842740116	1	2	9	2211	7870	0.829150063673335
GO:0031122	cytoplasmic microtubule organization	 21	0.157705661170843	1	7	14	2206	7865	1.52010845006778
GO:0031124	mRNA 3	 41	0.00135740010182229	0.354281426575618	18	23	2195	7856	2.00209405618683
GO:0031143	pseudopodium	 10	0.380920088506331	1	3	7	2210	7872	1.368097605061
GO:0031145	anaphase-promoting complex-dependent catabolic process	 54	0.987379210884391	1	6	48	2207	7831	0.50670281668926
GO:0031146	SCF-dependent proteasomal ubiquitin-dependent protein catabolic process	 57	0.979122339004424	1	7	50	2206	7829	0.56003995528813
GO:0031167	rRNA methylation	 10	0.157129881410612	1	4	6	2209	7873	1.82413014008134
GO:0031175	neuron projection development	 96	0.80925072010059	1	18	78	2195	7801	0.855061003163127
GO:0031201	SNARE complex	 43	0.217925840597547	1	12	31	2201	7848	1.27264893494047
GO:0031209	SCAR complex	  7	1	1	0	7	2213	7872	0
GO:0031210	phosphatidylcholine binding	 12	0.100843441631321	1	5	7	2208	7872	1.90013556258473
GO:0031214	biomineral tissue development	 12	1	1	0	12	2213	7867	0
GO:0031224	intrinsic component of membrane	 12	0.77606351672464	1	2	10	2211	7869	0.760054225033891
GO:0031225	anchored component of membrane	 65	0.984176701615374	1	8	57	2205	7822	0.561270812332719
GO:0031226	intrinsic component of plasma membrane	 23	0.590072665113217	1	5	18	2208	7861	0.991375076131162
GO:0031234	extrinsic component of cytoplasmic side of plasma membrane	 48	0.490451430081519	1	11	37	2202	7842	1.0450745594216
GO:0031235	intrinsic component of the cytoplasmic side of the plasma membrane	 10	0.380920088506331	1	3	7	2210	7872	1.368097605061
GO:0031252	cell leading edge	 35	0.67344222412576	1	7	28	2206	7851	0.912065070040669
GO:0031253	cell projection membrane	  8	1	1	0	8	2213	7871	0
GO:0031256	leading edge membrane	  5	0.710033128778248	1	1	4	2212	7875	0.912065070040669
GO:0031258	lamellipodium membrane	 11	0.206185263049328	1	4	7	2209	7872	1.65830012734667
GO:0031267	small GTPase binding	 13	0.567559963400701	1	3	10	2210	7869	1.05238277312385
GO:0031274	positive regulation of pseudopodium assembly	  6	0.391952090801775	1	2	4	2211	7875	1.52010845006778
GO:0031290	retinal ganglion cell axon guidance	 12	0.508975472817498	1	3	9	2210	7870	1.14008133755084
GO:0031293	membrane protein intracellular domain proteolysis	 13	0.313693837540153	1	4	9	2209	7870	1.4031770308318
GO:0031295	T cell costimulation	 38	0.758351749702664	1	7	31	2206	7848	0.840059932932195
GO:0031297	replication fork processing	 14	0.174532180096009	1	5	9	2208	7870	1.62868762507262
GO:0031301	integral component of organelle membrane	  5	1	1	0	5	2213	7874	0
GO:0031305	integral component of mitochondrial inner membrane	 15	0.424675692435369	1	4	11	2209	7868	1.21608676005423
GO:0031307	integral component of mitochondrial outer membrane	 13	0.813973253692629	1	2	11	2211	7868	0.701588515415899
GO:0031313	extrinsic component of endosome membrane	  5	0.710033128778248	1	1	4	2212	7875	0.912065070040669
GO:0031314	extrinsic component of mitochondrial inner membrane	  5	1	1	0	5	2213	7874	0
GO:0031333	negative regulation of protein complex assembly	 16	0.478664437350441	1	4	12	2209	7867	1.14008133755084
GO:0031334	positive regulation of protein complex assembly	 18	0.929856630121416	1	2	16	2211	7863	0.50670281668926
GO:0031338	regulation of vesicle fusion	 25	0.983626289752331	1	2	23	2211	7856	0.364826028016268
GO:0031340	positive regulation of vesicle fusion	  6	0.391952090801775	1	2	4	2211	7875	1.52010845006778
GO:0031362	anchored component of external side of plasma membrane	  9	0.619953536302463	1	2	7	2211	7872	1.01340563337852
GO:0031369	translation initiation factor binding	 18	0.358397855587164	1	5	13	2208	7866	1.26675704172315
GO:0031386	protein tag	  5	0.710033128778248	1	1	4	2212	7875	0.912065070040669
GO:0031390	Ctf18 RFC-like complex	  7	0.82331362534889	1	1	6	2212	7873	0.651475050029049
GO:0031396	regulation of protein ubiquitination	 12	0.9488167484775	1	1	11	2212	7868	0.380027112516945
GO:0031397	negative regulation of protein ubiquitination	 34	0.641364935399031	1	7	27	2206	7852	0.938890513277159
GO:0031398	positive regulation of protein ubiquitination	 48	0.9884098107757	1	5	43	2208	7836	0.475033890646182
GO:0031402	sodium ion binding	  7	0.475663602521461	1	2	5	2211	7874	1.3029501000581
GO:0031404	chloride ion binding	  6	1	1	0	6	2213	7873	0
GO:0031406	carboxylic acid binding	  6	1	1	0	6	2213	7873	0
GO:0031418	L-ascorbic acid binding	 14	1	1	0	14	2213	7865	0
GO:0031419	cobalamin binding	  5	0.710033128778248	1	1	4	2212	7875	0.912065070040669
GO:0031424	keratinization	 18	1	1	0	18	2213	7861	0
GO:0031430	M band	 14	1	1	0	14	2213	7865	0
GO:0031432	titin binding	  6	0.773649336373543	1	1	5	2212	7874	0.760054225033891
GO:0031434	mitogen-activated protein kinase kinase binding	 11	0.934420645831428	1	1	10	2212	7869	0.414575031836668
GO:0031435	mitogen-activated protein kinase kinase kinase binding	 12	1	1	0	12	2213	7867	0
GO:0031442	positive regulation of mRNA 3	  5	0.302606661467939	1	2	3	2211	7876	1.82413014008134
GO:0031461	cullin-RING ubiquitin ligase complex	 10	0.679711898251496	1	2	8	2211	7871	0.912065070040669
GO:0031462	Cul2-RING ubiquitin ligase complex	  9	1	1	0	9	2213	7870	0
GO:0031463	Cul3-RING ubiquitin ligase complex	 44	0.779576176241519	1	8	36	2205	7843	0.829150063673335
GO:0031464	Cul4A-RING E3 ubiquitin ligase complex	  9	0.892351169002328	1	1	8	2212	7871	0.50670281668926
GO:0031466	Cul5-RING ubiquitin ligase complex	  5	0.302606661467939	1	2	3	2211	7876	1.82413014008134
GO:0031468	nuclear envelope reassembly	  5	0.302606661467939	1	2	3	2211	7876	1.82413014008134
GO:0031489	myosin V binding	 13	0.960053706376239	1	1	12	2212	7867	0.35079425770795
GO:0031490	chromatin DNA binding	 34	0.895095310501994	1	5	29	2208	7850	0.670636080912256
GO:0031491	nucleosome binding	 16	0.11719510586415	1	6	10	2207	7869	1.71012200632625
GO:0031492	nucleosomal DNA binding	 19	0.222505526992328	1	6	13	2207	7866	1.44010274216948
GO:0031514	motile cilium	 39	0.00559743756620029	0.674777072890282	16	23	2197	7856	1.87090270777573
GO:0031519	PcG protein complex	 15	0.217236222744526	1	5	10	2208	7869	1.52010845006778
GO:0031526	brush border membrane	 28	0.767187961599886	1	5	23	2208	7856	0.814343812536311
GO:0031527	filopodium membrane	 10	0.157129881410612	1	4	6	2209	7873	1.82413014008134
GO:0031528	microvillus membrane	 10	0.915977754641309	1	1	9	2212	7870	0.456032535020334
GO:0031529	ruffle organization	  7	1	1	0	7	2213	7872	0
GO:0031532	actin cytoskeleton reorganization	 35	0.67344222412576	1	7	28	2206	7851	0.912065070040669
GO:0031571	mitotic G1 DNA damage checkpoint	  5	1	1	0	5	2213	7874	0
GO:0031572	G2 DNA damage checkpoint	  9	0.892351169002328	1	1	8	2212	7871	0.50670281668926
GO:0031573	intra-S DNA damage checkpoint	  8	0.551915645208052	1	2	6	2211	7873	1.14008133755084
GO:0031581	hemidesmosome assembly	  5	0.302606661467939	1	2	3	2211	7876	1.82413014008134
GO:0031584	activation of phospholipase D activity	  5	0.302606661467939	1	2	3	2211	7876	1.82413014008134
GO:0031588	nucleotide-activated protein kinase complex	  9	0.0286913764967491	1	5	4	2208	7875	2.5335140834463
GO:0031589	cell-substrate adhesion	 13	0.313693837540153	1	4	9	2209	7870	1.4031770308318
GO:0031593	polyubiquitin modification-dependent protein binding	 17	0.914292249229749	1	2	15	2211	7864	0.536508864729805
GO:0031594	neuromuscular junction	 40	0.527013831960622	1	9	31	2204	7848	1.02607320379575
GO:0031595	nuclear proteasome complex	  6	1	1	0	6	2213	7873	0
GO:0031597	cytosolic proteasome complex	  7	0.82331362534889	1	1	6	2212	7873	0.651475050029049
GO:0031616	spindle pole centrosome	  8	0.862084765369009	1	1	7	2212	7872	0.570040668775418
GO:0031618	nuclear pericentric heterochromatin	  6	0.773649336373543	1	1	5	2212	7874	0.760054225033891
GO:0031623	receptor internalization	 31	0.84151041812627	1	5	26	2208	7853	0.735536346806991
GO:0031624	ubiquitin conjugating enzyme binding	 28	0.418293834832541	1	7	21	2206	7858	1.14008133755084
GO:0031629	synaptic vesicle fusion to presynaptic active zone membrane	  9	0.313783026377615	1	3	6	2210	7873	1.52010845006778
GO:0031638	zymogen activation	  5	1	1	0	5	2213	7874	0
GO:0031639	plasminogen activation	  6	1	1	0	6	2213	7873	0
GO:0031640	killing of cells of other organism	 10	1	1	0	10	2213	7869	0
GO:0031641	regulation of myelination	  9	1	1	0	9	2213	7870	0
GO:0031642	negative regulation of myelination	  5	1	1	0	5	2213	7874	0
GO:0031643	positive regulation of myelination	 11	0.446445648052706	1	3	8	2210	7871	1.24372509551
GO:0031647	regulation of protein stability	 42	0.443194893916263	1	10	32	2203	7847	1.08579175004842
GO:0031648	protein destabilization	 20	0.262931524136111	1	6	14	2207	7865	1.368097605061
GO:0031659	positive regulation of cyclin-dependent protein serine/threonine kinase activity involved in G1/S transition of mitotic cell cycle	  6	0.391952090801775	1	2	4	2211	7875	1.52010845006778
GO:0031663	lipopolysaccharide-mediated signaling pathway	 21	0.962023298212517	1	2	19	2211	7860	0.434316700019366
GO:0031666	positive regulation of lipopolysaccharide-mediated signaling pathway	  5	1	1	0	5	2213	7874	0
GO:0031667	response to nutrient levels	 33	0.985404927124626	1	3	30	2210	7849	0.414575031836668
GO:0031668	cellular response to extracellular stimulus	 17	0.530544543161278	1	4	13	2209	7866	1.07301772945961
GO:0031669	cellular response to nutrient levels	  9	0.313783026377615	1	3	6	2210	7873	1.52010845006778
GO:0031672	A band	  7	0.82331362534889	1	1	6	2212	7873	0.651475050029049
GO:0031674	I band	 13	0.567559963400701	1	3	10	2210	7869	1.05238277312385
GO:0031681	G-protein beta-subunit binding	  6	0.773649336373543	1	1	5	2212	7874	0.760054225033891
GO:0031683	G-protein beta/gamma-subunit complex binding	 16	0.11719510586415	1	6	10	2207	7869	1.71012200632625
GO:0031702	type 1 angiotensin receptor binding	  9	0.313783026377615	1	3	6	2210	7873	1.52010845006778
GO:0031748	D1 dopamine receptor binding	  6	0.391952090801775	1	2	4	2211	7875	1.52010845006778
GO:0031848	protection from non-homologous end joining at telomere	  6	0.391952090801775	1	2	4	2211	7875	1.52010845006778
GO:0031901	early endosome membrane	 90	0.615769511007267	1	19	71	2194	7808	0.962735351709595
GO:0031902	late endosome membrane	 80	0.38864993835678	1	19	61	2194	7818	1.08307727067329
GO:0031904	endosome lumen	  7	0.182673311502561	1	3	4	2210	7875	1.95442515008715
GO:0031915	positive regulation of synaptic plasticity	  7	0.475663602521461	1	2	5	2211	7874	1.3029501000581
GO:0031929	TOR signaling	 10	0.157129881410612	1	4	6	2209	7873	1.82413014008134
GO:0031932	TORC2 complex	  9	0.619953536302463	1	2	7	2211	7872	1.01340563337852
GO:0031941	filamentous actin	 17	0.31005409346522	1	5	12	2208	7867	1.34127216182451
GO:0031953	negative regulation of protein autophosphorylation	  7	1	1	0	7	2213	7872	0
GO:0031954	positive regulation of protein autophosphorylation	 14	0.621614907823308	1	3	11	2210	7868	0.977212575043574
GO:0031957	very long-chain fatty acid-CoA ligase activity	  5	1	1	0	5	2213	7874	0
GO:0031966	mitochondrial membrane	 89	0.969437076028097	1	13	76	2200	7803	0.666114938793747
GO:0031985	Golgi cisterna	  9	0.619953536302463	1	2	7	2211	7872	1.01340563337852
GO:0031994	insulin-like growth factor I binding	 10	0.157129881410612	1	4	6	2209	7873	1.82413014008134
GO:0031995	insulin-like growth factor II binding	  7	0.82331362534889	1	1	6	2212	7873	0.651475050029049
GO:0031996	thioesterase binding	  6	1	1	0	6	2213	7873	0
GO:0032000	positive regulation of fatty acid beta-oxidation	  6	0.123915802800268	1	3	3	2210	7876	2.28016267510167
GO:0032006	regulation of TOR signaling	 12	0.258856173758332	1	4	8	2209	7871	1.52010845006778
GO:0032007	negative regulation of TOR signaling	 22	0.546958821448314	1	5	17	2208	7862	1.03643757959167
GO:0032008	positive regulation of TOR signaling	 23	0.391748984254665	1	6	17	2207	7862	1.18965009135739
GO:0032012	regulation of ARF protein signal transduction	 13	0.313693837540153	1	4	9	2209	7870	1.4031770308318
GO:0032024	positive regulation of insulin secretion	 28	0.767187961599886	1	5	23	2208	7856	0.814343812536311
GO:0032026	response to magnesium ion	  7	1	1	0	7	2213	7872	0
GO:0032039	integrator complex	 10	0.380920088506331	1	3	7	2210	7872	1.368097605061
GO:0032040	small-subunit processome	 19	0.820521257621854	1	3	16	2210	7863	0.720051371084738
GO:0032041	NAD-dependent histone deacetylase activity (H3-K14 specific)	 10	0.380920088506331	1	3	7	2210	7872	1.368097605061
GO:0032045	guanyl-nucleotide exchange factor complex	 10	0.679711898251496	1	2	8	2211	7871	0.912065070040669
GO:0032049	cardiolipin biosynthetic process	  6	0.391952090801775	1	2	4	2211	7875	1.52010845006778
GO:0032050	clathrin heavy chain binding	  6	0.391952090801775	1	2	4	2211	7875	1.52010845006778
GO:0032051	clathrin light chain binding	  6	1	1	0	6	2213	7873	0
GO:0032057	negative regulation of translational initiation in response to stress	  6	1	1	0	6	2213	7873	0
GO:0032059	bleb	  5	0.302606661467939	1	2	3	2211	7876	1.82413014008134
GO:0032060	bleb assembly	  9	0.619953536302463	1	2	7	2211	7872	1.01340563337852
GO:0032088	negative regulation of NF-kappaB transcription factor activity	 35	0.811160108955759	1	6	29	2207	7850	0.781770060034859
GO:0032091	negative regulation of protein binding	 43	0.86224828224711	1	7	36	2206	7843	0.74237854538194
GO:0032092	positive regulation of protein binding	 45	0.801160370211347	1	8	37	2205	7842	0.810724506702817
GO:0032094	response to food	  9	1	1	0	9	2213	7870	0
GO:0032099	negative regulation of appetite	  5	0.710033128778248	1	1	4	2212	7875	0.912065070040669
GO:0032147	activation of protein kinase activity	 47	0.326973741327882	1	12	35	2201	7844	1.16433838728596
GO:0032148	activation of protein kinase B activity	 17	0.530544543161278	1	4	13	2209	7866	1.07301772945961
GO:0032154	cleavage furrow	 31	0.122104019372521	1	10	21	2203	7858	1.47107269361398
GO:0032182	ubiquitin-like protein binding	  5	0.302606661467939	1	2	3	2211	7876	1.82413014008134
GO:0032183	SUMO binding	  6	0.773649336373543	1	1	5	2212	7874	0.760054225033891
GO:0032201	telomere maintenance via semi-conservative replication	 16	0.895524834056086	1	2	14	2211	7865	0.570040668775418
GO:0032204	regulation of telomere maintenance	  9	0.619953536302463	1	2	7	2211	7872	1.01340563337852
GO:0032210	regulation of telomere maintenance via telomerase	  6	0.391952090801775	1	2	4	2211	7875	1.52010845006778
GO:0032211	negative regulation of telomere maintenance via telomerase	 14	0.174532180096009	1	5	9	2208	7870	1.62868762507262
GO:0032212	positive regulation of telomere maintenance via telomerase	 28	0.767187961599886	1	5	23	2208	7856	0.814343812536311
GO:0032228	regulation of synaptic transmission, GABAergic	 11	0.446445648052706	1	3	8	2210	7871	1.24372509551
GO:0032230	positive regulation of synaptic transmission, GABAergic	  7	0.82331362534889	1	1	6	2212	7873	0.651475050029049
GO:0032233	positive regulation of actin filament bundle assembly	  8	0.862084765369009	1	1	7	2212	7872	0.570040668775418
GO:0032266	phosphatidylinositol-3-phosphate binding	 23	0.110753792313656	1	8	15	2205	7864	1.58620012180986
GO:0032270	positive regulation of cellular protein metabolic process	 10	1	1	0	10	2213	7869	0
GO:0032279	asymmetric synapse	  6	1	1	0	6	2213	7873	0
GO:0032281	AMPA glutamate receptor complex	 22	0.995713841079957	1	1	21	2212	7858	0.207287515918334
GO:0032287	peripheral nervous system myelin maintenance	  7	0.82331362534889	1	1	6	2212	7873	0.651475050029049
GO:0032288	myelin assembly	  5	0.710033128778248	1	1	4	2212	7875	0.912065070040669
GO:0032330	regulation of chondrocyte differentiation	  7	1	1	0	7	2213	7872	0
GO:0032331	negative regulation of chondrocyte differentiation	 10	0.915977754641309	1	1	9	2212	7870	0.456032535020334
GO:0032332	positive regulation of chondrocyte differentiation	 12	0.77606351672464	1	2	10	2211	7869	0.760054225033891
GO:0032355	response to estradiol	 64	0.999353432528743	1	5	59	2208	7820	0.356275417984636
GO:0032391	photoreceptor connecting cilium	 25	0.478131092972125	1	6	19	2207	7860	1.0944780840488
GO:0032395	MHC class II receptor activity	  5	1	1	0	5	2213	7874	0
GO:0032402	melanosome transport	 15	0.872984249747857	1	2	13	2211	7866	0.608043380027113
GO:0032411	positive regulation of transporter activity	  5	0.302606661467939	1	2	3	2211	7876	1.82413014008134
GO:0032418	lysosome localization	 14	0.846032978004182	1	2	12	2211	7867	0.651475050029049
GO:0032420	stereocilium	 16	0.11719510586415	1	6	10	2207	7869	1.71012200632625
GO:0032432	actin filament bundle	  7	0.475663602521461	1	2	5	2211	7874	1.3029501000581
GO:0032433	filopodium tip	 12	0.77606351672464	1	2	10	2211	7869	0.760054225033891
GO:0032434	regulation of proteasomal ubiquitin-dependent protein catabolic process	  9	0.892351169002328	1	1	8	2212	7871	0.50670281668926
GO:0032435	negative regulation of proteasomal ubiquitin-dependent protein catabolic process	  9	0.892351169002328	1	1	8	2212	7871	0.50670281668926
GO:0032436	positive regulation of proteasomal ubiquitin-dependent protein catabolic process	 51	0.318672116008968	1	13	38	2200	7841	1.16243587358124
GO:0032438	melanosome organization	 15	0.670849711670293	1	3	12	2210	7867	0.912065070040669
GO:0032452	histone demethylase activity	 19	0.625808905960736	1	4	15	2209	7864	0.960068494779651
GO:0032453	histone demethylase activity (H3-K4 specific)	  5	1	1	0	5	2213	7874	0
GO:0032454	histone demethylase activity (H3-K9 specific)	  7	0.182673311502561	1	3	4	2210	7875	1.95442515008715
GO:0032456	endocytic recycling	 20	0.454930598735057	1	5	15	2208	7864	1.14008133755084
GO:0032461	positive regulation of protein oligomerization	  7	0.475663602521461	1	2	5	2211	7874	1.3029501000581
GO:0032464	positive regulation of protein homooligomerization	  6	0.123915802800268	1	3	3	2210	7876	2.28016267510167
GO:0032465	regulation of cytokinesis	 14	0.369358500517811	1	4	10	2209	7869	1.3029501000581
GO:0032467	positive regulation of cytokinesis	 16	0.715200159590258	1	3	13	2210	7866	0.855061003163127
GO:0032469	endoplasmic reticulum calcium ion homeostasis	 12	0.508975472817498	1	3	9	2210	7870	1.14008133755084
GO:0032471	negative regulation of endoplasmic reticulum calcium ion concentration	  6	0.773649336373543	1	1	5	2212	7874	0.760054225033891
GO:0032479	regulation of type I interferon production	 10	0.679711898251496	1	2	8	2211	7871	0.912065070040669
GO:0032480	negative regulation of type I interferon production	 25	0.830662443344484	1	4	21	2209	7858	0.729652056032535
GO:0032481	positive regulation of type I interferon production	 40	0.899688697652325	1	6	34	2207	7845	0.684048802530502
GO:0032486	Rap protein signal transduction	  8	0.862084765369009	1	1	7	2212	7872	0.570040668775418
GO:0032495	response to muramyl dipeptide	  8	1	1	0	8	2213	7871	0
GO:0032502	developmental process	 17	0.31005409346522	1	5	12	2208	7867	1.34127216182451
GO:0032508	DNA duplex unwinding	 26	0.193065881098155	1	8	18	2205	7861	1.4031770308318
GO:0032515	negative regulation of phosphoprotein phosphatase activity	 11	0.731548842740116	1	2	9	2211	7870	0.829150063673335
GO:0032516	positive regulation of phosphoprotein phosphatase activity	 10	0.380920088506331	1	3	7	2210	7872	1.368097605061
GO:0032525	somite rostral/caudal axis specification	  6	0.773649336373543	1	1	5	2212	7874	0.760054225033891
GO:0032526	response to retinoic acid	 26	0.99841180254083	1	1	25	2212	7854	0.175397128853975
GO:0032534	regulation of microvillus assembly	  5	0.302606661467939	1	2	3	2211	7876	1.82413014008134
GO:0032541	cortical endoplasmic reticulum	  5	0.710033128778248	1	1	4	2212	7875	0.912065070040669
GO:0032543	mitochondrial translation	 20	0.953316959911741	1	2	18	2211	7861	0.456032535020334
GO:0032570	response to progesterone	 24	0.804794893906303	1	4	20	2209	7859	0.760054225033891
GO:0032580	Golgi cisterna membrane	 48	0.356058860303625	1	12	36	2201	7843	1.14008133755084
GO:0032584	growth cone membrane	  6	1	1	0	6	2213	7873	0
GO:0032585	multivesicular body membrane	  5	1	1	0	5	2213	7874	0
GO:0032587	ruffle membrane	 63	0.526981300572113	1	14	49	2199	7830	1.01340563337852
GO:0032588	trans-Golgi network membrane	 53	0.16812171245807	1	15	38	2198	7841	1.29065811798208
GO:0032590	dendrite membrane	 14	0.846032978004182	1	2	12	2211	7867	0.651475050029049
GO:0032591	dendritic spine membrane	 11	0.446445648052706	1	3	8	2210	7871	1.24372509551
GO:0032592	integral component of mitochondrial membrane	  6	1	1	0	6	2213	7873	0
GO:0032593	insulin-responsive compartment	  5	0.710033128778248	1	1	4	2212	7875	0.912065070040669
GO:0032680	regulation of tumor necrosis factor production	  6	0.123915802800268	1	3	3	2210	7876	2.28016267510167
GO:0032688	negative regulation of interferon-beta production	  7	1	1	0	7	2213	7872	0
GO:0032689	negative regulation of interferon-gamma production	 13	0.567559963400701	1	3	10	2210	7869	1.05238277312385
GO:0032693	negative regulation of interleukin-10 production	  5	0.302606661467939	1	2	3	2211	7876	1.82413014008134
GO:0032695	negative regulation of interleukin-12 production	  6	0.773649336373543	1	1	5	2212	7874	0.760054225033891
GO:0032700	negative regulation of interleukin-17 production	  6	0.391952090801775	1	2	4	2211	7875	1.52010845006778
GO:0032703	negative regulation of interleukin-2 production	  5	0.710033128778248	1	1	4	2212	7875	0.912065070040669
GO:0032715	negative regulation of interleukin-6 production	 11	0.731548842740116	1	2	9	2211	7870	0.829150063673335
GO:0032720	negative regulation of tumor necrosis factor production	 18	0.789777202096414	1	3	15	2210	7864	0.760054225033891
GO:0032722	positive regulation of chemokine production	  9	0.313783026377615	1	3	6	2210	7873	1.52010845006778
GO:0032727	positive regulation of interferon-alpha production	 10	0.380920088506331	1	3	7	2210	7872	1.368097605061
GO:0032728	positive regulation of interferon-beta production	 22	0.0885267873059789	1	8	14	2205	7865	1.65830012734667
GO:0032729	positive regulation of interferon-gamma production	 21	0.707764107729648	1	4	17	2209	7862	0.868633400038732
GO:0032733	positive regulation of interleukin-10 production	 11	0.206185263049328	1	4	7	2209	7872	1.65830012734667
GO:0032735	positive regulation of interleukin-12 production	 11	0.446445648052706	1	3	8	2210	7871	1.24372509551
GO:0032743	positive regulation of interleukin-2 production	 12	0.508975472817498	1	3	9	2210	7870	1.14008133755084
GO:0032753	positive regulation of interleukin-4 production	  8	0.551915645208052	1	2	6	2211	7873	1.14008133755084
GO:0032755	positive regulation of interleukin-6 production	 26	0.704465957620568	1	5	21	2208	7858	0.876985644269874
GO:0032757	positive regulation of interleukin-8 production	 12	0.9488167484775	1	1	11	2212	7868	0.380027112516945
GO:0032760	positive regulation of tumor necrosis factor production	 25	0.478131092972125	1	6	19	2207	7860	1.0944780840488
GO:0032780	negative regulation of ATPase activity	  7	1	1	0	7	2213	7872	0
GO:0032781	positive regulation of ATPase activity	 27	0.378365839440938	1	7	20	2206	7859	1.18230657227494
GO:0032784	regulation of DNA-templated transcription, elongation	  9	0.113156370629833	1	4	5	2209	7874	2.02681126675704
GO:0032790	ribosome disassembly	  8	0.246907474461687	1	3	5	2210	7874	1.71012200632625
GO:0032793	positive regulation of CREB transcription factor activity	 13	0.813973253692629	1	2	11	2211	7868	0.701588515415899
GO:0032794	GTPase activating protein binding	 11	0.934420645831428	1	1	10	2212	7869	0.414575031836668
GO:0032797	SMN complex	  9	0.619953536302463	1	2	7	2211	7872	1.01340563337852
GO:0032801	receptor catabolic process	 11	1	1	0	11	2213	7868	0
GO:0032802	low-density lipoprotein particle receptor catabolic process	  9	1	1	0	9	2213	7870	0
GO:0032808	lacrimal gland development	  6	0.773649336373543	1	1	5	2212	7874	0.760054225033891
GO:0032809	neuronal cell body membrane	 19	0.942719615121364	1	2	17	2211	7862	0.480034247389826
GO:0032825	positive regulation of natural killer cell differentiation	  6	0.773649336373543	1	1	5	2212	7874	0.760054225033891
GO:0032835	glomerulus development	  5	1	1	0	5	2213	7874	0
GO:0032836	glomerular basement membrane development	  6	0.773649336373543	1	1	5	2212	7874	0.760054225033891
GO:0032839	dendrite cytoplasm	 18	0.929856630121416	1	2	16	2211	7863	0.50670281668926
GO:0032868	response to insulin	 46	0.570204983257395	1	10	36	2203	7843	0.991375076131162
GO:0032869	cellular response to insulin stimulus	 52	0.235673352582885	1	14	38	2199	7841	1.22777990197782
GO:0032870	cellular response to hormone stimulus	 28	0.96239913984799	1	3	25	2210	7854	0.488606287521787
GO:0032872	regulation of stress-activated MAPK cascade	  6	1	1	0	6	2213	7873	0
GO:0032874	positive regulation of stress-activated MAPK cascade	 14	0.846032978004182	1	2	12	2211	7867	0.651475050029049
GO:0032880	regulation of protein localization	 40	0.676472902829992	1	8	32	2205	7847	0.912065070040669
GO:0032886	regulation of microtubule-based process	  8	0.551915645208052	1	2	6	2211	7873	1.14008133755084
GO:0032897	negative regulation of viral transcription	  5	0.710033128778248	1	1	4	2212	7875	0.912065070040669
GO:0032922	circadian regulation of gene expression	 43	0.129735178078158	1	13	30	2200	7849	1.37870301285217
GO:0032924	activin receptor signaling pathway	 10	0.915977754641309	1	1	9	2212	7870	0.456032535020334
GO:0032926	negative regulation of activin receptor signaling pathway	  5	0.302606661467939	1	2	3	2211	7876	1.82413014008134
GO:0032927	positive regulation of activin receptor signaling pathway	  5	1	1	0	5	2213	7874	0
GO:0032930	positive regulation of superoxide anion generation	  7	0.82331362534889	1	1	6	2212	7873	0.651475050029049
GO:0032933	SREBP signaling pathway	  5	0.710033128778248	1	1	4	2212	7875	0.912065070040669
GO:0032940	secretion by cell	  8	1	1	0	8	2213	7871	0
GO:0032947	protein complex scaffold activity	 31	0.84151041812627	1	5	26	2208	7853	0.735536346806991
GO:0032956	regulation of actin cytoskeleton organization	 31	0.703403274729522	1	6	25	2207	7854	0.882643616168389
GO:0032963	collagen metabolic process	  8	0.862084765369009	1	1	7	2212	7872	0.570040668775418
GO:0032967	positive regulation of collagen biosynthetic process	 13	0.567559963400701	1	3	10	2210	7869	1.05238277312385
GO:0032968	positive regulation of transcription elongation from RNA polymerase II promoter	 11	0.446445648052706	1	3	8	2210	7871	1.24372509551
GO:0032981	mitochondrial respiratory chain complex I assembly	 38	0.869733087252702	1	6	32	2207	7847	0.720051371084738
GO:0032982	myosin filament	  5	1	1	0	5	2213	7874	0
GO:0032993	protein-DNA complex	 29	0.4579722441856	1	7	22	2206	7857	1.10076818798012
GO:0033010	paranodal junction	  6	0.773649336373543	1	1	5	2212	7874	0.760054225033891
GO:0033017	sarcoplasmic reticulum membrane	 26	0.85360725893065	1	4	22	2209	7857	0.701588515415899
GO:0033018	sarcoplasmic reticulum lumen	  5	0.710033128778248	1	1	4	2212	7875	0.912065070040669
GO:0033077	T cell differentiation in thymus	 18	0.0785263715936463	1	7	11	2206	7868	1.77345985841241
GO:0033089	positive regulation of T cell differentiation in thymus	  5	0.710033128778248	1	1	4	2212	7875	0.912065070040669
GO:0033093	Weibel-Palade body	  5	1	1	0	5	2213	7874	0
GO:0033116	endoplasmic reticulum-Golgi intermediate compartment membrane	 47	0.459653132840751	1	11	36	2202	7843	1.06731018834546
GO:0033120	positive regulation of RNA splicing	  7	0.182673311502561	1	3	4	2210	7875	1.95442515008715
GO:0033129	positive regulation of histone phosphorylation	  6	0.773649336373543	1	1	5	2212	7874	0.760054225033891
GO:0033130	acetylcholine receptor binding	  7	0.0455724578638761	1	4	3	2209	7876	2.6059002001162
GO:0033135	regulation of peptidyl-serine phosphorylation	  6	0.0235893709784742	1	4	2	2209	7877	3.04021690013556
GO:0033137	negative regulation of peptidyl-serine phosphorylation	 16	0.895524834056086	1	2	14	2211	7865	0.570040668775418
GO:0033138	positive regulation of peptidyl-serine phosphorylation	 56	0.945479311590349	1	8	48	2205	7831	0.651475050029049
GO:0033146	regulation of intracellular estrogen receptor signaling pathway	 10	0.157129881410612	1	4	6	2209	7873	1.82413014008134
GO:0033147	negative regulation of intracellular estrogen receptor signaling pathway	  7	0.182673311502561	1	3	4	2210	7875	1.95442515008715
GO:0033148	positive regulation of intracellular estrogen receptor signaling pathway	  5	0.302606661467939	1	2	3	2211	7876	1.82413014008134
GO:0033151	V(D)J recombination	  7	0.00710205581442276	0.725336048177351	5	2	2208	7877	3.25737525014525
GO:0033153	T cell receptor V(D)J recombination	  5	0.302606661467939	1	2	3	2211	7876	1.82413014008134
GO:0033160	positive regulation of protein import into nucleus, translocation	 10	0.380920088506331	1	3	7	2210	7872	1.368097605061
GO:0033162	melanosome membrane	  5	0.710033128778248	1	1	4	2212	7875	0.912065070040669
GO:0033169	histone H3-K9 demethylation	  8	0.246907474461687	1	3	5	2210	7874	1.71012200632625
GO:0033173	calcineurin-NFAT signaling cascade	  7	0.475663602521461	1	2	5	2211	7874	1.3029501000581
GO:0033179	proton-transporting V-type ATPase, V0 domain	  6	0.773649336373543	1	1	5	2212	7874	0.760054225033891
GO:0033180	proton-transporting V-type ATPase, V1 domain	  5	1	1	0	5	2213	7874	0
GO:0033189	response to vitamin A	  8	0.862084765369009	1	1	7	2212	7872	0.570040668775418
GO:0033197	response to vitamin E	  8	0.551915645208052	1	2	6	2211	7873	1.14008133755084
GO:0033198	response to ATP	 10	0.915977754641309	1	1	9	2212	7870	0.456032535020334
GO:0033209	tumor necrosis factor-mediated signaling pathway	 80	0.954687061151024	1	12	68	2201	7811	0.684048802530502
GO:0033210	leptin-mediated signaling pathway	  6	0.773649336373543	1	1	5	2212	7874	0.760054225033891
GO:0033234	negative regulation of protein sumoylation	  5	1	1	0	5	2213	7874	0
GO:0033256	I-kappaB/NF-kappaB complex	  5	1	1	0	5	2213	7874	0
GO:0033263	CORVET complex	  5	1	1	0	5	2213	7874	0
GO:0033268	node of Ranvier	 14	0.846032978004182	1	2	12	2211	7867	0.651475050029049
GO:0033270	paranode region of axon	 11	0.731548842740116	1	2	9	2211	7870	0.829150063673335
GO:0033276	transcription factor TFTC complex	 12	0.9488167484775	1	1	11	2212	7868	0.380027112516945
GO:0033280	response to vitamin D	  9	0.892351169002328	1	1	8	2212	7871	0.50670281668926
GO:0033290	eukaryotic 48S preinitiation complex	  6	1	1	0	6	2213	7873	0
GO:0033327	Leydig cell differentiation	  5	0.710033128778248	1	1	4	2212	7875	0.912065070040669
GO:0033344	cholesterol efflux	 13	0.567559963400701	1	3	10	2210	7869	1.05238277312385
GO:0033365	protein localization to organelle	 10	0.157129881410612	1	4	6	2209	7873	1.82413014008134
GO:0033391	chromatoid body	  7	0.182673311502561	1	3	4	2210	7875	1.95442515008715
GO:0033523	histone H2B ubiquitination	  5	0.710033128778248	1	1	4	2212	7875	0.912065070040669
GO:0033539	fatty acid beta-oxidation using acyl-CoA dehydrogenase	  9	0.619953536302463	1	2	7	2211	7872	1.01340563337852
GO:0033540	fatty acid beta-oxidation using acyl-CoA oxidase	  8	0.551915645208052	1	2	6	2211	7873	1.14008133755084
GO:0033555	multicellular organismal response to stress	  5	0.302606661467939	1	2	3	2211	7876	1.82413014008134
GO:0033558	protein deacetylase activity	  8	0.551915645208052	1	2	6	2211	7873	1.14008133755084
GO:0033564	anterior/posterior axon guidance	  5	1	1	0	5	2213	7874	0
GO:0033572	transferrin transport	 24	0.630818426079107	1	5	19	2208	7860	0.950067781292363
GO:0033574	response to testosterone	 23	0.224654598346874	1	7	16	2206	7863	1.38792510658363
GO:0033588	Elongator holoenzyme complex	  5	0.710033128778248	1	1	4	2212	7875	0.912065070040669
GO:0033598	mammary gland epithelial cell proliferation	  7	1	1	0	7	2213	7872	0
GO:0033601	positive regulation of mammary gland epithelial cell proliferation	  8	1	1	0	8	2213	7871	0
GO:0033613	activating transcription factor binding	 24	0.804794893906303	1	4	20	2209	7859	0.760054225033891
GO:0033617	mitochondrial respiratory chain complex IV assembly	 12	0.508975472817498	1	3	9	2210	7870	1.14008133755084
GO:0033619	membrane protein proteolysis	  7	0.475663602521461	1	2	5	2211	7874	1.3029501000581
GO:0033622	integrin activation	  8	0.551915645208052	1	2	6	2211	7873	1.14008133755084
GO:0033627	cell adhesion mediated by integrin	 11	0.00343229434917281	0.562694222252935	7	4	2206	7875	2.90202522285667
GO:0033628	regulation of cell adhesion mediated by integrin	  9	0.113156370629833	1	4	5	2209	7874	2.02681126675704
GO:0033630	positive regulation of cell adhesion mediated by integrin	 10	0.915977754641309	1	1	9	2212	7870	0.456032535020334
GO:0033673	negative regulation of kinase activity	  7	0.182673311502561	1	3	4	2210	7875	1.95442515008715
GO:0033674	positive regulation of kinase activity	 10	0.679711898251496	1	2	8	2211	7871	0.912065070040669
GO:0033683	nucleotide-excision repair, DNA incision	 26	0.0960735964534642	1	9	17	2204	7862	1.57857415968577
GO:0033689	negative regulation of osteoblast proliferation	  6	0.391952090801775	1	2	4	2211	7875	1.52010845006778
GO:0033690	positive regulation of osteoblast proliferation	  8	0.551915645208052	1	2	6	2211	7873	1.14008133755084
GO:0033700	phospholipid efflux	  6	0.773649336373543	1	1	5	2212	7874	0.760054225033891
GO:0033762	response to glucagon	  8	0.551915645208052	1	2	6	2211	7873	1.14008133755084
GO:0033962	cytoplasmic mRNA processing body assembly	 10	0.679711898251496	1	2	8	2211	7871	0.912065070040669
GO:0033993	response to lipid	 10	0.915977754641309	1	1	9	2212	7870	0.456032535020334
GO:0034045	pre-autophagosomal structure membrane	 13	0.567559963400701	1	3	10	2210	7869	1.05238277312385
GO:0034046	poly(G) binding	  6	0.123915802800268	1	3	3	2210	7876	2.28016267510167
GO:0034058	endosomal vesicle fusion	  8	0.551915645208052	1	2	6	2211	7873	1.14008133755084
GO:0034063	stress granule assembly	 10	0.157129881410612	1	4	6	2209	7873	1.82413014008134
GO:0034067	protein localization to Golgi apparatus	  9	0.619953536302463	1	2	7	2211	7872	1.01340563337852
GO:0034080	CENP-A containing nucleosome assembly	 13	0.567559963400701	1	3	10	2210	7869	1.05238277312385
GO:0034097	response to cytokine	 42	0.845004631553554	1	7	35	2206	7844	0.760054225033891
GO:0034098	VCP-NPL4-UFD1 AAA ATPase complex	  7	0.82331362534889	1	1	6	2212	7873	0.651475050029049
GO:0034101	erythrocyte homeostasis	  8	0.862084765369009	1	1	7	2212	7872	0.570040668775418
GO:0034113	heterotypic cell-cell adhesion	 13	0.567559963400701	1	3	10	2210	7869	1.05238277312385
GO:0034134	toll-like receptor 2 signaling pathway	  5	1	1	0	5	2213	7874	0
GO:0034138	toll-like receptor 3 signaling pathway	  5	1	1	0	5	2213	7874	0
GO:0034142	toll-like receptor 4 signaling pathway	 11	0.934420645831428	1	1	10	2212	7869	0.414575031836668
GO:0034145	positive regulation of toll-like receptor 4 signaling pathway	  5	0.710033128778248	1	1	4	2212	7875	0.912065070040669
GO:0034162	toll-like receptor 9 signaling pathway	  6	1	1	0	6	2213	7873	0
GO:0034185	apolipoprotein binding	 10	0.157129881410612	1	4	6	2209	7873	1.82413014008134
GO:0034198	cellular response to amino acid starvation	 34	0.987980486066523	1	3	31	2210	7848	0.402381648547354
GO:0034199	activation of protein kinase A activity	 14	0.621614907823308	1	3	11	2210	7868	0.977212575043574
GO:0034214	protein hexamerization	  8	0.551915645208052	1	2	6	2211	7873	1.14008133755084
GO:0034235	GPI anchor binding	  6	0.391952090801775	1	2	4	2211	7875	1.52010845006778
GO:0034236	protein kinase A catalytic subunit binding	 11	0.731548842740116	1	2	9	2211	7870	0.829150063673335
GO:0034237	protein kinase A regulatory subunit binding	 13	0.813973253692629	1	2	11	2211	7868	0.701588515415899
GO:0034244	negative regulation of transcription elongation from RNA polymerase II promoter	  6	0.391952090801775	1	2	4	2211	7875	1.52010845006778
GO:0034260	negative regulation of GTPase activity	 31	0.978578943808408	1	3	28	2210	7851	0.441321808084195
GO:0034314	Arp2/3 complex-mediated actin nucleation	  9	0.892351169002328	1	1	8	2212	7871	0.50670281668926
GO:0034329	cell junction assembly	  9	0.619953536302463	1	2	7	2211	7872	1.01340563337852
GO:0034332	adherens junction organization	 26	0.986776749649853	1	2	24	2211	7855	0.35079425770795
GO:0034333	adherens junction assembly	  9	1	1	0	9	2213	7870	0
GO:0034340	response to type I interferon	  6	0.773649336373543	1	1	5	2212	7874	0.760054225033891
GO:0034341	response to interferon-gamma	 15	0.670849711670293	1	3	12	2210	7867	0.912065070040669
GO:0034351	negative regulation of glial cell apoptotic process	  6	0.773649336373543	1	1	5	2212	7874	0.760054225033891
GO:0034356	NAD biosynthesis via nicotinamide riboside salvage pathway	 10	0.157129881410612	1	4	6	2209	7873	1.82413014008134
GO:0034361	very-low-density lipoprotein particle	 10	0.915977754641309	1	1	9	2212	7870	0.456032535020334
GO:0034362	low-density lipoprotein particle	  6	0.391952090801775	1	2	4	2211	7875	1.52010845006778
GO:0034364	high-density lipoprotein particle	  8	0.862084765369009	1	1	7	2212	7872	0.570040668775418
GO:0034375	high-density lipoprotein particle remodeling	  8	0.862084765369009	1	1	7	2212	7872	0.570040668775418
GO:0034380	high-density lipoprotein particle assembly	  7	0.82331362534889	1	1	6	2212	7873	0.651475050029049
GO:0034383	low-density lipoprotein particle clearance	 17	0.914292249229749	1	2	15	2211	7864	0.536508864729805
GO:0034389	lipid particle organization	 12	0.77606351672464	1	2	10	2211	7869	0.760054225033891
GO:0034394	protein localization to cell surface	 17	0.31005409346522	1	5	12	2208	7867	1.34127216182451
GO:0034399	nuclear periphery	 15	0.424675692435369	1	4	11	2209	7868	1.21608676005423
GO:0034405	response to fluid shear stress	  7	0.82331362534889	1	1	6	2212	7873	0.651475050029049
GO:0034427	nuclear-transcribed mRNA catabolic process, exonucleolytic, 3	  8	0.862084765369009	1	1	7	2212	7872	0.570040668775418
GO:0034446	substrate adhesion-dependent cell spreading	 26	0.51999232664405	1	6	20	2207	7859	1.05238277312385
GO:0034450	ubiquitin-ubiquitin ligase activity	 10	0.915977754641309	1	1	9	2212	7870	0.456032535020334
GO:0034451	centriolar satellite	 16	0.0123504655161619	0.93584656443433	8	8	2205	7871	2.28016267510167
GO:0034452	dynactin binding	  7	0.182673311502561	1	3	4	2210	7875	1.95442515008715
GO:0034453	microtubule anchoring	 11	0.446445648052706	1	3	8	2210	7871	1.24372509551
GO:0034454	microtubule anchoring at centrosome	  6	0.391952090801775	1	2	4	2211	7875	1.52010845006778
GO:0034464	BBSome	  7	0.475663602521461	1	2	5	2211	7874	1.3029501000581
GO:0034475	U4 snRNA 3	  7	0.82331362534889	1	1	6	2212	7873	0.651475050029049
GO:0034497	protein localization to pre-autophagosomal structure	 10	0.679711898251496	1	2	8	2211	7871	0.912065070040669
GO:0034498	early endosome to Golgi transport	  6	0.773649336373543	1	1	5	2212	7874	0.760054225033891
GO:0034504	protein localization to nucleus	 26	0.945820770982062	1	3	23	2210	7856	0.526191386561924
GO:0034551	mitochondrial respiratory chain complex III assembly	  8	0.551915645208052	1	2	6	2211	7873	1.14008133755084
GO:0034587	piRNA metabolic process	  5	1	1	0	5	2213	7874	0
GO:0034599	cellular response to oxidative stress	 59	0.666185262287753	1	12	47	2201	7832	0.927523800041358
GO:0034604	pyruvate dehydrogenase (NAD+) activity	  5	1	1	0	5	2213	7874	0
GO:0034605	cellular response to heat	 29	0.293590262580069	1	8	21	2205	7858	1.25802078626299
GO:0034612	response to tumor necrosis factor	 21	0.0691232786288158	1	8	13	2205	7866	1.73726680007746
GO:0034613	cellular protein localization	 34	0.958790818058356	1	4	30	2209	7849	0.536508864729805
GO:0034614	cellular response to reactive oxygen species	 22	0.890676450832607	1	3	19	2210	7860	0.621862547755001
GO:0034616	response to laminar fluid shear stress	  7	0.475663602521461	1	2	5	2211	7874	1.3029501000581
GO:0034620	cellular response to unfolded protein	  5	1	1	0	5	2213	7874	0
GO:0034625	fatty acid elongation, monounsaturated fatty acid	  5	0.073752586889371	1	3	2	2210	7877	2.73619521012201
GO:0034626	fatty acid elongation, polyunsaturated fatty acid	  5	0.073752586889371	1	3	2	2210	7877	2.73619521012201
GO:0034629	cellular protein complex localization	  8	0.862084765369009	1	1	7	2212	7872	0.570040668775418
GO:0034641	cellular nitrogen compound metabolic process	 14	0.846032978004182	1	2	12	2211	7867	0.651475050029049
GO:0034644	cellular response to UV	 30	0.819235072417117	1	5	25	2208	7854	0.760054225033891
GO:0034656	nucleobase-containing small molecule catabolic process	  9	0.313783026377615	1	3	6	2210	7873	1.52010845006778
GO:0034663	endoplasmic reticulum chaperone complex	  8	0.551915645208052	1	2	6	2211	7873	1.14008133755084
GO:0034704	calcium channel complex	 10	0.679711898251496	1	2	8	2211	7871	0.912065070040669
GO:0034705	potassium channel complex	  5	1	1	0	5	2213	7874	0
GO:0034706	sodium channel complex	  5	1	1	0	5	2213	7874	0
GO:0034707	chloride channel complex	 25	0.478131092972125	1	6	19	2207	7860	1.0944780840488
GO:0034709	methylosome	  5	0.710033128778248	1	1	4	2212	7875	0.912065070040669
GO:0034713	type I transforming growth factor beta receptor binding	  9	0.892351169002328	1	1	8	2212	7871	0.50670281668926
GO:0034719	SMN-Sm protein complex	  9	0.619953536302463	1	2	7	2211	7872	1.01340563337852
GO:0034720	histone H3-K4 demethylation	  7	0.82331362534889	1	1	6	2212	7873	0.651475050029049
GO:0034755	iron ion transmembrane transport	  5	0.710033128778248	1	1	4	2212	7875	0.912065070040669
GO:0034765	regulation of ion transmembrane transport	 99	0.939526511785559	1	16	83	2197	7796	0.737022278820742
GO:0034774	secretory granule lumen	 83	0.984377586130253	1	11	72	2202	7807	0.604380468099238
GO:0034968	histone lysine methylation	 19	0.101712346019139	1	7	12	2206	7867	1.68011986586439
GO:0034969	histone arginine methylation	  5	0.302606661467939	1	2	3	2211	7876	1.82413014008134
GO:0034975	protein folding in endoplasmic reticulum	 13	0.0454386598426596	1	6	7	2207	7872	2.1047655462477
GO:0034976	response to endoplasmic reticulum stress	 52	0.235673352582885	1	14	38	2199	7841	1.22777990197782
GO:0034983	peptidyl-lysine deacetylation	  6	0.391952090801775	1	2	4	2211	7875	1.52010845006778
GO:0035019	somatic stem cell population maintenance	 42	0.591600213805964	1	9	33	2204	7846	0.977212575043574
GO:0035023	regulation of Rho protein signal transduction	 50	0.415188651151613	1	12	38	2201	7841	1.0944780840488
GO:0035024	negative regulation of Rho protein signal transduction	 15	0.670849711670293	1	3	12	2210	7867	0.912065070040669
GO:0035025	positive regulation of Rho protein signal transduction	 11	0.206185263049328	1	4	7	2209	7872	1.65830012734667
GO:0035035	histone acetyltransferase binding	 21	0.707764107729648	1	4	17	2209	7862	0.868633400038732
GO:0035050	embryonic heart tube development	 10	1	1	0	10	2213	7869	0
GO:0035064	methylated histone binding	 30	0.497034174054913	1	7	23	2206	7856	1.06407591504745
GO:0035065	regulation of histone acetylation	  5	0.710033128778248	1	1	4	2212	7875	0.912065070040669
GO:0035066	positive regulation of histone acetylation	 10	0.679711898251496	1	2	8	2211	7871	0.912065070040669
GO:0035067	negative regulation of histone acetylation	  8	0.862084765369009	1	1	7	2212	7872	0.570040668775418
GO:0035068	micro-ribonucleoprotein complex	  6	0.0235893709784742	1	4	2	2209	7877	3.04021690013556
GO:0035082	axoneme assembly	  6	0.773649336373543	1	1	5	2212	7874	0.760054225033891
GO:0035091	phosphatidylinositol binding	 66	0.116523396095784	1	19	47	2194	7832	1.31282093414945
GO:0035094	response to nicotine	 21	0.707764107729648	1	4	17	2209	7862	0.868633400038732
GO:0035097	histone methyltransferase complex	 16	0.895524834056086	1	2	14	2211	7865	0.570040668775418
GO:0035098	ESC/E(Z) complex	 11	0.446445648052706	1	3	8	2210	7871	1.24372509551
GO:0035108	limb morphogenesis	 13	0.813973253692629	1	2	11	2211	7868	0.701588515415899
GO:0035115	embryonic forelimb morphogenesis	 16	0.715200159590258	1	3	13	2210	7866	0.855061003163127
GO:0035116	embryonic hindlimb morphogenesis	 17	0.754769220253611	1	3	14	2210	7865	0.804763297094708
GO:0035136	forelimb morphogenesis	  6	0.0235893709784742	1	4	2	2209	7877	3.04021690013556
GO:0035137	hindlimb morphogenesis	  5	0.302606661467939	1	2	3	2211	7876	1.82413014008134
GO:0035145	exon-exon junction complex	 16	0.0123504655161619	0.93584656443433	8	8	2205	7871	2.28016267510167
GO:0035148	tube formation	  8	0.551915645208052	1	2	6	2211	7873	1.14008133755084
GO:0035162	embryonic hemopoiesis	 10	0.679711898251496	1	2	8	2211	7871	0.912065070040669
GO:0035176	social behavior	 33	0.761753729881513	1	6	27	2207	7852	0.829150063673335
GO:0035194	posttranscriptional gene silencing by RNA	  7	0.00710205581442276	0.725336048177351	5	2	2208	7877	3.25737525014525
GO:0035195	gene silencing by miRNA	  9	0.619953536302463	1	2	7	2211	7872	1.01340563337852
GO:0035196	production of miRNAs involved in gene silencing by miRNA	  8	0.246907474461687	1	3	5	2210	7874	1.71012200632625
GO:0035197	siRNA binding	  5	0.073752586889371	1	3	2	2210	7877	2.73619521012201
GO:0035198	miRNA binding	  9	0.113156370629833	1	4	5	2209	7874	2.02681126675704
GO:0035235	ionotropic glutamate receptor signaling pathway	 17	0.985183360207843	1	1	16	2212	7863	0.268254432364903
GO:0035242	protein-arginine omega-N asymmetric methyltransferase activity	  7	0.182673311502561	1	3	4	2210	7875	1.95442515008715
GO:0035246	peptidyl-arginine N-methylation	  8	0.0155285424904012	1	5	3	2208	7876	2.85020334387709
GO:0035249	synaptic transmission, glutamatergic	 15	0.872984249747857	1	2	13	2211	7866	0.608043380027113
GO:0035253	ciliary rootlet	  6	0.123915802800268	1	3	3	2210	7876	2.28016267510167
GO:0035254	glutamate receptor binding	  6	1	1	0	6	2213	7873	0
GO:0035255	ionotropic glutamate receptor binding	 18	0.358397855587164	1	5	13	2208	7866	1.26675704172315
GO:0035257	nuclear hormone receptor binding	 19	0.820521257621854	1	3	16	2210	7863	0.720051371084738
GO:0035259	glucocorticoid receptor binding	 13	0.813973253692629	1	2	11	2211	7868	0.701588515415899
GO:0035264	multicellular organism growth	 58	0.116339194778387	1	17	41	2196	7838	1.33664708540443
GO:0035265	organ growth	  7	0.0455724578638761	1	4	3	2209	7876	2.6059002001162
GO:0035267	NuA4 histone acetyltransferase complex	 13	1	1	0	13	2213	7866	0
GO:0035269	protein O-linked mannosylation	  8	0.551915645208052	1	2	6	2211	7873	1.14008133755084
GO:0035278	miRNA mediated inhibition of translation	  9	0.0286913764967491	1	5	4	2208	7875	2.5335140834463
GO:0035280	miRNA loading onto RISC involved in gene silencing by miRNA	  6	0.123915802800268	1	3	3	2210	7876	2.28016267510167
GO:0035307	positive regulation of protein dephosphorylation	 14	0.968824531635628	1	1	13	2212	7866	0.325737525014525
GO:0035308	negative regulation of protein dephosphorylation	  8	1	1	0	8	2213	7871	0
GO:0035313	wound healing, spreading of epidermal cells	  5	0.302606661467939	1	2	3	2211	7876	1.82413014008134
GO:0035326	enhancer binding	 10	0.380920088506331	1	3	7	2210	7872	1.368097605061
GO:0035327	transcriptionally active chromatin	 16	0.262709457690152	1	5	11	2208	7868	1.42510167193854
GO:0035329	hippo signaling	 21	0.994506756619528	1	1	20	2212	7859	0.217158350009683
GO:0035331	negative regulation of hippo signaling	  7	0.475663602521461	1	2	5	2211	7874	1.3029501000581
GO:0035335	peptidyl-tyrosine dephosphorylation	 76	0.809286822189112	1	14	62	2199	7817	0.840059932932195
GO:0035338	long-chain fatty-acyl-CoA biosynthetic process	 13	0.0454386598426596	1	6	7	2207	7872	2.1047655462477
GO:0035357	peroxisome proliferator activated receptor signaling pathway	  5	1	1	0	5	2213	7874	0
GO:0035360	positive regulation of peroxisome proliferator activated receptor signaling pathway	  5	0.710033128778248	1	1	4	2212	7875	0.912065070040669
GO:0035371	microtubule plus-end	 11	0.446445648052706	1	3	8	2210	7871	1.24372509551
GO:0035372	protein localization to microtubule	  5	1	1	0	5	2213	7874	0
GO:0035374	chondroitin sulfate binding	  6	1	1	0	6	2213	7873	0
GO:0035385	Roundabout signaling pathway	  7	0.82331362534889	1	1	6	2212	7873	0.651475050029049
GO:0035413	positive regulation of catenin import into nucleus	  8	0.862084765369009	1	1	7	2212	7872	0.570040668775418
GO:0035414	negative regulation of catenin import into nucleus	  9	1	1	0	9	2213	7870	0
GO:0035418	protein localization to synapse	 12	0.9488167484775	1	1	11	2212	7868	0.380027112516945
GO:0035435	phosphate ion transmembrane transport	  9	1	1	0	9	2213	7870	0
GO:0035455	response to interferon-alpha	  8	0.862084765369009	1	1	7	2212	7872	0.570040668775418
GO:0035456	response to interferon-beta	  7	0.82331362534889	1	1	6	2212	7873	0.651475050029049
GO:0035457	cellular response to interferon-alpha	  6	0.123915802800268	1	3	3	2210	7876	2.28016267510167
GO:0035458	cellular response to interferon-beta	  7	0.182673311502561	1	3	4	2210	7875	1.95442515008715
GO:0035459	cargo loading into vesicle	  5	0.073752586889371	1	3	2	2210	7877	2.73619521012201
GO:0035493	SNARE complex assembly	  7	0.475663602521461	1	2	5	2211	7874	1.3029501000581
GO:0035497	cAMP response element binding	  8	0.862084765369009	1	1	7	2212	7872	0.570040668775418
GO:0035518	histone H2A monoubiquitination	  9	0.892351169002328	1	1	8	2212	7871	0.50670281668926
GO:0035520	monoubiquitinated protein deubiquitination	  6	0.0235893709784742	1	4	2	2209	7877	3.04021690013556
GO:0035542	regulation of SNARE complex assembly	  6	1	1	0	6	2213	7873	0
GO:0035562	negative regulation of chromatin binding	  6	0.0235893709784742	1	4	2	2209	7877	3.04021690013556
GO:0035563	positive regulation of chromatin binding	  6	1	1	0	6	2213	7873	0
GO:0035567	non-canonical Wnt signaling pathway	 15	0.975670266056184	1	1	14	2212	7865	0.304021690013556
GO:0035577	azurophil granule membrane	 37	0.975338700736277	1	4	33	2209	7846	0.493008145967929
GO:0035578	azurophil granule lumen	 60	0.933059480920486	1	9	51	2204	7828	0.684048802530502
GO:0035579	specific granule membrane	 58	0.515836241823425	1	13	45	2200	7834	1.02214188883868
GO:0035580	specific granule lumen	 34	0.987980486066523	1	3	31	2210	7848	0.402381648547354
GO:0035584	calcium-mediated signaling using intracellular calcium source	 10	0.679711898251496	1	2	8	2211	7871	0.912065070040669
GO:0035589	G-protein coupled purinergic nucleotide receptor signaling pathway	  5	1	1	0	5	2213	7874	0
GO:0035591	signaling adaptor activity	 10	0.380920088506331	1	3	7	2210	7872	1.368097605061
GO:0035612	AP-2 adaptor complex binding	  6	0.773649336373543	1	1	5	2212	7874	0.760054225033891
GO:0035613	RNA stem-loop binding	  8	0.246907474461687	1	3	5	2210	7874	1.71012200632625
GO:0035615	clathrin adaptor activity	 10	0.679711898251496	1	2	8	2211	7871	0.912065070040669
GO:0035631	CD40 receptor complex	  7	0.475663602521461	1	2	5	2211	7874	1.3029501000581
GO:0035635	entry of bacterium into host cell	  7	0.82331362534889	1	1	6	2212	7873	0.651475050029049
GO:0035640	exploration behavior	 11	0.446445648052706	1	3	8	2210	7871	1.24372509551
GO:0035641	locomotory exploration behavior	 12	1	1	0	12	2213	7867	0
GO:0035646	endosome to melanosome transport	  5	1	1	0	5	2213	7874	0
GO:0035666	TRIF-dependent toll-like receptor signaling pathway	 18	0.184360311948163	1	6	12	2207	7867	1.52010845006778
GO:0035690	cellular response to drug	 42	0.731382703584426	1	8	34	2205	7845	0.868633400038732
GO:0035721	intraciliary retrograde transport	 10	0.157129881410612	1	4	6	2209	7873	1.82413014008134
GO:0035722	interleukin-12-mediated signaling pathway	 37	0.731974947087403	1	7	30	2206	7849	0.862764255443876
GO:0035725	sodium ion transmembrane transport	 48	0.926392673555478	1	7	41	2206	7838	0.665047446904654
GO:0035729	cellular response to hepatocyte growth factor stimulus	 10	0.679711898251496	1	2	8	2211	7871	0.912065070040669
GO:0035735	intraciliary transport involved in cilium assembly	 34	0.00100338654795554	0.309970232465982	16	18	2197	7861	2.14603545891922
GO:0035748	myelin sheath abaxonal region	  5	1	1	0	5	2213	7874	0
GO:0035749	myelin sheath adaxonal region	  6	0.773649336373543	1	1	5	2212	7874	0.760054225033891
GO:0035767	endothelial cell chemotaxis	  7	0.82331362534889	1	1	6	2212	7873	0.651475050029049
GO:0035770	ribonucleoprotein granule	  8	0.862084765369009	1	1	7	2212	7872	0.570040668775418
GO:0035773	insulin secretion involved in cellular response to glucose stimulus	  7	0.475663602521461	1	2	5	2211	7874	1.3029501000581
GO:0035774	positive regulation of insulin secretion involved in cellular response to glucose stimulus	 18	0.988437873742338	1	1	17	2212	7862	0.25335140834463
GO:0035815	positive regulation of renal sodium excretion	  6	0.773649336373543	1	1	5	2212	7874	0.760054225033891
GO:0035845	photoreceptor cell outer segment organization	  7	0.475663602521461	1	2	5	2211	7874	1.3029501000581
GO:0035855	megakaryocyte development	 14	0.846032978004182	1	2	12	2211	7867	0.651475050029049
GO:0035861	site of double-strand break	 18	0.184360311948163	1	6	12	2207	7867	1.52010845006778
GO:0035865	cellular response to potassium ion	  6	0.773649336373543	1	1	5	2212	7874	0.760054225033891
GO:0035869	ciliary transition zone	 22	0.348159144452633	1	6	16	2207	7863	1.24372509551
GO:0035871	protein K11-linked deubiquitination	  6	1	1	0	6	2213	7873	0
GO:0035897	proteolysis in other organism	  5	1	1	0	5	2213	7874	0
GO:0035900	response to isolation stress	  7	1	1	0	7	2213	7872	0
GO:0035902	response to immobilization stress	 14	0.846032978004182	1	2	12	2211	7867	0.651475050029049
GO:0035904	aorta development	 10	0.679711898251496	1	2	8	2211	7871	0.912065070040669
GO:0035909	aorta morphogenesis	  9	1	1	0	9	2213	7870	0
GO:0035912	dorsal aorta morphogenesis	  7	1	1	0	7	2213	7872	0
GO:0035914	skeletal muscle cell differentiation	 29	0.968771645692927	1	3	26	2210	7853	0.471757794848622
GO:0035924	cellular response to vascular endothelial growth factor stimulus	 20	1	1	0	20	2213	7859	0
GO:0035925	mRNA 3	  8	0.551915645208052	1	2	6	2211	7873	1.14008133755084
GO:0035970	peptidyl-threonine dephosphorylation	 10	0.679711898251496	1	2	8	2211	7871	0.912065070040669
GO:0035987	endodermal cell differentiation	 15	0.872984249747857	1	2	13	2211	7866	0.608043380027113
GO:0035988	chondrocyte proliferation	  6	1	1	0	6	2213	7873	0
GO:0035994	response to muscle stretch	 13	0.960053706376239	1	1	12	2212	7867	0.35079425770795
GO:0035999	tetrahydrofolate interconversion	  6	0.123915802800268	1	3	3	2210	7876	2.28016267510167
GO:0036002	pre-mRNA binding	 11	0.00343229434917281	0.562694222252935	7	4	2206	7875	2.90202522285667
GO:0036006	cellular response to macrophage colony-stimulating factor stimulus	  5	1	1	0	5	2213	7874	0
GO:0036020	endolysosome membrane	  8	1	1	0	8	2213	7871	0
GO:0036038	MKS complex	 10	0.380920088506331	1	3	7	2210	7872	1.368097605061
GO:0036057	slit diaphragm	  5	0.710033128778248	1	1	4	2212	7875	0.912065070040669
GO:0036064	ciliary basal body	 75	0.00367457130651041	0.57543786659953	27	48	2186	7831	1.6417171260732
GO:0036065	fucosylation	  6	0.391952090801775	1	2	4	2211	7875	1.52010845006778
GO:0036066	protein O-linked fucosylation	  5	0.710033128778248	1	1	4	2212	7875	0.912065070040669
GO:0036092	phosphatidylinositol-3-phosphate biosynthetic process	 26	0.00517969901686031	0.674777072890282	12	14	2201	7865	2.1047655462477
GO:0036109	alpha-linolenic acid metabolic process	 10	0.157129881410612	1	4	6	2209	7873	1.82413014008134
GO:0036120	cellular response to platelet-derived growth factor stimulus	 14	0.621614907823308	1	3	11	2210	7868	0.977212575043574
GO:0036122	BMP binding	  7	0.82331362534889	1	1	6	2212	7873	0.651475050029049
GO:0036126	sperm flagellum	 12	0.100843441631321	1	5	7	2208	7872	1.90013556258473
GO:0036148	phosphatidylglycerol acyl-chain remodeling	  8	0.551915645208052	1	2	6	2211	7873	1.14008133755084
GO:0036149	phosphatidylinositol acyl-chain remodeling	  8	0.246907474461687	1	3	5	2210	7874	1.71012200632625
GO:0036150	phosphatidylserine acyl-chain remodeling	 11	0.731548842740116	1	2	9	2211	7870	0.829150063673335
GO:0036151	phosphatidylcholine acyl-chain remodeling	 14	0.0651620805250405	1	6	8	2207	7871	1.95442515008715
GO:0036152	phosphatidylethanolamine acyl-chain remodeling	 12	0.100843441631321	1	5	7	2208	7872	1.90013556258473
GO:0036158	outer dynein arm assembly	  5	0.302606661467939	1	2	3	2211	7876	1.82413014008134
GO:0036159	inner dynein arm assembly	  5	0.073752586889371	1	3	2	2210	7877	2.73619521012201
GO:0036258	multivesicular body assembly	 20	0.454930598735057	1	5	15	2208	7864	1.14008133755084
GO:0036295	cellular response to increased oxygen levels	  5	0.710033128778248	1	1	4	2212	7875	0.912065070040669
GO:0036297	interstrand cross-link repair	 28	0.767187961599886	1	5	23	2208	7856	0.814343812536311
GO:0036312	phosphatidylinositol 3-kinase regulatory subunit binding	  6	0.773649336373543	1	1	5	2212	7874	0.760054225033891
GO:0036342	post-anal tail morphogenesis	 12	0.9488167484775	1	1	11	2212	7868	0.380027112516945
GO:0036376	sodium ion export from cell	  5	1	1	0	5	2213	7874	0
GO:0036402	proteasome-activating ATPase activity	  5	1	1	0	5	2213	7874	0
GO:0036444	mitochondrial calcium uptake	  5	0.710033128778248	1	1	4	2212	7875	0.912065070040669
GO:0036459	thiol-dependent ubiquitinyl hydrolase activity	 71	0.0811540817316033	1	21	50	2192	7829	1.34882862470803
GO:0036464	cytoplasmic ribonucleoprotein granule	 15	0.670849711670293	1	3	12	2210	7867	0.912065070040669
GO:0036465	synaptic vesicle recycling	  5	0.710033128778248	1	1	4	2212	7875	0.912065070040669
GO:0036477	somatodendritic compartment	  7	0.0455724578638761	1	4	3	2209	7876	2.6059002001162
GO:0036498	IRE1-mediated unfolded protein response	 41	0.826067643558699	1	7	34	2206	7845	0.778592132961547
GO:0036499	PERK-mediated unfolded protein response	  7	1	1	0	7	2213	7872	0
GO:0036500	ATF6-mediated unfolded protein response	  6	0.123915802800268	1	3	3	2210	7876	2.28016267510167
GO:0036503	ERAD pathway	 10	0.380920088506331	1	3	7	2210	7872	1.368097605061
GO:0036513	Derlin-1 retrotranslocation complex	  9	0.0286913764967491	1	5	4	2208	7875	2.5335140834463
GO:0038007	netrin-activated signaling pathway	  5	0.302606661467939	1	2	3	2211	7876	1.82413014008134
GO:0038033	positive regulation of endothelial cell chemotaxis by VEGF-activated vascular endothelial growth factor receptor signaling pathway	  5	1	1	0	5	2213	7874	0
GO:0038036	sphingosine-1-phosphate receptor activity	  8	1	1	0	8	2213	7871	0
GO:0038061	NIK/NF-kappaB signaling	 52	0.994200150512276	1	5	47	2208	7832	0.438492822134937
GO:0038063	collagen-activated tyrosine kinase receptor signaling pathway	  8	0.862084765369009	1	1	7	2212	7872	0.570040668775418
GO:0038066	p38MAPK cascade	  6	1	1	0	6	2213	7873	0
GO:0038083	peptidyl-tyrosine autophosphorylation	 28	0.891630301489211	1	4	24	2209	7855	0.651475050029049
GO:0038095	Fc-epsilon receptor signaling pathway	 88	0.982645480367299	1	12	76	2201	7803	0.621862547755001
GO:0038096	Fc-gamma receptor signaling pathway involved in phagocytosis	 52	0.835175910273537	1	9	43	2204	7836	0.789287079842886
GO:0038111	interleukin-7-mediated signaling pathway	 52	0.00203046605349255	0.436948980632278	21	31	2192	7848	1.84166985296674
GO:0038128	ERBB2 signaling pathway	 28	0.767187961599886	1	5	23	2208	7856	0.814343812536311
GO:0038180	nerve growth factor signaling pathway	  8	0.551915645208052	1	2	6	2211	7873	1.14008133755084
GO:0038191	neuropilin binding	  7	0.475663602521461	1	2	5	2211	7874	1.3029501000581
GO:0038203	TORC2 signaling	  5	0.710033128778248	1	1	4	2212	7875	0.912065070040669
GO:0039536	negative regulation of RIG-I signaling pathway	  5	1	1	0	5	2213	7874	0
GO:0039694	viral RNA genome replication	  8	0.551915645208052	1	2	6	2211	7873	1.14008133755084
GO:0039702	viral budding via host ESCRT complex	 12	0.258856173758332	1	4	8	2209	7871	1.52010845006778
GO:0040007	growth	  9	0.892351169002328	1	1	8	2212	7871	0.50670281668926
GO:0040008	regulation of growth	 54	0.967689030998185	1	7	47	2206	7832	0.591153286137471
GO:0040011	locomotion	  7	0.82331362534889	1	1	6	2212	7873	0.651475050029049
GO:0040012	regulation of locomotion	  5	0.710033128778248	1	1	4	2212	7875	0.912065070040669
GO:0040014	regulation of multicellular organism growth	 18	0.929856630121416	1	2	16	2211	7863	0.50670281668926
GO:0040015	negative regulation of multicellular organism growth	 10	0.0471961044586633	1	5	5	2208	7874	2.28016267510167
GO:0040018	positive regulation of multicellular organism growth	 20	0.847343512007977	1	3	17	2210	7862	0.684048802530502
GO:0040019	positive regulation of embryonic development	  5	0.710033128778248	1	1	4	2212	7875	0.912065070040669
GO:0040029	regulation of gene expression, epigenetic	 11	0.446445648052706	1	3	8	2210	7871	1.24372509551
GO:0040036	regulation of fibroblast growth factor receptor signaling pathway	  6	0.123915802800268	1	3	3	2210	7876	2.28016267510167
GO:0040037	negative regulation of fibroblast growth factor receptor signaling pathway	  5	1	1	0	5	2213	7874	0
GO:0042026	protein refolding	 12	0.9488167484775	1	1	11	2212	7868	0.380027112516945
GO:0042043	neurexin family protein binding	 10	1	1	0	10	2213	7869	0
GO:0042045	epithelial fluid transport	  5	0.302606661467939	1	2	3	2211	7876	1.82413014008134
GO:0042048	olfactory behavior	  5	0.710033128778248	1	1	4	2212	7875	0.912065070040669
GO:0042054	histone methyltransferase activity	  5	0.302606661467939	1	2	3	2211	7876	1.82413014008134
GO:0042056	chemoattractant activity	 14	0.621614907823308	1	3	11	2210	7868	0.977212575043574
GO:0042058	regulation of epidermal growth factor receptor signaling pathway	  5	1	1	0	5	2213	7874	0
GO:0042059	negative regulation of epidermal growth factor receptor signaling pathway	 24	0.435238773442835	1	6	18	2207	7861	1.14008133755084
GO:0042060	wound healing	 55	0.880518411021416	1	9	46	2204	7833	0.746235057306002
GO:0042073	intraciliary transport	 14	0.174532180096009	1	5	9	2208	7870	1.62868762507262
GO:0042088	T-helper 1 type immune response	  6	0.773649336373543	1	1	5	2212	7874	0.760054225033891
GO:0042098	T cell proliferation	 14	0.621614907823308	1	3	11	2210	7868	0.977212575043574
GO:0042100	B cell proliferation	  9	1	1	0	9	2213	7870	0
GO:0042102	positive regulation of T cell proliferation	 27	0.378365839440938	1	7	20	2206	7859	1.18230657227494
GO:0042104	positive regulation of activated T cell proliferation	 14	0.968824531635628	1	1	13	2212	7866	0.325737525014525
GO:0042110	T cell activation	 25	0.478131092972125	1	6	19	2207	7860	1.0944780840488
GO:0042113	B cell activation	 22	0.890676450832607	1	3	19	2210	7860	0.621862547755001
GO:0042116	macrophage activation	  6	0.123915802800268	1	3	3	2210	7876	2.28016267510167
GO:0042117	monocyte activation	  6	0.123915802800268	1	3	3	2210	7876	2.28016267510167
GO:0042118	endothelial cell activation	  9	0.313783026377615	1	3	6	2210	7873	1.52010845006778
GO:0042119	neutrophil activation	  5	1	1	0	5	2213	7874	0
GO:0042130	negative regulation of T cell proliferation	 21	1	1	0	21	2213	7858	0
GO:0042135	neurotransmitter catabolic process	  9	0.619953536302463	1	2	7	2211	7872	1.01340563337852
GO:0042136	neurotransmitter biosynthetic process	  5	1	1	0	5	2213	7874	0
GO:0042147	retrograde transport, endosome to Golgi	 51	0.212385853598396	1	14	37	2199	7842	1.25185401770288
GO:0042149	cellular response to glucose starvation	 24	0.630818426079107	1	5	19	2208	7860	0.950067781292363
GO:0042157	lipoprotein metabolic process	 11	0.934420645831428	1	1	10	2212	7869	0.414575031836668
GO:0042162	telomeric DNA binding	 16	0.478664437350441	1	4	12	2209	7867	1.14008133755084
GO:0042166	acetylcholine binding	  6	1	1	0	6	2213	7873	0
GO:0042169	SH2 domain binding	 23	0.224654598346874	1	7	16	2206	7863	1.38792510658363
GO:0042176	regulation of protein catabolic process	 10	0.679711898251496	1	2	8	2211	7871	0.912065070040669
GO:0042177	negative regulation of protein catabolic process	 23	0.97499130551082	1	2	21	2211	7858	0.396550030452465
GO:0042178	xenobiotic catabolic process	  5	0.710033128778248	1	1	4	2212	7875	0.912065070040669
GO:0042220	response to cocaine	 23	0.907908096067233	1	3	20	2210	7859	0.594825045678697
GO:0042246	tissue regeneration	 11	0.731548842740116	1	2	9	2211	7870	0.829150063673335
GO:0042254	ribosome biogenesis	 56	0.148715353950591	1	16	40	2197	7839	1.3029501000581
GO:0042255	ribosome assembly	  6	0.773649336373543	1	1	5	2212	7874	0.760054225033891
GO:0042267	natural killer cell mediated cytotoxicity	  9	0.892351169002328	1	1	8	2212	7871	0.50670281668926
GO:0042273	ribosomal large subunit biogenesis	 16	0.478664437350441	1	4	12	2209	7867	1.14008133755084
GO:0042274	ribosomal small subunit biogenesis	  8	0.862084765369009	1	1	7	2212	7872	0.570040668775418
GO:0042276	error-prone translesion synthesis	 16	0.11719510586415	1	6	10	2207	7869	1.71012200632625
GO:0042277	peptide binding	 36	0.548236499857312	1	8	28	2205	7851	1.01340563337852
GO:0042288	MHC class I protein binding	 10	0.915977754641309	1	1	9	2212	7870	0.456032535020334
GO:0042297	vocal learning	  5	0.710033128778248	1	1	4	2212	7875	0.912065070040669
GO:0042301	phosphate ion binding	  9	1	1	0	9	2213	7870	0
GO:0042304	regulation of fatty acid biosynthetic process	  6	0.123915802800268	1	3	3	2210	7876	2.28016267510167
GO:0042306	regulation of protein import into nucleus	  5	1	1	0	5	2213	7874	0
GO:0042307	positive regulation of protein import into nucleus	 12	0.9488167484775	1	1	11	2212	7868	0.380027112516945
GO:0042308	negative regulation of protein import into nucleus	  8	0.862084765369009	1	1	7	2212	7872	0.570040668775418
GO:0042310	vasoconstriction	  8	0.862084765369009	1	1	7	2212	7872	0.570040668775418
GO:0042311	vasodilation	 15	0.670849711670293	1	3	12	2210	7867	0.912065070040669
GO:0042325	regulation of phosphorylation	 11	0.0182918735576292	1	6	5	2207	7874	2.48745019102001
GO:0042326	negative regulation of phosphorylation	 11	0.731548842740116	1	2	9	2211	7870	0.829150063673335
GO:0042327	positive regulation of phosphorylation	 17	0.754769220253611	1	3	14	2210	7865	0.804763297094708
GO:0042340	keratan sulfate catabolic process	  8	0.862084765369009	1	1	7	2212	7872	0.570040668775418
GO:0042346	positive regulation of NF-kappaB import into nucleus	 10	0.380920088506331	1	3	7	2210	7872	1.368097605061
GO:0042347	negative regulation of NF-kappaB import into nucleus	  7	0.182673311502561	1	3	4	2210	7875	1.95442515008715
GO:0042359	vitamin D metabolic process	  5	0.710033128778248	1	1	4	2212	7875	0.912065070040669
GO:0042382	paraspeckles	  5	0.302606661467939	1	2	3	2211	7876	1.82413014008134
GO:0042383	sarcolemma	 66	0.485647797386192	1	15	51	2198	7828	1.03643757959167
GO:0042391	regulation of membrane potential	 54	0.929641845524211	1	8	46	2205	7833	0.675603755585681
GO:0042392	sphingosine-1-phosphate phosphatase activity	  5	0.710033128778248	1	1	4	2212	7875	0.912065070040669
GO:0042393	histone binding	 70	0.00570988258634514	0.674777072890282	25	45	2188	7834	1.62868762507262
GO:0042405	nuclear inclusion body	  9	0.619953536302463	1	2	7	2211	7872	1.01340563337852
GO:0042407	cristae formation	 19	0.820521257621854	1	3	16	2210	7863	0.720051371084738
GO:0042416	dopamine biosynthetic process	  5	0.302606661467939	1	2	3	2211	7876	1.82413014008134
GO:0042417	dopamine metabolic process	 10	0.915977754641309	1	1	9	2212	7870	0.456032535020334
GO:0042426	choline catabolic process	  5	0.302606661467939	1	2	3	2211	7876	1.82413014008134
GO:0042428	serotonin metabolic process	  6	1	1	0	6	2213	7873	0
GO:0042438	melanin biosynthetic process	  5	0.710033128778248	1	1	4	2212	7875	0.912065070040669
GO:0042448	progesterone metabolic process	  5	1	1	0	5	2213	7874	0
GO:0042462	eye photoreceptor cell development	  8	0.862084765369009	1	1	7	2212	7872	0.570040668775418
GO:0042470	melanosome	 74	0.571217369530308	1	16	58	2197	7821	0.986016291935858
GO:0042471	ear morphogenesis	  5	0.302606661467939	1	2	3	2211	7876	1.82413014008134
GO:0042472	inner ear morphogenesis	 31	0.84151041812627	1	5	26	2208	7853	0.735536346806991
GO:0042473	outer ear morphogenesis	  5	0.710033128778248	1	1	4	2212	7875	0.912065070040669
GO:0042474	middle ear morphogenesis	 13	0.813973253692629	1	2	11	2211	7868	0.701588515415899
GO:0042475	odontogenesis of dentin-containing tooth	 35	0.513055780492111	1	8	27	2205	7852	1.04236008004648
GO:0042476	odontogenesis	 16	0.715200159590258	1	3	13	2210	7866	0.855061003163127
GO:0042500	aspartic endopeptidase activity, intramembrane cleaving	  6	0.123915802800268	1	3	3	2210	7876	2.28016267510167
GO:0042531	positive regulation of tyrosine phosphorylation of STAT protein	 29	0.907170755858537	1	4	25	2209	7854	0.629010393131496
GO:0042532	negative regulation of tyrosine phosphorylation of STAT protein	  9	0.313783026377615	1	3	6	2210	7873	1.52010845006778
GO:0042535	positive regulation of tumor necrosis factor biosynthetic process	  7	0.82331362534889	1	1	6	2212	7873	0.651475050029049
GO:0042542	response to hydrogen peroxide	 37	0.975338700736277	1	4	33	2209	7846	0.493008145967929
GO:0042551	neuron maturation	  6	0.123915802800268	1	3	3	2210	7876	2.28016267510167
GO:0042552	myelination	 38	0.313206795110684	1	10	28	2203	7851	1.20008561847456
GO:0042554	superoxide anion generation	  7	1	1	0	7	2213	7872	0
GO:0042555	MCM complex	  6	1	1	0	6	2213	7873	0
GO:0042562	hormone binding	  6	1	1	0	6	2213	7873	0
GO:0042572	retinol metabolic process	 16	0.98101329485619	1	1	15	2212	7864	0.285020334387709
GO:0042573	retinoic acid metabolic process	  5	0.710033128778248	1	1	4	2212	7875	0.912065070040669
GO:0042574	retinal metabolic process	  8	0.862084765369009	1	1	7	2212	7872	0.570040668775418
GO:0042577	lipid phosphatase activity	  6	1	1	0	6	2213	7873	0
GO:0042578	phosphoric ester hydrolase activity	  6	1	1	0	6	2213	7873	0
GO:0042581	specific granule	  9	0.113156370629833	1	4	5	2209	7874	2.02681126675704
GO:0042582	azurophil granule	  9	0.313783026377615	1	3	6	2210	7873	1.52010845006778
GO:0042584	chromaffin granule membrane	  5	0.710033128778248	1	1	4	2212	7875	0.912065070040669
GO:0042589	zymogen granule membrane	  7	0.475663602521461	1	2	5	2211	7874	1.3029501000581
GO:0042592	homeostatic process	  8	0.551915645208052	1	2	6	2211	7873	1.14008133755084
GO:0042593	glucose homeostasis	 60	0.328615342285664	1	15	45	2198	7834	1.14008133755084
GO:0042594	response to starvation	 17	0.31005409346522	1	5	12	2208	7867	1.34127216182451
GO:0042605	peptide antigen binding	 13	1	1	0	13	2213	7866	0
GO:0042609	CD4 receptor binding	  5	1	1	0	5	2213	7874	0
GO:0042612	MHC class I protein complex	  6	0.773649336373543	1	1	5	2212	7874	0.760054225033891
GO:0042613	MHC class II protein complex	  8	1	1	0	8	2213	7871	0
GO:0042622	photoreceptor outer segment membrane	  5	1	1	0	5	2213	7874	0
GO:0042623	ATPase activity, coupled	  8	0.551915645208052	1	2	6	2211	7873	1.14008133755084
GO:0042626	ATPase activity, coupled to transmembrane movement of substances	 25	0.00347342112501812	0.562694222252935	12	13	2201	7866	2.1889561680976
GO:0042627	chylomicron	  5	1	1	0	5	2213	7874	0
GO:0042629	mast cell granule	 14	0.621614907823308	1	3	11	2210	7868	0.977212575043574
GO:0042632	cholesterol homeostasis	 27	0.737195257699444	1	5	22	2208	7857	0.844504694482101
GO:0042634	regulation of hair cycle	  5	0.302606661467939	1	2	3	2211	7876	1.82413014008134
GO:0042641	actomyosin	 10	0.679711898251496	1	2	8	2211	7871	0.912065070040669
GO:0042645	mitochondrial nucleoid	 32	0.982304227289121	1	3	29	2210	7850	0.427530501581563
GO:0042692	muscle cell differentiation	 13	0.135471430249234	1	5	8	2208	7871	1.75397128853975
GO:0042698	ovulation cycle	  8	0.862084765369009	1	1	7	2212	7872	0.570040668775418
GO:0042711	maternal behavior	 11	0.731548842740116	1	2	9	2211	7870	0.829150063673335
GO:0042730	fibrinolysis	 12	0.9488167484775	1	1	11	2212	7868	0.380027112516945
GO:0042733	embryonic digit morphogenesis	 42	0.845004631553554	1	7	35	2206	7844	0.760054225033891
GO:0042734	presynaptic membrane	 52	0.957151530064226	1	7	45	2206	7834	0.613889950988912
GO:0042742	defense response to bacterium	 48	0.9884098107757	1	5	43	2208	7836	0.475033890646182
GO:0042744	hydrogen peroxide catabolic process	 11	0.731548842740116	1	2	9	2211	7870	0.829150063673335
GO:0042752	regulation of circadian rhythm	 38	0.758351749702664	1	7	31	2206	7848	0.840059932932195
GO:0042753	positive regulation of circadian rhythm	  6	0.391952090801775	1	2	4	2211	7875	1.52010845006778
GO:0042754	negative regulation of circadian rhythm	  6	0.391952090801775	1	2	4	2211	7875	1.52010845006778
GO:0042755	eating behavior	 15	1	1	0	15	2213	7864	0
GO:0042761	very long-chain fatty acid biosynthetic process	  9	0.0286913764967491	1	5	4	2208	7875	2.5335140834463
GO:0042769	DNA damage response, detection of DNA damage	 26	0.85360725893065	1	4	22	2209	7857	0.701588515415899
GO:0042770	signal transduction in response to DNA damage	  8	0.862084765369009	1	1	7	2212	7872	0.570040668775418
GO:0042771	intrinsic apoptotic signaling pathway in response to DNA damage by p53 class mediator	 20	0.992959925266813	1	1	19	2212	7860	0.228016267510167
GO:0042775	mitochondrial ATP synthesis coupled electron transport	  6	0.773649336373543	1	1	5	2212	7874	0.760054225033891
GO:0042776	mitochondrial ATP synthesis coupled proton transport	 11	0.934420645831428	1	1	10	2212	7869	0.414575031836668
GO:0042787	protein ubiquitination involved in ubiquitin-dependent protein catabolic process	 99	0.848381529653271	1	18	81	2195	7798	0.829150063673335
GO:0042788	polysomal ribosome	  6	0.391952090801775	1	2	4	2211	7875	1.52010845006778
GO:0042789	mRNA transcription from RNA polymerase II promoter	  9	0.619953536302463	1	2	7	2211	7872	1.01340563337852
GO:0042795	snRNA transcription from RNA polymerase II promoter	 48	0.239718384400654	1	13	35	2200	7844	1.23508811568007
GO:0042800	histone methyltransferase activity (H3-K4 specific)	  8	0.551915645208052	1	2	6	2211	7873	1.14008133755084
GO:0042805	actinin binding	  6	0.123915802800268	1	3	3	2210	7876	2.28016267510167
GO:0042809	vitamin D receptor binding	 15	0.872984249747857	1	2	13	2211	7866	0.608043380027113
GO:0042813	Wnt-activated receptor activity	 14	0.846032978004182	1	2	12	2211	7867	0.651475050029049
GO:0042826	histone deacetylase binding	 68	0.420970434113158	1	16	52	2197	7827	1.07301772945961
GO:0042832	defense response to protozoan	 11	0.934420645831428	1	1	10	2212	7869	0.414575031836668
GO:0042908	xenobiotic transport	  5	0.710033128778248	1	1	4	2212	7875	0.912065070040669
GO:0042921	glucocorticoid receptor signaling pathway	  8	0.551915645208052	1	2	6	2211	7873	1.14008133755084
GO:0042923	neuropeptide binding	  8	0.862084765369009	1	1	7	2212	7872	0.570040668775418
GO:0042953	lipoprotein transport	  5	0.073752586889371	1	3	2	2210	7877	2.73619521012201
GO:0042974	retinoic acid receptor binding	 13	0.567559963400701	1	3	10	2210	7869	1.05238277312385
GO:0042975	peroxisome proliferator activated receptor binding	  7	0.475663602521461	1	2	5	2211	7874	1.3029501000581
GO:0042982	amyloid precursor protein metabolic process	  8	0.246907474461687	1	3	5	2210	7874	1.71012200632625
GO:0042987	amyloid precursor protein catabolic process	  5	0.302606661467939	1	2	3	2211	7876	1.82413014008134
GO:0042993	positive regulation of transcription factor import into nucleus	 11	1	1	0	11	2213	7868	0
GO:0042994	cytoplasmic sequestering of transcription factor	  8	0.862084765369009	1	1	7	2212	7872	0.570040668775418
GO:0043001	Golgi to plasma membrane protein transport	 18	0.0785263715936463	1	7	11	2206	7868	1.77345985841241
GO:0043008	ATP-dependent protein binding	  6	0.773649336373543	1	1	5	2212	7874	0.760054225033891
GO:0043010	camera-type eye development	 41	0.559799073829599	1	9	32	2204	7847	1.00104702809342
GO:0043011	myeloid dendritic cell differentiation	 11	0.934420645831428	1	1	10	2212	7869	0.414575031836668
GO:0043014	alpha-tubulin binding	 18	0.358397855587164	1	5	13	2208	7866	1.26675704172315
GO:0043015	gamma-tubulin binding	 19	0.222505526992328	1	6	13	2207	7866	1.44010274216948
GO:0043020	NADPH oxidase complex	  5	1	1	0	5	2213	7874	0
GO:0043021	ribonucleoprotein complex binding	 19	0.625808905960736	1	4	15	2209	7864	0.960068494779651
GO:0043022	ribosome binding	 37	0.0925299836015753	1	12	25	2201	7854	1.47902443790379
GO:0043023	ribosomal large subunit binding	  8	0.551915645208052	1	2	6	2211	7873	1.14008133755084
GO:0043024	ribosomal small subunit binding	  9	0.00499827528532287	0.674777072890282	6	3	2207	7876	3.04021690013556
GO:0043027	cysteine-type endopeptidase inhibitor activity involved in apoptotic process	 13	0.813973253692629	1	2	11	2211	7868	0.701588515415899
GO:0043029	T cell homeostasis	 18	0.789777202096414	1	3	15	2210	7864	0.760054225033891
GO:0043032	positive regulation of macrophage activation	  7	0.82331362534889	1	1	6	2212	7873	0.651475050029049
GO:0043034	costamere	 14	0.621614907823308	1	3	11	2210	7868	0.977212575043574
GO:0043039	tRNA aminoacylation	  7	0.82331362534889	1	1	6	2212	7873	0.651475050029049
GO:0043044	ATP-dependent chromatin remodeling	 16	0.0423390763570133	1	7	9	2206	7870	1.99514234071396
GO:0043046	DNA methylation involved in gamete generation	  6	0.773649336373543	1	1	5	2212	7874	0.760054225033891
GO:0043068	positive regulation of programmed cell death	  8	0.862084765369009	1	1	7	2212	7872	0.570040668775418
GO:0043069	negative regulation of programmed cell death	 10	1	1	0	10	2213	7869	0
GO:0043083	synaptic cleft	  8	0.551915645208052	1	2	6	2211	7873	1.14008133755084
GO:0043085	positive regulation of catalytic activity	 57	0.61526170024093	1	12	45	2201	7834	0.960068494779651
GO:0043086	negative regulation of catalytic activity	 61	0.88869139753884	1	10	51	2203	7828	0.747594319705466
GO:0043087	regulation of GTPase activity	 62	0.829225515750763	1	11	51	2202	7828	0.80908998148769
GO:0043097	pyrimidine nucleoside salvage	  5	0.710033128778248	1	1	4	2212	7875	0.912065070040669
GO:0043101	purine-containing compound salvage	 10	0.679711898251496	1	2	8	2211	7871	0.912065070040669
GO:0043113	receptor clustering	 17	0.985183360207843	1	1	16	2212	7863	0.268254432364903
GO:0043114	regulation of vascular permeability	  6	0.773649336373543	1	1	5	2212	7874	0.760054225033891
GO:0043116	negative regulation of vascular permeability	  9	0.619953536302463	1	2	7	2211	7872	1.01340563337852
GO:0043122	regulation of I-kappaB kinase/NF-kappaB signaling	  9	0.619953536302463	1	2	7	2211	7872	1.01340563337852
GO:0043124	negative regulation of I-kappaB kinase/NF-kappaB signaling	 24	0.435238773442835	1	6	18	2207	7861	1.14008133755084
GO:0043129	surfactant homeostasis	  6	1	1	0	6	2213	7873	0
GO:0043130	ubiquitin binding	 49	0.385522464311084	1	12	37	2201	7842	1.11681437147837
GO:0043142	single-stranded DNA-dependent ATPase activity	  7	0.82331362534889	1	1	6	2212	7873	0.651475050029049
GO:0043149	stress fiber assembly	  9	0.313783026377615	1	3	6	2210	7873	1.52010845006778
GO:0043153	entrainment of circadian clock by photoperiod	 13	0.960053706376239	1	1	12	2212	7867	0.35079425770795
GO:0043154	negative regulation of cysteine-type endopeptidase activity involved in apoptotic process	 48	0.9884098107757	1	5	43	2208	7836	0.475033890646182
GO:0043162	ubiquitin-dependent protein catabolic process via the multivesicular body sorting pathway	 12	0.258856173758332	1	4	8	2209	7871	1.52010845006778
GO:0043169	cation binding	 11	0.446445648052706	1	3	8	2210	7871	1.24372509551
GO:0043171	peptide catabolic process	 10	1	1	0	10	2213	7869	0
GO:0043190	ATP-binding cassette (ABC) transporter complex	  5	0.302606661467939	1	2	3	2211	7876	1.82413014008134
GO:0043194	axon initial segment	 11	0.206185263049328	1	4	7	2209	7872	1.65830012734667
GO:0043195	terminal bouton	 46	0.999845787987033	1	2	44	2211	7835	0.198275015226232
GO:0043196	varicosity	  5	1	1	0	5	2213	7874	0
GO:0043197	dendritic spine	 97	0.823031120355801	1	18	79	2195	7800	0.846245941274847
GO:0043198	dendritic shaft	 33	0.951297228934078	1	4	29	2209	7850	0.552766709115557
GO:0043200	response to amino acid	 25	0.668990259355853	1	5	20	2208	7859	0.912065070040669
GO:0043202	lysosomal lumen	 61	0.713076423234635	1	12	49	2201	7830	0.897113183646559
GO:0043203	axon hillock	  5	1	1	0	5	2213	7874	0
GO:0043204	perikaryon	 78	0.970521467086757	1	11	67	2202	7812	0.643122805797907
GO:0043218	compact myelin	  5	0.302606661467939	1	2	3	2211	7876	1.82413014008134
GO:0043220	Schmidt-Lanterman incisure	 10	0.380920088506331	1	3	7	2210	7872	1.368097605061
GO:0043225	ATPase-coupled anion transmembrane transporter activity	  6	0.123915802800268	1	3	3	2210	7876	2.28016267510167
GO:0043229	intracellular organelle	  7	1	1	0	7	2213	7872	0
GO:0043235	receptor complex	 85	0.915814584313854	1	14	71	2199	7808	0.751112410621727
GO:0043236	laminin binding	 14	0.621614907823308	1	3	11	2210	7868	0.977212575043574
GO:0043240	Fanconi anaemia nuclear complex	  6	0.773649336373543	1	1	5	2212	7874	0.760054225033891
GO:0043248	proteasome assembly	 11	1	1	0	11	2213	7868	0
GO:0043249	erythrocyte maturation	  7	1	1	0	7	2213	7872	0
GO:0043252	sodium-independent organic anion transport	 13	0.567559963400701	1	3	10	2210	7869	1.05238277312385
GO:0043254	regulation of protein complex assembly	  8	0.862084765369009	1	1	7	2212	7872	0.570040668775418
GO:0043267	negative regulation of potassium ion transport	  7	1	1	0	7	2213	7872	0
GO:0043268	positive regulation of potassium ion transport	 10	0.679711898251496	1	2	8	2211	7871	0.912065070040669
GO:0043274	phospholipase binding	  9	0.619953536302463	1	2	7	2211	7872	1.01340563337852
GO:0043276	anoikis	  5	0.302606661467939	1	2	3	2211	7876	1.82413014008134
GO:0043277	apoptotic cell clearance	 11	0.731548842740116	1	2	9	2211	7870	0.829150063673335
GO:0043278	response to morphine	 18	0.929856630121416	1	2	16	2211	7863	0.50670281668926
GO:0043279	response to alkaloid	  5	0.302606661467939	1	2	3	2211	7876	1.82413014008134
GO:0043280	positive regulation of cysteine-type endopeptidase activity involved in apoptotic process	 24	0.804794893906303	1	4	20	2209	7859	0.760054225033891
GO:0043281	regulation of cysteine-type endopeptidase activity involved in apoptotic process	  8	0.862084765369009	1	1	7	2212	7872	0.570040668775418
GO:0043292	contractile fiber	  8	0.862084765369009	1	1	7	2212	7872	0.570040668775418
GO:0043295	glutathione binding	  5	0.710033128778248	1	1	4	2212	7875	0.912065070040669
GO:0043296	apical junction complex	 12	0.9488167484775	1	1	11	2212	7868	0.380027112516945
GO:0043303	mast cell degranulation	  7	0.475663602521461	1	2	5	2211	7874	1.3029501000581
GO:0043304	regulation of mast cell degranulation	  6	0.391952090801775	1	2	4	2211	7875	1.52010845006778
GO:0043305	negative regulation of mast cell degranulation	  5	1	1	0	5	2213	7874	0
GO:0043306	positive regulation of mast cell degranulation	  6	1	1	0	6	2213	7873	0
GO:0043325	phosphatidylinositol-3,4-bisphosphate binding	 14	0.621614907823308	1	3	11	2210	7868	0.977212575043574
GO:0043330	response to exogenous dsRNA	 12	1	1	0	12	2213	7867	0
GO:0043388	positive regulation of DNA binding	 16	0.11719510586415	1	6	10	2207	7869	1.71012200632625
GO:0043392	negative regulation of DNA binding	 21	0.707764107729648	1	4	17	2209	7862	0.868633400038732
GO:0043393	regulation of protein binding	 18	0.579729311039596	1	4	14	2209	7865	1.01340563337852
GO:0043394	proteoglycan binding	  8	0.246907474461687	1	3	5	2210	7874	1.71012200632625
GO:0043395	heparan sulfate proteoglycan binding	 10	1	1	0	10	2213	7869	0
GO:0043401	steroid hormone mediated signaling pathway	 33	0.607526668788888	1	7	26	2206	7853	0.967341740952224
GO:0043403	skeletal muscle tissue regeneration	 11	0.731548842740116	1	2	9	2211	7870	0.829150063673335
GO:0043406	positive regulation of MAP kinase activity	 35	0.909084510759699	1	5	30	2208	7849	0.651475050029049
GO:0043407	negative regulation of MAP kinase activity	 23	0.97499130551082	1	2	21	2211	7858	0.396550030452465
GO:0043408	regulation of MAPK cascade	 20	0.847343512007977	1	3	17	2210	7862	0.684048802530502
GO:0043409	negative regulation of MAPK cascade	 14	0.0651620805250405	1	6	8	2207	7871	1.95442515008715
GO:0043410	positive regulation of MAPK cascade	 60	0.876199412897406	1	10	50	2203	7829	0.760054225033891
GO:0043422	protein kinase B binding	  8	0.246907474461687	1	3	5	2210	7874	1.71012200632625
GO:0043425	bHLH transcription factor binding	 16	0.895524834056086	1	2	14	2211	7865	0.570040668775418
GO:0043433	negative regulation of sequence-specific DNA binding transcription factor activity	 38	0.869733087252702	1	6	32	2207	7847	0.720051371084738
GO:0043434	response to peptide hormone	 37	0.424636934939564	1	9	28	2204	7851	1.10926832842784
GO:0043457	regulation of cellular respiration	  5	0.710033128778248	1	1	4	2212	7875	0.912065070040669
GO:0043462	regulation of ATPase activity	  5	0.710033128778248	1	1	4	2212	7875	0.912065070040669
GO:0043473	pigmentation	 24	0.135708125227478	1	8	16	2205	7863	1.52010845006778
GO:0043484	regulation of RNA splicing	 24	0.000555110068208559	0.243487974149252	13	11	2200	7868	2.47017623136014
GO:0043486	histone exchange	  5	0.710033128778248	1	1	4	2212	7875	0.912065070040669
GO:0043488	regulation of mRNA stability	 83	0.968036768117418	1	12	71	2201	7808	0.659324147017351
GO:0043491	protein kinase B signaling	 25	0.983626289752331	1	2	23	2211	7856	0.364826028016268
GO:0043495	protein membrane anchor	  6	0.391952090801775	1	2	4	2211	7875	1.52010845006778
GO:0043496	regulation of protein homodimerization activity	  5	1	1	0	5	2213	7874	0
GO:0043497	regulation of protein heterodimerization activity	  6	1	1	0	6	2213	7873	0
GO:0043507	positive regulation of JUN kinase activity	 21	0.962023298212517	1	2	19	2211	7860	0.434316700019366
GO:0043508	negative regulation of JUN kinase activity	  9	0.619953536302463	1	2	7	2211	7872	1.01340563337852
GO:0043517	positive regulation of DNA damage response, signal transduction by p53 class mediator	  7	0.182673311502561	1	3	4	2210	7875	1.95442515008715
GO:0043522	leucine zipper domain binding	  5	0.710033128778248	1	1	4	2212	7875	0.912065070040669
GO:0043523	regulation of neuron apoptotic process	 13	0.960053706376239	1	1	12	2212	7867	0.35079425770795
GO:0043524	negative regulation of neuron apoptotic process	 97	0.976816907311043	1	14	83	2199	7796	0.658191287658215
GO:0043525	positive regulation of neuron apoptotic process	 34	0.641364935399031	1	7	27	2206	7852	0.938890513277159
GO:0043531	ADP binding	 27	0.737195257699444	1	5	22	2208	7857	0.844504694482101
GO:0043533	inositol 1,3,4,5 tetrakisphosphate binding	  5	1	1	0	5	2213	7874	0
GO:0043534	blood vessel endothelial cell migration	  5	1	1	0	5	2213	7874	0
GO:0043536	positive regulation of blood vessel endothelial cell migration	 14	0.846032978004182	1	2	12	2211	7867	0.651475050029049
GO:0043537	negative regulation of blood vessel endothelial cell migration	  8	0.551915645208052	1	2	6	2211	7873	1.14008133755084
GO:0043539	protein serine/threonine kinase activator activity	 14	0.968824531635628	1	1	13	2212	7866	0.325737525014525
GO:0043542	endothelial cell migration	 20	0.953316959911741	1	2	18	2211	7861	0.456032535020334
GO:0043548	phosphatidylinositol 3-kinase binding	 16	0.478664437350441	1	4	12	2209	7867	1.14008133755084
GO:0043552	positive regulation of phosphatidylinositol 3-kinase activity	 18	0.579729311039596	1	4	14	2209	7865	1.01340563337852
GO:0043559	insulin binding	  5	0.302606661467939	1	2	3	2211	7876	1.82413014008134
GO:0043560	insulin receptor substrate binding	 11	0.206185263049328	1	4	7	2209	7872	1.65830012734667
GO:0043568	positive regulation of insulin-like growth factor receptor signaling pathway	  7	0.82331362534889	1	1	6	2212	7873	0.651475050029049
GO:0043576	regulation of respiratory gaseous exchange	  5	0.302606661467939	1	2	3	2211	7876	1.82413014008134
GO:0043583	ear development	  6	0.773649336373543	1	1	5	2212	7874	0.760054225033891
GO:0043586	tongue development	  7	1	1	0	7	2213	7872	0
GO:0043588	skin development	 27	0.737195257699444	1	5	22	2208	7857	0.844504694482101
GO:0043596	nuclear replication fork	  6	0.123915802800268	1	3	3	2210	7876	2.28016267510167
GO:0043616	keratinocyte proliferation	  5	0.710033128778248	1	1	4	2212	7875	0.912065070040669
GO:0043619	regulation of transcription from RNA polymerase II promoter in response to oxidative stress	  5	1	1	0	5	2213	7874	0
GO:0043620	regulation of DNA-templated transcription in response to stress	  6	0.773649336373543	1	1	5	2212	7874	0.760054225033891
GO:0043621	protein self-association	 36	0.548236499857312	1	8	28	2205	7851	1.01340563337852
GO:0043623	cellular protein complex assembly	 12	0.77606351672464	1	2	10	2211	7869	0.760054225033891
GO:0043627	response to estrogen	 29	0.968771645692927	1	3	26	2210	7853	0.471757794848622
GO:0043647	inositol phosphate metabolic process	 35	0.909084510759699	1	5	30	2208	7849	0.651475050029049
GO:0043651	linoleic acid metabolic process	  8	0.246907474461687	1	3	5	2210	7874	1.71012200632625
GO:0043653	mitochondrial fragmentation involved in apoptotic process	  7	0.82331362534889	1	1	6	2212	7873	0.651475050029049
GO:0043654	recognition of apoptotic cell	  6	0.773649336373543	1	1	5	2212	7874	0.760054225033891
GO:0043657	host cell	 37	0.58233293155876	1	8	29	2205	7850	0.986016291935858
GO:0043666	regulation of phosphoprotein phosphatase activity	  5	0.302606661467939	1	2	3	2211	7876	1.82413014008134
GO:0043679	axon terminus	 43	0.998021963656652	1	3	40	2210	7839	0.318162233735117
GO:0043691	reverse cholesterol transport	  7	0.475663602521461	1	2	5	2211	7874	1.3029501000581
GO:0043813	phosphatidylinositol-3,5-bisphosphate 5-phosphatase activity	  5	0.710033128778248	1	1	4	2212	7875	0.912065070040669
GO:0043922	negative regulation by host of viral transcription	  5	0.710033128778248	1	1	4	2212	7875	0.912065070040669
GO:0043923	positive regulation by host of viral transcription	 11	0.731548842740116	1	2	9	2211	7870	0.829150063673335
GO:0043928	exonucleolytic nuclear-transcribed mRNA catabolic process involved in deadenylation-dependent decay	 25	0.935180750360745	1	3	22	2210	7857	0.547239042024401
GO:0043931	ossification involved in bone maturation	  7	0.82331362534889	1	1	6	2212	7873	0.651475050029049
GO:0043949	regulation of cAMP-mediated signaling	  5	0.302606661467939	1	2	3	2211	7876	1.82413014008134
GO:0043950	positive regulation of cAMP-mediated signaling	  5	0.302606661467939	1	2	3	2211	7876	1.82413014008134
GO:0043951	negative regulation of cAMP-mediated signaling	  5	0.710033128778248	1	1	4	2212	7875	0.912065070040669
GO:0043966	histone H3 acetylation	 30	0.920699322541832	1	4	26	2209	7853	0.608043380027113
GO:0043967	histone H4 acetylation	 24	0.804794893906303	1	4	20	2209	7859	0.760054225033891
GO:0043968	histone H2A acetylation	 12	0.9488167484775	1	1	11	2212	7868	0.380027112516945
GO:0043981	histone H4-K5 acetylation	 11	0.446445648052706	1	3	8	2210	7871	1.24372509551
GO:0043982	histone H4-K8 acetylation	 11	0.446445648052706	1	3	8	2210	7871	1.24372509551
GO:0043983	histone H4-K12 acetylation	  5	0.710033128778248	1	1	4	2212	7875	0.912065070040669
GO:0043984	histone H4-K16 acetylation	 10	0.157129881410612	1	4	6	2209	7873	1.82413014008134
GO:0043985	histone H4-R3 methylation	  6	0.773649336373543	1	1	5	2212	7874	0.760054225033891
GO:0043995	histone acetyltransferase activity (H4-K5 specific)	  7	0.182673311502561	1	3	4	2210	7875	1.95442515008715
GO:0043996	histone acetyltransferase activity (H4-K8 specific)	  7	0.182673311502561	1	3	4	2210	7875	1.95442515008715
GO:0044030	regulation of DNA methylation	  9	0.892351169002328	1	1	8	2212	7871	0.50670281668926
GO:0044070	regulation of anion transport	  9	0.892351169002328	1	1	8	2212	7871	0.50670281668926
GO:0044130	negative regulation of growth of symbiont in host	  6	1	1	0	6	2213	7873	0
GO:0044183	protein binding involved in protein folding	 19	0.990977776999059	1	1	18	2212	7861	0.240017123694913
GO:0044224	juxtaparanode region of axon	  9	1	1	0	9	2213	7870	0
GO:0044233	ER-mitochondrion membrane contact site	  7	0.82331362534889	1	1	6	2212	7873	0.651475050029049
GO:0044237	cellular metabolic process	  8	0.0756163732373509	1	4	4	2209	7875	2.28016267510167
GO:0044255	cellular lipid metabolic process	  6	1	1	0	6	2213	7873	0
GO:0044257	cellular protein catabolic process	  9	0.313783026377615	1	3	6	2210	7873	1.52010845006778
GO:0044281	small molecule metabolic process	  6	0.391952090801775	1	2	4	2211	7875	1.52010845006778
GO:0044291	cell-cell contact zone	 16	0.262709457690152	1	5	11	2208	7868	1.42510167193854
GO:0044294	dendritic growth cone	  5	1	1	0	5	2213	7874	0
GO:0044295	axonal growth cone	 17	0.914292249229749	1	2	15	2211	7864	0.536508864729805
GO:0044297	cell body	 65	0.984176701615374	1	8	57	2205	7822	0.561270812332719
GO:0044300	cerebellar mossy fiber	  5	1	1	0	5	2213	7874	0
GO:0044306	neuron projection terminus	 16	0.895524834056086	1	2	14	2211	7865	0.570040668775418
GO:0044309	neuron spine	  5	1	1	0	5	2213	7874	0
GO:0044319	wound healing, spreading of cells	 10	1	1	0	10	2213	7869	0
GO:0044320	cellular response to leptin stimulus	  6	0.773649336373543	1	1	5	2212	7874	0.760054225033891
GO:0044321	response to leptin	  8	0.551915645208052	1	2	6	2211	7873	1.14008133755084
GO:0044322	endoplasmic reticulum quality control compartment	 17	0.31005409346522	1	5	12	2208	7867	1.34127216182451
GO:0044325	ion channel binding	 90	0.413649054898734	1	21	69	2192	7810	1.06407591504745
GO:0044327	dendritic spine head	  7	0.182673311502561	1	3	4	2210	7875	1.95442515008715
GO:0044342	type B pancreatic cell proliferation	  7	1	1	0	7	2213	7872	0
GO:0044344	cellular response to fibroblast growth factor stimulus	 23	0.391748984254665	1	6	17	2207	7862	1.18965009135739
GO:0044351	macropinocytosis	  5	1	1	0	5	2213	7874	0
GO:0044387	negative regulation of protein kinase activity by regulation of protein phosphorylation	  5	0.710033128778248	1	1	4	2212	7875	0.912065070040669
GO:0044389	ubiquitin-like protein ligase binding	  7	0.475663602521461	1	2	5	2211	7874	1.3029501000581
GO:0044458	motile cilium assembly	 11	0.206185263049328	1	4	7	2209	7872	1.65830012734667
GO:0044539	long-chain fatty acid import	  5	0.710033128778248	1	1	4	2212	7875	0.912065070040669
GO:0044548	S100 protein binding	 12	0.258856173758332	1	4	8	2209	7871	1.52010845006778
GO:0044666	MLL3/4 complex	  6	0.773649336373543	1	1	5	2212	7874	0.760054225033891
GO:0044754	autolysosome	  7	1	1	0	7	2213	7872	0
GO:0044782	cilium organization	  6	0.123915802800268	1	3	3	2210	7876	2.28016267510167
GO:0044794	positive regulation by host of viral process	  5	1	1	0	5	2213	7874	0
GO:0044798	nuclear transcription factor complex	  7	1	1	0	7	2213	7872	0
GO:0044804	autophagy of nucleus	 12	0.100843441631321	1	5	7	2208	7872	1.90013556258473
GO:0044829	positive regulation by host of viral genome replication	  6	0.773649336373543	1	1	5	2212	7874	0.760054225033891
GO:0044849	estrous cycle	 11	0.934420645831428	1	1	10	2212	7869	0.414575031836668
GO:0044853	plasma membrane raft	  8	0.551915645208052	1	2	6	2211	7873	1.14008133755084
GO:0044877	macromolecular complex binding	  8	0.862084765369009	1	1	7	2212	7872	0.570040668775418
GO:0045008	depyrimidination	  5	0.710033128778248	1	1	4	2212	7875	0.912065070040669
GO:0045010	actin nucleation	  7	0.475663602521461	1	2	5	2211	7874	1.3029501000581
GO:0045019	negative regulation of nitric oxide biosynthetic process	  7	0.82331362534889	1	1	6	2212	7873	0.651475050029049
GO:0045022	early endosome to late endosome transport	 15	0.975670266056184	1	1	14	2212	7865	0.304021690013556
GO:0045028	G-protein coupled purinergic nucleotide receptor activity	  5	1	1	0	5	2213	7874	0
GO:0045047	protein targeting to ER	  9	0.313783026377615	1	3	6	2210	7873	1.52010845006778
GO:0045055	regulated exocytosis	 12	0.9488167484775	1	1	11	2212	7868	0.380027112516945
GO:0045056	transcytosis	  9	0.113156370629833	1	4	5	2209	7874	2.02681126675704
GO:0045059	positive thymic T cell selection	  5	0.710033128778248	1	1	4	2212	7875	0.912065070040669
GO:0045060	negative thymic T cell selection	  6	1	1	0	6	2213	7873	0
GO:0045070	positive regulation of viral genome replication	 16	0.478664437350441	1	4	12	2209	7867	1.14008133755084
GO:0045071	negative regulation of viral genome replication	 30	0.994436930063121	1	2	28	2211	7851	0.304021690013556
GO:0045086	positive regulation of interleukin-2 biosynthetic process	  5	0.710033128778248	1	1	4	2212	7875	0.912065070040669
GO:0045088	regulation of innate immune response	 12	0.77606351672464	1	2	10	2211	7869	0.760054225033891
GO:0045089	positive regulation of innate immune response	 10	0.0471961044586633	1	5	5	2208	7874	2.28016267510167
GO:0045095	keratin filament	  5	0.073752586889371	1	3	2	2210	7877	2.73619521012201
GO:0045104	intermediate filament cytoskeleton organization	 10	0.380920088506331	1	3	7	2210	7872	1.368097605061
GO:0045109	intermediate filament organization	  8	1	1	0	8	2213	7871	0
GO:0045111	intermediate filament cytoskeleton	 28	0.599228819757412	1	6	22	2207	7857	0.977212575043574
GO:0045116	protein neddylation	 11	0.731548842740116	1	2	9	2211	7870	0.829150063673335
GO:0045124	regulation of bone resorption	  5	0.710033128778248	1	1	4	2212	7875	0.912065070040669
GO:0045132	meiotic chromosome segregation	  5	0.00951539520558073	0.843458993883364	4	1	2209	7878	3.64826028016268
GO:0045141	meiotic telomere clustering	  5	0.302606661467939	1	2	3	2211	7876	1.82413014008134
GO:0045162	clustering of voltage-gated sodium channels	  6	0.123915802800268	1	3	3	2210	7876	2.28016267510167
GO:0045165	cell fate commitment	 31	0.932431012084879	1	4	27	2209	7852	0.588429077445593
GO:0045171	intercellular bridge	 28	0.767187961599886	1	5	23	2208	7856	0.814343812536311
GO:0045176	apical protein localization	  7	0.182673311502561	1	3	4	2210	7875	1.95442515008715
GO:0045177	apical part of cell	 61	0.354323748782593	1	15	46	2198	7833	1.1213914795582
GO:0045178	basal part of cell	 10	0.157129881410612	1	4	6	2209	7873	1.82413014008134
GO:0045182	translation regulator activity	  6	0.773649336373543	1	1	5	2212	7874	0.760054225033891
GO:0045184	establishment of protein localization	 30	0.497034174054913	1	7	23	2206	7856	1.06407591504745
GO:0045190	isotype switching	 10	0.679711898251496	1	2	8	2211	7871	0.912065070040669
GO:0045197	establishment or maintenance of epithelial cell apical/basal polarity	 10	1	1	0	10	2213	7869	0
GO:0045198	establishment of epithelial cell apical/basal polarity	  5	1	1	0	5	2213	7874	0
GO:0045199	maintenance of epithelial cell apical/basal polarity	  8	0.551915645208052	1	2	6	2211	7873	1.14008133755084
GO:0045214	sarcomere organization	 17	0.914292249229749	1	2	15	2211	7864	0.536508864729805
GO:0045216	cell-cell junction organization	  9	0.619953536302463	1	2	7	2211	7872	1.01340563337852
GO:0045236	CXCR chemokine receptor binding	  5	1	1	0	5	2213	7874	0
GO:0045252	oxoglutarate dehydrogenase complex	  5	1	1	0	5	2213	7874	0
GO:0045254	pyruvate dehydrogenase complex	  5	1	1	0	5	2213	7874	0
GO:0045263	proton-transporting ATP synthase complex, coupling factor F(o)	  5	0.710033128778248	1	1	4	2212	7875	0.912065070040669
GO:0045292	mRNA cis splicing, via spliceosome	  7	0.475663602521461	1	2	5	2211	7874	1.3029501000581
GO:0045294	alpha-catenin binding	  7	0.82331362534889	1	1	6	2212	7873	0.651475050029049
GO:0045295	gamma-catenin binding	  8	0.551915645208052	1	2	6	2211	7873	1.14008133755084
GO:0045332	phospholipid translocation	 18	0.00801766548050424	0.771578832163946	9	9	2204	7870	2.28016267510167
GO:0045333	cellular respiration	 17	0.914292249229749	1	2	15	2211	7864	0.536508864729805
GO:0045334	clathrin-coated endocytic vesicle	  7	0.475663602521461	1	2	5	2211	7874	1.3029501000581
GO:0045335	phagocytic vesicle	 36	0.921411162229533	1	5	31	2208	7848	0.633378520861576
GO:0045429	positive regulation of nitric oxide biosynthetic process	 25	0.478131092972125	1	6	19	2207	7860	1.0944780840488
GO:0045444	fat cell differentiation	 53	0.635227370726728	1	11	42	2202	7837	0.946482619853524
GO:0045445	myoblast differentiation	 12	0.508975472817498	1	3	9	2210	7870	1.14008133755084
GO:0045446	endothelial cell differentiation	 10	1	1	0	10	2213	7869	0
GO:0045453	bone resorption	  9	0.892351169002328	1	1	8	2212	7871	0.50670281668926
GO:0045454	cell redox homeostasis	 42	0.305641488459175	1	11	31	2202	7848	1.19437092505326
GO:0045471	response to ethanol	 62	0.734899704793522	1	12	50	2201	7829	0.882643616168389
GO:0045475	locomotor rhythm	  7	1	1	0	7	2213	7872	0
GO:0045494	photoreceptor cell maintenance	 16	0.895524834056086	1	2	14	2211	7865	0.570040668775418
GO:0045499	chemorepellent activity	  7	0.82331362534889	1	1	6	2212	7873	0.651475050029049
GO:0045503	dynein light chain binding	 12	0.0298982942190106	1	6	6	2207	7873	2.28016267510167
GO:0045504	dynein heavy chain binding	  9	0.0286913764967491	1	5	4	2208	7875	2.5335140834463
GO:0045505	dynein intermediate chain binding	 12	0.258856173758332	1	4	8	2209	7871	1.52010845006778
GO:0045540	regulation of cholesterol biosynthetic process	 25	0.077240926269973	1	9	16	2204	7863	1.6417171260732
GO:0045577	regulation of B cell differentiation	  6	1	1	0	6	2213	7873	0
GO:0045579	positive regulation of B cell differentiation	  7	0.82331362534889	1	1	6	2212	7873	0.651475050029049
GO:0045582	positive regulation of T cell differentiation	  5	0.302606661467939	1	2	3	2211	7876	1.82413014008134
GO:0045589	regulation of regulatory T cell differentiation	  6	1	1	0	6	2213	7873	0
GO:0045591	positive regulation of regulatory T cell differentiation	  7	0.475663602521461	1	2	5	2211	7874	1.3029501000581
GO:0045595	regulation of cell differentiation	 23	0.590072665113217	1	5	18	2208	7861	0.991375076131162
GO:0045596	negative regulation of cell differentiation	 24	0.979750646601004	1	2	22	2211	7857	0.380027112516945
GO:0045597	positive regulation of cell differentiation	 26	0.85360725893065	1	4	22	2209	7857	0.701588515415899
GO:0045598	regulation of fat cell differentiation	  8	0.246907474461687	1	3	5	2210	7874	1.71012200632625
GO:0045599	negative regulation of fat cell differentiation	 27	0.954816764309549	1	3	24	2210	7855	0.50670281668926
GO:0045600	positive regulation of fat cell differentiation	 35	0.990115731466902	1	3	32	2210	7847	0.390885030017429
GO:0045602	negative regulation of endothelial cell differentiation	  5	1	1	0	5	2213	7874	0
GO:0045603	positive regulation of endothelial cell differentiation	  8	0.862084765369009	1	1	7	2212	7872	0.570040668775418
GO:0045607	regulation of auditory receptor cell differentiation	  5	1	1	0	5	2213	7874	0
GO:0045616	regulation of keratinocyte differentiation	  9	0.892351169002328	1	1	8	2212	7871	0.50670281668926
GO:0045618	positive regulation of keratinocyte differentiation	  6	1	1	0	6	2213	7873	0
GO:0045630	positive regulation of T-helper 2 cell differentiation	  5	1	1	0	5	2213	7874	0
GO:0045637	regulation of myeloid cell differentiation	 11	0.731548842740116	1	2	9	2211	7870	0.829150063673335
GO:0045638	negative regulation of myeloid cell differentiation	 16	0.262709457690152	1	5	11	2208	7868	1.42510167193854
GO:0045646	regulation of erythrocyte differentiation	  6	0.391952090801775	1	2	4	2211	7875	1.52010845006778
GO:0045647	negative regulation of erythrocyte differentiation	  6	1	1	0	6	2213	7873	0
GO:0045648	positive regulation of erythrocyte differentiation	 18	0.579729311039596	1	4	14	2209	7865	1.01340563337852
GO:0045651	positive regulation of macrophage differentiation	  6	0.773649336373543	1	1	5	2212	7874	0.760054225033891
GO:0045652	regulation of megakaryocyte differentiation	 33	0.0416288019511491	1	12	21	2201	7858	1.65830012734667
GO:0045653	negative regulation of megakaryocyte differentiation	  5	0.302606661467939	1	2	3	2211	7876	1.82413014008134
GO:0045657	positive regulation of monocyte differentiation	  8	0.862084765369009	1	1	7	2212	7872	0.570040668775418
GO:0045662	negative regulation of myoblast differentiation	 15	0.872984249747857	1	2	13	2211	7866	0.608043380027113
GO:0045663	positive regulation of myoblast differentiation	 13	0.960053706376239	1	1	12	2212	7867	0.35079425770795
GO:0045664	regulation of neuron differentiation	 14	0.174532180096009	1	5	9	2208	7870	1.62868762507262
GO:0045665	negative regulation of neuron differentiation	 41	0.704757467436148	1	8	33	2205	7846	0.889819580527482
GO:0045666	positive regulation of neuron differentiation	 57	0.61526170024093	1	12	45	2201	7834	0.960068494779651
GO:0045667	regulation of osteoblast differentiation	  8	0.0155285424904012	1	5	3	2208	7876	2.85020334387709
GO:0045668	negative regulation of osteoblast differentiation	 28	0.599228819757412	1	6	22	2207	7857	0.977212575043574
GO:0045669	positive regulation of osteoblast differentiation	 45	0.94996451667544	1	6	39	2207	7840	0.608043380027113
GO:0045670	regulation of osteoclast differentiation	  9	0.619953536302463	1	2	7	2211	7872	1.01340563337852
GO:0045671	negative regulation of osteoclast differentiation	 15	0.670849711670293	1	3	12	2210	7867	0.912065070040669
GO:0045672	positive regulation of osteoclast differentiation	  9	0.619953536302463	1	2	7	2211	7872	1.01340563337852
GO:0045717	negative regulation of fatty acid biosynthetic process	  8	0.551915645208052	1	2	6	2211	7873	1.14008133755084
GO:0045719	negative regulation of glycogen biosynthetic process	  5	0.710033128778248	1	1	4	2212	7875	0.912065070040669
GO:0045721	negative regulation of gluconeogenesis	  9	0.892351169002328	1	1	8	2212	7871	0.50670281668926
GO:0045722	positive regulation of gluconeogenesis	  7	0.475663602521461	1	2	5	2211	7874	1.3029501000581
GO:0045723	positive regulation of fatty acid biosynthetic process	  8	0.862084765369009	1	1	7	2212	7872	0.570040668775418
GO:0045724	positive regulation of cilium assembly	  9	0.619953536302463	1	2	7	2211	7872	1.01340563337852
GO:0045725	positive regulation of glycogen biosynthetic process	 11	0.206185263049328	1	4	7	2209	7872	1.65830012734667
GO:0045727	positive regulation of translation	 43	0.129735178078158	1	13	30	2200	7849	1.37870301285217
GO:0045730	respiratory burst	  5	0.710033128778248	1	1	4	2212	7875	0.912065070040669
GO:0045732	positive regulation of protein catabolic process	 40	0.377707114884188	1	10	30	2203	7849	1.14008133755084
GO:0045736	negative regulation of cyclin-dependent protein serine/threonine kinase activity	 14	0.369358500517811	1	4	10	2209	7869	1.3029501000581
GO:0045737	positive regulation of cyclin-dependent protein serine/threonine kinase activity	 19	0.222505526992328	1	6	13	2207	7866	1.44010274216948
GO:0045739	positive regulation of DNA repair	 18	0.929856630121416	1	2	16	2211	7863	0.50670281668926
GO:0045740	positive regulation of DNA replication	 26	0.945820770982062	1	3	23	2210	7856	0.526191386561924
GO:0045741	positive regulation of epidermal growth factor-activated receptor activity	  6	0.773649336373543	1	1	5	2212	7874	0.760054225033891
GO:0045742	positive regulation of epidermal growth factor receptor signaling pathway	 15	0.872984249747857	1	2	13	2211	7866	0.608043380027113
GO:0045743	positive regulation of fibroblast growth factor receptor signaling pathway	  5	0.710033128778248	1	1	4	2212	7875	0.912065070040669
GO:0045744	negative regulation of G-protein coupled receptor protein signaling pathway	  9	0.892351169002328	1	1	8	2212	7871	0.50670281668926
GO:0045745	positive regulation of G-protein coupled receptor protein signaling pathway	  7	0.475663602521461	1	2	5	2211	7874	1.3029501000581
GO:0045746	negative regulation of Notch signaling pathway	 19	0.942719615121364	1	2	17	2211	7862	0.480034247389826
GO:0045747	positive regulation of Notch signaling pathway	 25	0.935180750360745	1	3	22	2210	7857	0.547239042024401
GO:0045762	positive regulation of adenylate cyclase activity	  7	0.82331362534889	1	1	6	2212	7873	0.651475050029049
GO:0045765	regulation of angiogenesis	 25	0.668990259355853	1	5	20	2208	7859	0.912065070040669
GO:0045766	positive regulation of angiogenesis	 70	0.793156880421422	1	13	57	2200	7822	0.846917565037764
GO:0045773	positive regulation of axon extension	 25	0.830662443344484	1	4	21	2209	7858	0.729652056032535
GO:0045776	negative regulation of blood pressure	 16	0.895524834056086	1	2	14	2211	7865	0.570040668775418
GO:0045777	positive regulation of blood pressure	  8	1	1	0	8	2213	7871	0
GO:0045778	positive regulation of ossification	 10	0.380920088506331	1	3	7	2210	7872	1.368097605061
GO:0045779	negative regulation of bone resorption	  6	0.773649336373543	1	1	5	2212	7874	0.760054225033891
GO:0045780	positive regulation of bone resorption	  9	0.619953536302463	1	2	7	2211	7872	1.01340563337852
GO:0045785	positive regulation of cell adhesion	 26	0.193065881098155	1	8	18	2205	7861	1.4031770308318
GO:0045786	negative regulation of cell cycle	 26	0.704465957620568	1	5	21	2208	7858	0.876985644269874
GO:0045787	positive regulation of cell cycle	 28	0.258581853266127	1	8	20	2205	7859	1.3029501000581
GO:0045792	negative regulation of cell size	  5	0.710033128778248	1	1	4	2212	7875	0.912065070040669
GO:0045793	positive regulation of cell size	  5	1	1	0	5	2213	7874	0
GO:0045794	negative regulation of cell volume	  5	0.710033128778248	1	1	4	2212	7875	0.912065070040669
GO:0045806	negative regulation of endocytosis	  7	1	1	0	7	2213	7872	0
GO:0045807	positive regulation of endocytosis	 16	0.262709457690152	1	5	11	2208	7868	1.42510167193854
GO:0045814	negative regulation of gene expression, epigenetic	 15	0.670849711670293	1	3	12	2210	7867	0.912065070040669
GO:0045815	positive regulation of gene expression, epigenetic	 25	0.163222101207481	1	8	17	2205	7862	1.45930411206507
GO:0045820	negative regulation of glycolytic process	  9	0.892351169002328	1	1	8	2212	7871	0.50670281668926
GO:0045821	positive regulation of glycolytic process	 11	0.206185263049328	1	4	7	2209	7872	1.65830012734667
GO:0045822	negative regulation of heart contraction	  7	0.82331362534889	1	1	6	2212	7873	0.651475050029049
GO:0045824	negative regulation of innate immune response	  5	1	1	0	5	2213	7874	0
GO:0045830	positive regulation of isotype switching	  7	0.82331362534889	1	1	6	2212	7873	0.651475050029049
GO:0045839	negative regulation of mitotic nuclear division	  5	0.710033128778248	1	1	4	2212	7875	0.912065070040669
GO:0045840	positive regulation of mitotic nuclear division	 12	0.9488167484775	1	1	11	2212	7868	0.380027112516945
GO:0045859	regulation of protein kinase activity	 28	0.599228819757412	1	6	22	2207	7857	0.977212575043574
GO:0045860	positive regulation of protein kinase activity	 44	0.651683703697105	1	9	35	2204	7844	0.932793821632502
GO:0045861	negative regulation of proteolysis	 15	0.670849711670293	1	3	12	2210	7867	0.912065070040669
GO:0045862	positive regulation of proteolysis	 13	0.135471430249234	1	5	8	2208	7871	1.75397128853975
GO:0045879	negative regulation of smoothened signaling pathway	 16	0.715200159590258	1	3	13	2210	7866	0.855061003163127
GO:0045880	positive regulation of smoothened signaling pathway	 16	0.262709457690152	1	5	11	2208	7868	1.42510167193854
GO:0045899	positive regulation of RNA polymerase II transcriptional preinitiation complex assembly	  8	1	1	0	8	2213	7871	0
GO:0045907	positive regulation of vasoconstriction	 15	1	1	0	15	2213	7864	0
GO:0045921	positive regulation of exocytosis	 18	0.929856630121416	1	2	16	2211	7863	0.50670281668926
GO:0045926	negative regulation of growth	 13	0.960053706376239	1	1	12	2212	7867	0.35079425770795
GO:0045930	negative regulation of mitotic cell cycle	 18	0.789777202096414	1	3	15	2210	7864	0.760054225033891
GO:0045931	positive regulation of mitotic cell cycle	 20	0.668528482767157	1	4	16	2209	7863	0.912065070040669
GO:0045943	positive regulation of transcription from RNA polymerase I promoter	  8	0.551915645208052	1	2	6	2211	7873	1.14008133755084
GO:0045945	positive regulation of transcription from RNA polymerase III promoter	  7	0.82331362534889	1	1	6	2212	7873	0.651475050029049
GO:0045947	negative regulation of translational initiation	  9	0.619953536302463	1	2	7	2211	7872	1.01340563337852
GO:0045948	positive regulation of translational initiation	 10	0.679711898251496	1	2	8	2211	7871	0.912065070040669
GO:0045954	positive regulation of natural killer cell mediated cytotoxicity	  8	1	1	0	8	2213	7871	0
GO:0045955	negative regulation of calcium ion-dependent exocytosis	  5	0.302606661467939	1	2	3	2211	7876	1.82413014008134
GO:0045956	positive regulation of calcium ion-dependent exocytosis	 12	0.9488167484775	1	1	11	2212	7868	0.380027112516945
GO:0045987	positive regulation of smooth muscle contraction	  9	0.619953536302463	1	2	7	2211	7872	1.01340563337852
GO:0045995	regulation of embryonic development	 10	0.915977754641309	1	1	9	2212	7870	0.456032535020334
GO:0046007	negative regulation of activated T cell proliferation	  7	0.475663602521461	1	2	5	2211	7874	1.3029501000581
GO:0046034	ATP metabolic process	 27	0.56045703727351	1	6	21	2207	7858	1.01340563337852
GO:0046037	GMP metabolic process	 11	1	1	0	11	2213	7868	0
GO:0046039	GTP metabolic process	 11	0.0712829635428583	1	5	6	2208	7873	2.07287515918334
GO:0046069	cGMP catabolic process	  5	0.302606661467939	1	2	3	2211	7876	1.82413014008134
GO:0046323	glucose import	  8	1	1	0	8	2213	7871	0
GO:0046324	regulation of glucose import	  7	0.475663602521461	1	2	5	2211	7874	1.3029501000581
GO:0046325	negative regulation of glucose import	  5	0.710033128778248	1	1	4	2212	7875	0.912065070040669
GO:0046326	positive regulation of glucose import	 19	0.222505526992328	1	6	13	2207	7866	1.44010274216948
GO:0046328	regulation of JNK cascade	 15	0.872984249747857	1	2	13	2211	7866	0.608043380027113
GO:0046329	negative regulation of JNK cascade	 18	0.579729311039596	1	4	14	2209	7865	1.01340563337852
GO:0046330	positive regulation of JNK cascade	 41	0.963372306668285	1	5	36	2208	7843	0.556137237829676
GO:0046332	SMAD binding	 39	0.646581088656118	1	8	31	2205	7848	0.935451353887865
GO:0046426	negative regulation of JAK-STAT cascade	 26	0.85360725893065	1	4	22	2209	7857	0.701588515415899
GO:0046427	positive regulation of JAK-STAT cascade	 11	1	1	0	11	2213	7868	0
GO:0046470	phosphatidylcholine metabolic process	  6	0.391952090801775	1	2	4	2211	7875	1.52010845006778
GO:0046474	glycerophospholipid biosynthetic process	  7	0.82331362534889	1	1	6	2212	7873	0.651475050029049
GO:0046475	glycerophospholipid catabolic process	  7	0.475663602521461	1	2	5	2211	7874	1.3029501000581
GO:0046486	glycerolipid metabolic process	  5	0.710033128778248	1	1	4	2212	7875	0.912065070040669
GO:0046488	phosphatidylinositol metabolic process	 20	0.992959925266813	1	1	19	2212	7860	0.228016267510167
GO:0046500	S-adenosylmethionine metabolic process	  6	0.773649336373543	1	1	5	2212	7874	0.760054225033891
GO:0046512	sphingosine biosynthetic process	  5	0.073752586889371	1	3	2	2210	7877	2.73619521012201
GO:0046513	ceramide biosynthetic process	 17	0.530544543161278	1	4	13	2209	7866	1.07301772945961
GO:0046533	negative regulation of photoreceptor cell differentiation	  5	1	1	0	5	2213	7874	0
GO:0046540	U4/U6 x U5 tri-snRNP complex	 13	0.567559963400701	1	3	10	2210	7869	1.05238277312385
GO:0046548	retinal rod cell development	  6	0.773649336373543	1	1	5	2212	7874	0.760054225033891
GO:0046549	retinal cone cell development	  5	1	1	0	5	2213	7874	0
GO:0046578	regulation of Ras protein signal transduction	  6	0.773649336373543	1	1	5	2212	7874	0.760054225033891
GO:0046579	positive regulation of Ras protein signal transduction	 17	1	1	0	17	2213	7862	0
GO:0046580	negative regulation of Ras protein signal transduction	 20	0.668528482767157	1	4	16	2209	7863	0.912065070040669
GO:0046597	negative regulation of viral entry into host cell	  7	1	1	0	7	2213	7872	0
GO:0046598	positive regulation of viral entry into host cell	  7	0.82331362534889	1	1	6	2212	7873	0.651475050029049
GO:0046599	regulation of centriole replication	  5	0.302606661467939	1	2	3	2211	7876	1.82413014008134
GO:0046620	regulation of organ growth	  8	0.862084765369009	1	1	7	2212	7872	0.570040668775418
GO:0046621	negative regulation of organ growth	  7	0.475663602521461	1	2	5	2211	7874	1.3029501000581
GO:0046622	positive regulation of organ growth	  5	0.710033128778248	1	1	4	2212	7875	0.912065070040669
GO:0046626	regulation of insulin receptor signaling pathway	  7	0.82331362534889	1	1	6	2212	7873	0.651475050029049
GO:0046627	negative regulation of insulin receptor signaling pathway	 18	0.358397855587164	1	5	13	2208	7866	1.26675704172315
GO:0046628	positive regulation of insulin receptor signaling pathway	  7	0.82331362534889	1	1	6	2212	7873	0.651475050029049
GO:0046632	alpha-beta T cell differentiation	  6	0.773649336373543	1	1	5	2212	7874	0.760054225033891
GO:0046638	positive regulation of alpha-beta T cell differentiation	  6	0.391952090801775	1	2	4	2211	7875	1.52010845006778
GO:0046653	tetrahydrofolate metabolic process	  6	0.391952090801775	1	2	4	2211	7875	1.52010845006778
GO:0046655	folic acid metabolic process	 10	0.157129881410612	1	4	6	2209	7873	1.82413014008134
GO:0046658	anchored component of plasma membrane	 14	0.968824531635628	1	1	13	2212	7866	0.325737525014525
GO:0046676	negative regulation of insulin secretion	 19	0.222505526992328	1	6	13	2207	7866	1.44010274216948
GO:0046677	response to antibiotic	 18	0.929856630121416	1	2	16	2211	7863	0.50670281668926
GO:0046685	response to arsenic-containing substance	  8	0.551915645208052	1	2	6	2211	7873	1.14008133755084
GO:0046686	response to cadmium ion	 15	0.0891240947989735	1	6	9	2207	7870	1.82413014008134
GO:0046688	response to copper ion	  8	0.862084765369009	1	1	7	2212	7872	0.570040668775418
GO:0046696	lipopolysaccharide receptor complex	  5	0.710033128778248	1	1	4	2212	7875	0.912065070040669
GO:0046697	decidualization	 15	0.975670266056184	1	1	14	2212	7865	0.304021690013556
GO:0046710	GDP metabolic process	 10	1	1	0	10	2213	7869	0
GO:0046716	muscle cell cellular homeostasis	 12	1	1	0	12	2213	7867	0
GO:0046718	viral entry into host cell	 57	0.733462680601039	1	11	46	2202	7833	0.880062786881347
GO:0046755	viral budding	  5	0.710033128778248	1	1	4	2212	7875	0.912065070040669
GO:0046784	viral mRNA export from host cell nucleus	  5	0.302606661467939	1	2	3	2211	7876	1.82413014008134
GO:0046785	microtubule polymerization	  6	0.391952090801775	1	2	4	2211	7875	1.52010845006778
GO:0046826	negative regulation of protein export from nucleus	  6	0.773649336373543	1	1	5	2212	7874	0.760054225033891
GO:0046827	positive regulation of protein export from nucleus	 13	0.313693837540153	1	4	9	2209	7870	1.4031770308318
GO:0046834	lipid phosphorylation	 10	0.915977754641309	1	1	9	2212	7870	0.456032535020334
GO:0046835	carbohydrate phosphorylation	 13	0.813973253692629	1	2	11	2211	7868	0.701588515415899
GO:0046839	phospholipid dephosphorylation	  8	1	1	0	8	2213	7871	0
GO:0046847	filopodium assembly	 11	0.206185263049328	1	4	7	2209	7872	1.65830012734667
GO:0046849	bone remodeling	  6	0.391952090801775	1	2	4	2211	7875	1.52010845006778
GO:0046850	regulation of bone remodeling	  5	0.710033128778248	1	1	4	2212	7875	0.912065070040669
GO:0046854	phosphatidylinositol phosphorylation	 58	0.0680076610240902	1	18	40	2195	7839	1.41527338454587
GO:0046855	inositol phosphate dephosphorylation	  7	1	1	0	7	2213	7872	0
GO:0046856	phosphatidylinositol dephosphorylation	 17	0.914292249229749	1	2	15	2211	7864	0.536508864729805
GO:0046873	metal ion transmembrane transporter activity	 13	0.813973253692629	1	2	11	2211	7868	0.701588515415899
GO:0046875	ephrin receptor binding	 20	0.847343512007977	1	3	17	2210	7862	0.684048802530502
GO:0046887	positive regulation of hormone secretion	  5	0.710033128778248	1	1	4	2212	7875	0.912065070040669
GO:0046888	negative regulation of hormone secretion	  6	0.773649336373543	1	1	5	2212	7874	0.760054225033891
GO:0046889	positive regulation of lipid biosynthetic process	  9	0.892351169002328	1	1	8	2212	7871	0.50670281668926
GO:0046902	regulation of mitochondrial membrane permeability	 10	1	1	0	10	2213	7869	0
GO:0046903	secretion	  6	1	1	0	6	2213	7873	0
GO:0046907	intracellular transport	 20	0.262931524136111	1	6	14	2207	7865	1.368097605061
GO:0046914	transition metal ion binding	  7	0.82331362534889	1	1	6	2212	7873	0.651475050029049
GO:0046928	regulation of neurotransmitter secretion	 13	0.567559963400701	1	3	10	2210	7869	1.05238277312385
GO:0046929	negative regulation of neurotransmitter secretion	  5	0.302606661467939	1	2	3	2211	7876	1.82413014008134
GO:0046931	pore complex assembly	  6	0.773649336373543	1	1	5	2212	7874	0.760054225033891
GO:0046933	proton-transporting ATP synthase activity, rotational mechanism	  8	1	1	0	8	2213	7871	0
GO:0046934	phosphatidylinositol-4,5-bisphosphate 3-kinase activity	 32	0.072945351926513	1	11	21	2202	7858	1.5676118391324
GO:0046939	nucleotide phosphorylation	  7	0.182673311502561	1	3	4	2210	7875	1.95442515008715
GO:0046949	fatty-acyl-CoA biosynthetic process	  6	0.123915802800268	1	3	3	2210	7876	2.28016267510167
GO:0046951	ketone body biosynthetic process	  6	0.123915802800268	1	3	3	2210	7876	2.28016267510167
GO:0046959	habituation	  5	0.302606661467939	1	2	3	2211	7876	1.82413014008134
GO:0046961	proton-transporting ATPase activity, rotational mechanism	 13	0.813973253692629	1	2	11	2211	7868	0.701588515415899
GO:0046965	retinoid X receptor binding	 12	0.258856173758332	1	4	8	2209	7871	1.52010845006778
GO:0046966	thyroid hormone receptor binding	 26	0.193065881098155	1	8	18	2205	7861	1.4031770308318
GO:0046972	histone acetyltransferase activity (H4-K16 specific)	  7	0.182673311502561	1	3	4	2210	7875	1.95442515008715
GO:0047035	testosterone dehydrogenase (NAD+) activity	  5	0.710033128778248	1	1	4	2212	7875	0.912065070040669
GO:0047134	protein-disulfide reductase activity	  5	1	1	0	5	2213	7874	0
GO:0047144	2-acylglycerol-3-phosphate O-acyltransferase activity	  8	0.551915645208052	1	2	6	2211	7873	1.14008133755084
GO:0047184	1-acylglycerophosphocholine O-acyltransferase activity	  5	0.710033128778248	1	1	4	2212	7875	0.912065070040669
GO:0047372	acylglycerol lipase activity	  7	1	1	0	7	2213	7872	0
GO:0047485	protein N-terminus binding	 68	0.420970434113158	1	16	52	2197	7827	1.07301772945961
GO:0047496	vesicle transport along microtubule	 10	0.380920088506331	1	3	7	2210	7872	1.368097605061
GO:0047497	mitochondrion transport along microtubule	  6	0.773649336373543	1	1	5	2212	7874	0.760054225033891
GO:0047555	3	  6	0.123915802800268	1	3	3	2210	7876	2.28016267510167
GO:0047617	acyl-CoA hydrolase activity	  8	1	1	0	8	2213	7871	0
GO:0048008	platelet-derived growth factor receptor signaling pathway	 26	0.704465957620568	1	5	21	2208	7858	0.876985644269874
GO:0048009	insulin-like growth factor receptor signaling pathway	 11	0.731548842740116	1	2	9	2211	7870	0.829150063673335
GO:0048010	vascular endothelial growth factor receptor signaling pathway	 51	0.993089719398478	1	5	46	2208	7833	0.447090720608171
GO:0048011	neurotrophin TRK receptor signaling pathway	 11	0.446445648052706	1	3	8	2210	7871	1.24372509551
GO:0048012	hepatocyte growth factor receptor signaling pathway	  6	1	1	0	6	2213	7873	0
GO:0048013	ephrin receptor signaling pathway	 63	0.755608123111353	1	12	51	2201	7828	0.868633400038732
GO:0048015	phosphatidylinositol-mediated signaling	 67	0.00127011599040876	0.351000289584728	26	41	2187	7838	1.76967849410876
GO:0048016	inositol phosphate-mediated signaling	  8	0.862084765369009	1	1	7	2212	7872	0.570040668775418
GO:0048018	receptor ligand activity	  8	0.551915645208052	1	2	6	2211	7873	1.14008133755084
GO:0048024	regulation of mRNA splicing, via spliceosome	 11	0.0712829635428583	1	5	6	2208	7873	2.07287515918334
GO:0048025	negative regulation of mRNA splicing, via spliceosome	 14	0.00439496971668872	0.666050571903343	8	6	2205	7873	2.6059002001162
GO:0048026	positive regulation of mRNA splicing, via spliceosome	 14	0.174532180096009	1	5	9	2208	7870	1.62868762507262
GO:0048027	mRNA 5	  9	0.619953536302463	1	2	7	2211	7872	1.01340563337852
GO:0048029	monosaccharide binding	  5	1	1	0	5	2213	7874	0
GO:0048037	cofactor binding	 14	0.846032978004182	1	2	12	2211	7867	0.651475050029049
GO:0048038	quinone binding	  6	0.391952090801775	1	2	4	2211	7875	1.52010845006778
GO:0048041	focal adhesion assembly	 21	0.157705661170843	1	7	14	2206	7865	1.52010845006778
GO:0048066	developmental pigmentation	  8	0.0155285424904012	1	5	3	2208	7876	2.85020334387709
GO:0048096	chromatin-mediated maintenance of transcription	  7	0.182673311502561	1	3	4	2210	7875	1.95442515008715
GO:0048102	autophagic cell death	  6	1	1	0	6	2213	7873	0
GO:0048103	somatic stem cell division	  7	1	1	0	7	2213	7872	0
GO:0048143	astrocyte activation	  5	0.302606661467939	1	2	3	2211	7876	1.82413014008134
GO:0048146	positive regulation of fibroblast proliferation	 33	0.951297228934078	1	4	29	2209	7850	0.552766709115557
GO:0048147	negative regulation of fibroblast proliferation	 20	0.454930598735057	1	5	15	2208	7864	1.14008133755084
GO:0048148	behavioral response to cocaine	  9	0.619953536302463	1	2	7	2211	7872	1.01340563337852
GO:0048149	behavioral response to ethanol	  5	0.710033128778248	1	1	4	2212	7875	0.912065070040669
GO:0048156	tau protein binding	  8	0.246907474461687	1	3	5	2210	7874	1.71012200632625
GO:0048167	regulation of synaptic plasticity	 28	0.96239913984799	1	3	25	2210	7854	0.488606287521787
GO:0048168	regulation of neuronal synaptic plasticity	 16	1	1	0	16	2213	7863	0
GO:0048169	regulation of long-term neuronal synaptic plasticity	 16	0.98101329485619	1	1	15	2212	7864	0.285020334387709
GO:0048170	positive regulation of long-term neuronal synaptic plasticity	  5	1	1	0	5	2213	7874	0
GO:0048172	regulation of short-term neuronal synaptic plasticity	 11	0.731548842740116	1	2	9	2211	7870	0.829150063673335
GO:0048185	activin binding	 11	1	1	0	11	2213	7868	0
GO:0048188	Set1C/COMPASS complex	  6	0.773649336373543	1	1	5	2212	7874	0.760054225033891
GO:0048193	Golgi vesicle transport	 12	0.258856173758332	1	4	8	2209	7871	1.52010845006778
GO:0048208	COPII vesicle coating	 49	0.265212747947292	1	13	36	2200	7843	1.20988223576823
GO:0048227	plasma membrane to endosome transport	  5	1	1	0	5	2213	7874	0
GO:0048240	sperm capacitation	  6	0.773649336373543	1	1	5	2212	7874	0.760054225033891
GO:0048246	macrophage chemotaxis	  7	0.475663602521461	1	2	5	2211	7874	1.3029501000581
GO:0048247	lymphocyte chemotaxis	  6	0.773649336373543	1	1	5	2212	7874	0.760054225033891
GO:0048251	elastic fiber assembly	  5	1	1	0	5	2213	7874	0
GO:0048255	mRNA stabilization	  9	0.619953536302463	1	2	7	2211	7872	1.01340563337852
GO:0048260	positive regulation of receptor-mediated endocytosis	 12	0.0298982942190106	1	6	6	2207	7873	2.28016267510167
GO:0048265	response to pain	 13	0.567559963400701	1	3	10	2210	7869	1.05238277312385
GO:0048266	behavioral response to pain	  7	0.82331362534889	1	1	6	2212	7873	0.651475050029049
GO:0048268	clathrin coat assembly	 15	0.872984249747857	1	2	13	2211	7866	0.608043380027113
GO:0048273	mitogen-activated protein kinase p38 binding	  5	0.073752586889371	1	3	2	2210	7877	2.73619521012201
GO:0048278	vesicle docking	 17	0.754769220253611	1	3	14	2210	7865	0.804763297094708
GO:0048280	vesicle fusion with Golgi apparatus	  9	0.113156370629833	1	4	5	2209	7874	2.02681126675704
GO:0048286	lung alveolus development	 18	0.358397855587164	1	5	13	2208	7866	1.26675704172315
GO:0048306	calcium-dependent protein binding	 41	0.963372306668285	1	5	36	2208	7843	0.556137237829676
GO:0048312	intracellular distribution of mitochondria	  5	0.302606661467939	1	2	3	2211	7876	1.82413014008134
GO:0048333	mesodermal cell differentiation	  9	0.619953536302463	1	2	7	2211	7872	1.01340563337852
GO:0048339	paraxial mesoderm development	  6	0.773649336373543	1	1	5	2212	7874	0.760054225033891
GO:0048341	paraxial mesoderm formation	  5	1	1	0	5	2213	7874	0
GO:0048365	Rac GTPase binding	 41	0.963372306668285	1	5	36	2208	7843	0.556137237829676
GO:0048384	retinoic acid receptor signaling pathway	 12	1	1	0	12	2213	7867	0
GO:0048407	platelet-derived growth factor binding	  6	1	1	0	6	2213	7873	0
GO:0048468	cell development	 16	0.98101329485619	1	1	15	2212	7864	0.285020334387709
GO:0048469	cell maturation	 23	0.775798815935103	1	4	19	2209	7860	0.793100060904929
GO:0048477	oogenesis	 10	0.380920088506331	1	3	7	2210	7872	1.368097605061
GO:0048484	enteric nervous system development	  7	0.82331362534889	1	1	6	2212	7873	0.651475050029049
GO:0048485	sympathetic nervous system development	  8	0.862084765369009	1	1	7	2212	7872	0.570040668775418
GO:0048487	beta-tubulin binding	 29	0.968771645692927	1	3	26	2210	7853	0.471757794848622
GO:0048488	synaptic vesicle endocytosis	 19	0.990977776999059	1	1	18	2212	7861	0.240017123694913
GO:0048489	synaptic vesicle transport	  8	0.862084765369009	1	1	7	2212	7872	0.570040668775418
GO:0048490	anterograde synaptic vesicle transport	  9	0.619953536302463	1	2	7	2211	7872	1.01340563337852
GO:0048495	Roundabout binding	  5	1	1	0	5	2213	7874	0
GO:0048500	signal recognition particle	  7	0.475663602521461	1	2	5	2211	7874	1.3029501000581
GO:0048505	regulation of timing of cell differentiation	  6	1	1	0	6	2213	7873	0
GO:0048511	rhythmic process	 97	0.210489013033758	1	25	72	2188	7807	1.17534158510395
GO:0048513	animal organ development	  8	1	1	0	8	2213	7871	0
GO:0048514	blood vessel morphogenesis	 18	0.358397855587164	1	5	13	2208	7866	1.26675704172315
GO:0048515	spermatid differentiation	  5	0.710033128778248	1	1	4	2212	7875	0.912065070040669
GO:0048524	positive regulation of viral process	  5	1	1	0	5	2213	7874	0
GO:0048535	lymph node development	  8	0.862084765369009	1	1	7	2212	7872	0.570040668775418
GO:0048536	spleen development	 20	0.454930598735057	1	5	15	2208	7864	1.14008133755084
GO:0048538	thymus development	 26	0.193065881098155	1	8	18	2205	7861	1.4031770308318
GO:0048545	response to steroid hormone	 19	0.820521257621854	1	3	16	2210	7863	0.720051371084738
GO:0048546	digestive tract morphogenesis	  8	1	1	0	8	2213	7871	0
GO:0048557	embryonic digestive tract morphogenesis	  8	0.551915645208052	1	2	6	2211	7873	1.14008133755084
GO:0048565	digestive tract development	 21	0.707764107729648	1	4	17	2209	7862	0.868633400038732
GO:0048566	embryonic digestive tract development	 15	0.872984249747857	1	2	13	2211	7866	0.608043380027113
GO:0048568	embryonic organ development	 25	0.830662443344484	1	4	21	2209	7858	0.729652056032535
GO:0048589	developmental growth	 16	0.262709457690152	1	5	11	2208	7868	1.42510167193854
GO:0048593	camera-type eye morphogenesis	 15	0.872984249747857	1	2	13	2211	7866	0.608043380027113
GO:0048596	embryonic camera-type eye morphogenesis	  9	0.892351169002328	1	1	8	2212	7871	0.50670281668926
GO:0048598	embryonic morphogenesis	 10	0.679711898251496	1	2	8	2211	7871	0.912065070040669
GO:0048608	reproductive structure development	  5	0.710033128778248	1	1	4	2212	7875	0.912065070040669
GO:0048646	anatomical structure formation involved in morphogenesis	  7	1	1	0	7	2213	7872	0
GO:0048660	regulation of smooth muscle cell proliferation	  8	0.551915645208052	1	2	6	2211	7873	1.14008133755084
GO:0048661	positive regulation of smooth muscle cell proliferation	 41	0.170055038059498	1	12	29	2201	7850	1.33472937079122
GO:0048662	negative regulation of smooth muscle cell proliferation	 16	1	1	0	16	2213	7863	0
GO:0048663	neuron fate commitment	 18	0.929856630121416	1	2	16	2211	7863	0.50670281668926
GO:0048665	neuron fate specification	  8	0.551915645208052	1	2	6	2211	7873	1.14008133755084
GO:0048666	neuron development	 43	0.475740697402522	1	10	33	2203	7846	1.06054077911706
GO:0048667	cell morphogenesis involved in neuron differentiation	  6	0.773649336373543	1	1	5	2212	7874	0.760054225033891
GO:0048668	collateral sprouting	  6	0.123915802800268	1	3	3	2210	7876	2.28016267510167
GO:0048671	negative regulation of collateral sprouting	  7	0.82331362534889	1	1	6	2212	7873	0.651475050029049
GO:0048672	positive regulation of collateral sprouting	  6	0.391952090801775	1	2	4	2211	7875	1.52010845006778
GO:0048675	axon extension	 20	0.847343512007977	1	3	17	2210	7862	0.684048802530502
GO:0048678	response to axon injury	 22	0.743498615792167	1	4	18	2209	7861	0.829150063673335
GO:0048679	regulation of axon regeneration	  6	0.773649336373543	1	1	5	2212	7874	0.760054225033891
GO:0048681	negative regulation of axon regeneration	  7	1	1	0	7	2213	7872	0
GO:0048699	generation of neurons	 11	0.206185263049328	1	4	7	2209	7872	1.65830012734667
GO:0048701	embryonic cranial skeleton morphogenesis	 23	0.391748984254665	1	6	17	2207	7862	1.18965009135739
GO:0048703	embryonic viscerocranium morphogenesis	  7	0.82331362534889	1	1	6	2212	7873	0.651475050029049
GO:0048704	embryonic skeletal system morphogenesis	 27	0.989333548477078	1	2	25	2211	7854	0.33780187779284
GO:0048705	skeletal system morphogenesis	 29	0.16668477881703	1	9	20	2204	7859	1.41527338454587
GO:0048706	embryonic skeletal system development	 20	0.668528482767157	1	4	16	2209	7863	0.912065070040669
GO:0048708	astrocyte differentiation	  7	1	1	0	7	2213	7872	0
GO:0048709	oligodendrocyte differentiation	 22	0.743498615792167	1	4	18	2209	7861	0.829150063673335
GO:0048711	positive regulation of astrocyte differentiation	  8	0.246907474461687	1	3	5	2210	7874	1.71012200632625
GO:0048712	negative regulation of astrocyte differentiation	 11	0.731548842740116	1	2	9	2211	7870	0.829150063673335
GO:0048714	positive regulation of oligodendrocyte differentiation	 12	0.508975472817498	1	3	9	2210	7870	1.14008133755084
GO:0048715	negative regulation of oligodendrocyte differentiation	  9	0.619953536302463	1	2	7	2211	7872	1.01340563337852
GO:0048730	epidermis morphogenesis	  5	0.710033128778248	1	1	4	2212	7875	0.912065070040669
GO:0048738	cardiac muscle tissue development	 11	0.731548842740116	1	2	9	2211	7870	0.829150063673335
GO:0048741	skeletal muscle fiber development	 15	0.670849711670293	1	3	12	2210	7867	0.912065070040669
GO:0048745	smooth muscle tissue development	 11	0.446445648052706	1	3	8	2210	7871	1.24372509551
GO:0048747	muscle fiber development	  9	0.892351169002328	1	1	8	2212	7871	0.50670281668926
GO:0048754	branching morphogenesis of an epithelial tube	 17	0.985183360207843	1	1	16	2212	7863	0.268254432364903
GO:0048762	mesenchymal cell differentiation	  5	0.302606661467939	1	2	3	2211	7876	1.82413014008134
GO:0048786	presynaptic active zone	 27	0.737195257699444	1	5	22	2208	7857	0.844504694482101
GO:0048791	calcium ion-regulated exocytosis of neurotransmitter	 21	0.870606746054365	1	3	18	2210	7861	0.651475050029049
GO:0048806	genitalia development	  5	0.710033128778248	1	1	4	2212	7875	0.912065070040669
GO:0048812	neuron projection morphogenesis	 47	0.986270089361792	1	5	42	2208	7837	0.485140994702483
GO:0048813	dendrite morphogenesis	 35	0.67344222412576	1	7	28	2206	7851	0.912065070040669
GO:0048814	regulation of dendrite morphogenesis	 13	0.135471430249234	1	5	8	2208	7871	1.75397128853975
GO:0048820	hair follicle maturation	  5	0.302606661467939	1	2	3	2211	7876	1.82413014008134
GO:0048821	erythrocyte development	 11	1	1	0	11	2213	7868	0
GO:0048839	inner ear development	 32	0.861473005548451	1	5	27	2208	7852	0.712550835969272
GO:0048841	regulation of axon extension involved in axon guidance	  5	1	1	0	5	2213	7874	0
GO:0048842	positive regulation of axon extension involved in axon guidance	  5	1	1	0	5	2213	7874	0
GO:0048844	artery morphogenesis	 16	0.98101329485619	1	1	15	2212	7864	0.285020334387709
GO:0048845	venous blood vessel morphogenesis	  6	0.773649336373543	1	1	5	2212	7874	0.760054225033891
GO:0048846	axon extension involved in axon guidance	  6	0.773649336373543	1	1	5	2212	7874	0.760054225033891
GO:0048853	forebrain morphogenesis	  6	0.773649336373543	1	1	5	2212	7874	0.760054225033891
GO:0048854	brain morphogenesis	 13	0.313693837540153	1	4	9	2209	7870	1.4031770308318
GO:0048856	anatomical structure development	 13	0.813973253692629	1	2	11	2211	7868	0.701588515415899
GO:0048863	stem cell differentiation	 17	0.754769220253611	1	3	14	2210	7865	0.804763297094708
GO:0048870	cell motility	 18	0.0785263715936463	1	7	11	2206	7868	1.77345985841241
GO:0048872	homeostasis of number of cells	 12	0.9488167484775	1	1	11	2212	7868	0.380027112516945
GO:0048873	homeostasis of number of cells within a tissue	 18	0.184360311948163	1	6	12	2207	7867	1.52010845006778
GO:0048935	peripheral nervous system neuron development	  5	1	1	0	5	2213	7874	0
GO:0050072	m7G(5	  7	0.475663602521461	1	2	5	2211	7874	1.3029501000581
GO:0050145	nucleoside phosphate kinase activity	  5	0.302606661467939	1	2	3	2211	7876	1.82413014008134
GO:0050291	sphingosine N-acyltransferase activity	  6	0.773649336373543	1	1	5	2212	7874	0.760054225033891
GO:0050321	tau-protein kinase activity	 12	0.77606351672464	1	2	10	2211	7869	0.760054225033891
GO:0050427	3	  9	1	1	0	9	2213	7870	0
GO:0050431	transforming growth factor beta binding	 11	0.731548842740116	1	2	9	2211	7870	0.829150063673335
GO:0050434	positive regulation of viral transcription	 18	0.358397855587164	1	5	13	2208	7866	1.26675704172315
GO:0050435	amyloid-beta metabolic process	  9	0.113156370629833	1	4	5	2209	7874	2.02681126675704
GO:0050482	arachidonic acid secretion	  9	0.619953536302463	1	2	7	2211	7872	1.01340563337852
GO:0050650	chondroitin sulfate proteoglycan biosynthetic process	  6	0.773649336373543	1	1	5	2212	7874	0.760054225033891
GO:0050658	RNA transport	  5	0.073752586889371	1	3	2	2210	7877	2.73619521012201
GO:0050660	flavin adenine dinucleotide binding	 44	0.651683703697105	1	9	35	2204	7844	0.932793821632502
GO:0050661	NADP binding	 21	0.707764107729648	1	4	17	2209	7862	0.868633400038732
GO:0050662	coenzyme binding	 11	0.206185263049328	1	4	7	2209	7872	1.65830012734667
GO:0050663	cytokine secretion	  5	1	1	0	5	2213	7874	0
GO:0050665	hydrogen peroxide biosynthetic process	  6	1	1	0	6	2213	7873	0
GO:0050673	epithelial cell proliferation	  6	0.123915802800268	1	3	3	2210	7876	2.28016267510167
GO:0050678	regulation of epithelial cell proliferation	  7	0.475663602521461	1	2	5	2211	7874	1.3029501000581
GO:0050679	positive regulation of epithelial cell proliferation	 39	0.88553881551563	1	6	33	2207	7846	0.701588515415899
GO:0050680	negative regulation of epithelial cell proliferation	 43	0.622268909324522	1	9	34	2204	7845	0.954486701205351
GO:0050681	androgen receptor binding	 28	0.0284569371160809	1	11	17	2202	7862	1.79155638757989
GO:0050684	regulation of mRNA processing	  9	0.113156370629833	1	4	5	2209	7874	2.02681126675704
GO:0050687	negative regulation of defense response to virus	  7	1	1	0	7	2213	7872	0
GO:0050688	regulation of defense response to virus	  5	1	1	0	5	2213	7874	0
GO:0050690	regulation of defense response to virus by virus	 19	0.625808905960736	1	4	15	2209	7864	0.960068494779651
GO:0050693	LBD domain binding	  5	1	1	0	5	2213	7874	0
GO:0050699	WW domain binding	 19	0.625808905960736	1	4	15	2209	7864	0.960068494779651
GO:0050700	CARD domain binding	  5	1	1	0	5	2213	7874	0
GO:0050707	regulation of cytokine secretion	  6	0.773649336373543	1	1	5	2212	7874	0.760054225033891
GO:0050708	regulation of protein secretion	  8	0.551915645208052	1	2	6	2211	7873	1.14008133755084
GO:0050709	negative regulation of protein secretion	  9	1	1	0	9	2213	7870	0
GO:0050710	negative regulation of cytokine secretion	  9	0.892351169002328	1	1	8	2212	7871	0.50670281668926
GO:0050714	positive regulation of protein secretion	 24	0.922638553518794	1	3	21	2210	7858	0.570040668775418
GO:0050715	positive regulation of cytokine secretion	 12	0.77606351672464	1	2	10	2211	7869	0.760054225033891
GO:0050718	positive regulation of interleukin-1 beta secretion	 14	0.174532180096009	1	5	9	2208	7870	1.62868762507262
GO:0050727	regulation of inflammatory response	 36	0.703664295500903	1	7	29	2206	7850	0.886729929206206
GO:0050728	negative regulation of inflammatory response	 43	0.86224828224711	1	7	36	2206	7843	0.74237854538194
GO:0050729	positive regulation of inflammatory response	 32	0.733712446046491	1	6	26	2207	7853	0.855061003163127
GO:0050730	regulation of peptidyl-tyrosine phosphorylation	 12	0.508975472817498	1	3	9	2210	7870	1.14008133755084
GO:0050731	positive regulation of peptidyl-tyrosine phosphorylation	 55	0.310823563779546	1	14	41	2199	7838	1.16081008914267
GO:0050732	negative regulation of peptidyl-tyrosine phosphorylation	  9	0.619953536302463	1	2	7	2211	7872	1.01340563337852
GO:0050733	RS domain binding	  5	0.073752586889371	1	3	2	2210	7877	2.73619521012201
GO:0050750	low-density lipoprotein particle receptor binding	 14	0.174532180096009	1	5	9	2208	7870	1.62868762507262
GO:0050764	regulation of phagocytosis	  6	0.773649336373543	1	1	5	2212	7874	0.760054225033891
GO:0050765	negative regulation of phagocytosis	  8	0.551915645208052	1	2	6	2211	7873	1.14008133755084
GO:0050766	positive regulation of phagocytosis	 18	0.988437873742338	1	1	17	2212	7862	0.25335140834463
GO:0050767	regulation of neurogenesis	 19	0.625808905960736	1	4	15	2209	7864	0.960068494779651
GO:0050768	negative regulation of neurogenesis	 13	0.567559963400701	1	3	10	2210	7869	1.05238277312385
GO:0050769	positive regulation of neurogenesis	 15	0.424675692435369	1	4	11	2209	7868	1.21608676005423
GO:0050770	regulation of axonogenesis	 18	0.929856630121416	1	2	16	2211	7863	0.50670281668926
GO:0050771	negative regulation of axonogenesis	 19	0.625808905960736	1	4	15	2209	7864	0.960068494779651
GO:0050772	positive regulation of axonogenesis	 23	0.775798815935103	1	4	19	2209	7860	0.793100060904929
GO:0050773	regulation of dendrite development	  9	0.619953536302463	1	2	7	2211	7872	1.01340563337852
GO:0050774	negative regulation of dendrite morphogenesis	  7	0.82331362534889	1	1	6	2212	7873	0.651475050029049
GO:0050775	positive regulation of dendrite morphogenesis	 16	0.262709457690152	1	5	11	2208	7868	1.42510167193854
GO:0050776	regulation of immune response	 57	0.992256807600087	1	6	51	2207	7828	0.480034247389826
GO:0050777	negative regulation of immune response	  7	1	1	0	7	2213	7872	0
GO:0050786	RAGE receptor binding	  9	0.619953536302463	1	2	7	2211	7872	1.01340563337852
GO:0050790	regulation of catalytic activity	 79	0.683693757985345	1	16	63	2197	7816	0.923610197509538
GO:0050796	regulation of insulin secretion	 45	0.801160370211347	1	8	37	2205	7842	0.810724506702817
GO:0050804	modulation of chemical synaptic transmission	 18	0.579729311039596	1	4	14	2209	7865	1.01340563337852
GO:0050805	negative regulation of synaptic transmission	  7	0.475663602521461	1	2	5	2211	7874	1.3029501000581
GO:0050806	positive regulation of synaptic transmission	 13	1	1	0	13	2213	7866	0
GO:0050808	synapse organization	 33	0.997122497181859	1	2	31	2211	7848	0.276383354557778
GO:0050811	GABA receptor binding	 13	0.313693837540153	1	4	9	2209	7870	1.4031770308318
GO:0050829	defense response to Gram-negative bacterium	 26	0.986776749649853	1	2	24	2211	7855	0.35079425770795
GO:0050830	defense response to Gram-positive bacterium	 29	0.907170755858537	1	4	25	2209	7854	0.629010393131496
GO:0050832	defense response to fungus	 13	1	1	0	13	2213	7866	0
GO:0050839	cell adhesion molecule binding	 48	0.996690080909967	1	4	44	2209	7835	0.380027112516945
GO:0050840	extracellular matrix binding	 18	0.789777202096414	1	3	15	2210	7864	0.760054225033891
GO:0050848	regulation of calcium-mediated signaling	  8	0.862084765369009	1	1	7	2212	7872	0.570040668775418
GO:0050850	positive regulation of calcium-mediated signaling	  7	0.475663602521461	1	2	5	2211	7874	1.3029501000581
GO:0050852	T cell receptor signaling pathway	 96	0.952470123654558	1	15	81	2198	7798	0.712550835969272
GO:0050853	B cell receptor signaling pathway	 17	0.985183360207843	1	1	16	2212	7863	0.268254432364903
GO:0050855	regulation of B cell receptor signaling pathway	  5	1	1	0	5	2213	7874	0
GO:0050860	negative regulation of T cell receptor signaling pathway	 11	0.446445648052706	1	3	8	2210	7871	1.24372509551
GO:0050861	positive regulation of B cell receptor signaling pathway	  6	0.391952090801775	1	2	4	2211	7875	1.52010845006778
GO:0050862	positive regulation of T cell receptor signaling pathway	  8	0.862084765369009	1	1	7	2212	7872	0.570040668775418
GO:0050868	negative regulation of T cell activation	  8	0.551915645208052	1	2	6	2211	7873	1.14008133755084
GO:0050869	negative regulation of B cell activation	  7	1	1	0	7	2213	7872	0
GO:0050870	positive regulation of T cell activation	 16	0.262709457690152	1	5	11	2208	7868	1.42510167193854
GO:0050871	positive regulation of B cell activation	  6	1	1	0	6	2213	7873	0
GO:0050872	white fat cell differentiation	  7	1	1	0	7	2213	7872	0
GO:0050873	brown fat cell differentiation	 19	0.625808905960736	1	4	15	2209	7864	0.960068494779651
GO:0050877	nervous system process	  9	0.619953536302463	1	2	7	2211	7872	1.01340563337852
GO:0050880	regulation of blood vessel size	 11	0.731548842740116	1	2	9	2211	7870	0.829150063673335
GO:0050884	neuromuscular process controlling posture	  9	0.619953536302463	1	2	7	2211	7872	1.01340563337852
GO:0050885	neuromuscular process controlling balance	 32	0.982304227289121	1	3	29	2210	7850	0.427530501581563
GO:0050890	cognition	 26	0.0157433310514595	1	11	15	2202	7864	1.92936841739372
GO:0050892	intestinal absorption	  7	1	1	0	7	2213	7872	0
GO:0050896	response to stimulus	 54	0.661488429188503	1	11	43	2202	7836	0.928955163930311
GO:0050900	leukocyte migration	 98	0.97936663346181	1	14	84	2199	7795	0.651475050029049
GO:0050901	leukocyte tethering or rolling	  8	1	1	0	8	2213	7871	0
GO:0050905	neuromuscular process	 14	0.968824531635628	1	1	13	2212	7866	0.325737525014525
GO:0050908	detection of light stimulus involved in visual perception	  6	0.773649336373543	1	1	5	2212	7874	0.760054225033891
GO:0050909	sensory perception of taste	  8	0.551915645208052	1	2	6	2211	7873	1.14008133755084
GO:0050918	positive chemotaxis	 21	0.707764107729648	1	4	17	2209	7862	0.868633400038732
GO:0050919	negative chemotaxis	 22	0.546958821448314	1	5	17	2208	7862	1.03643757959167
GO:0050921	positive regulation of chemotaxis	  7	0.475663602521461	1	2	5	2211	7874	1.3029501000581
GO:0050927	positive regulation of positive chemotaxis	  7	0.475663602521461	1	2	5	2211	7874	1.3029501000581
GO:0050930	induction of positive chemotaxis	  9	0.892351169002328	1	1	8	2212	7871	0.50670281668926
GO:0050965	detection of temperature stimulus involved in sensory perception of pain	  9	0.892351169002328	1	1	8	2212	7871	0.50670281668926
GO:0050966	detection of mechanical stimulus involved in sensory perception of pain	  8	0.862084765369009	1	1	7	2212	7872	0.570040668775418
GO:0050982	detection of mechanical stimulus	  9	0.313783026377615	1	3	6	2210	7873	1.52010845006778
GO:0050995	negative regulation of lipid catabolic process	  7	0.475663602521461	1	2	5	2211	7874	1.3029501000581
GO:0050998	nitric-oxide synthase binding	 10	0.380920088506331	1	3	7	2210	7872	1.368097605061
GO:0050999	regulation of nitric-oxide synthase activity	 18	0.579729311039596	1	4	14	2209	7865	1.01340563337852
GO:0051000	positive regulation of nitric-oxide synthase activity	  9	0.619953536302463	1	2	7	2211	7872	1.01340563337852
GO:0051004	regulation of lipoprotein lipase activity	  7	0.475663602521461	1	2	5	2211	7874	1.3029501000581
GO:0051006	positive regulation of lipoprotein lipase activity	  5	1	1	0	5	2213	7874	0
GO:0051010	microtubule plus-end binding	  9	0.313783026377615	1	3	6	2210	7873	1.52010845006778
GO:0051011	microtubule minus-end binding	  6	0.773649336373543	1	1	5	2212	7874	0.760054225033891
GO:0051013	microtubule severing	  5	1	1	0	5	2213	7874	0
GO:0051015	actin filament binding	100	0.261722709436769	1	25	75	2188	7804	1.14008133755084
GO:0051016	barbed-end actin filament capping	  8	0.551915645208052	1	2	6	2211	7873	1.14008133755084
GO:0051017	actin filament bundle assembly	 26	0.945820770982062	1	3	23	2210	7856	0.526191386561924
GO:0051018	protein kinase A binding	 12	0.77606351672464	1	2	10	2211	7869	0.760054225033891
GO:0051019	mitogen-activated protein kinase binding	 14	0.621614907823308	1	3	11	2210	7868	0.977212575043574
GO:0051020	GTPase binding	 29	0.907170755858537	1	4	25	2209	7854	0.629010393131496
GO:0051024	positive regulation of immunoglobulin secretion	  6	1	1	0	6	2213	7873	0
GO:0051028	mRNA transport	 75	0.00760035713552018	0.759712294099442	26	49	2187	7830	1.58091278807049
GO:0051044	positive regulation of membrane protein ectodomain proteolysis	  9	0.313783026377615	1	3	6	2210	7873	1.52010845006778
GO:0051056	regulation of small GTPase mediated signal transduction	100	0.19124153290953	1	26	74	2187	7805	1.18568459105287
GO:0051057	positive regulation of small GTPase mediated signal transduction	  5	0.073752586889371	1	3	2	2210	7877	2.73619521012201
GO:0051059	NF-kappaB binding	 19	0.820521257621854	1	3	16	2210	7863	0.720051371084738
GO:0051082	unfolded protein binding	 78	0.970521467086757	1	11	67	2202	7812	0.643122805797907
GO:0051084	de novo	  5	0.302606661467939	1	2	3	2211	7876	1.82413014008134
GO:0051085	chaperone mediated protein folding requiring cofactor	  7	0.82331362534889	1	1	6	2212	7873	0.651475050029049
GO:0051087	chaperone binding	 60	0.933059480920486	1	9	51	2204	7828	0.684048802530502
GO:0051090	regulation of sequence-specific DNA binding transcription factor activity	 17	0.530544543161278	1	4	13	2209	7866	1.07301772945961
GO:0051091	positive regulation of sequence-specific DNA binding transcription factor activity	 66	0.810988163971401	1	12	54	2201	7825	0.829150063673335
GO:0051092	positive regulation of NF-kappaB transcription factor activity	 80	0.704050671003907	1	16	64	2197	7815	0.912065070040669
GO:0051096	positive regulation of helicase activity	  5	0.302606661467939	1	2	3	2211	7876	1.82413014008134
GO:0051103	DNA ligation involved in DNA repair	  6	0.123915802800268	1	3	3	2210	7876	2.28016267510167
GO:0051117	ATPase binding	 50	0.683163254046113	1	10	40	2203	7839	0.912065070040669
GO:0051123	RNA polymerase II transcriptional preinitiation complex assembly	 15	0.872984249747857	1	2	13	2211	7866	0.608043380027113
GO:0051131	chaperone-mediated protein complex assembly	 12	1	1	0	12	2213	7867	0
GO:0051145	smooth muscle cell differentiation	 10	1	1	0	10	2213	7869	0
GO:0051146	striated muscle cell differentiation	  8	0.246907474461687	1	3	5	2210	7874	1.71012200632625
GO:0051149	positive regulation of muscle cell differentiation	 16	0.478664437350441	1	4	12	2209	7867	1.14008133755084
GO:0051151	negative regulation of smooth muscle cell differentiation	  7	0.182673311502561	1	3	4	2210	7875	1.95442515008715
GO:0051156	glucose 6-phosphate metabolic process	  6	1	1	0	6	2213	7873	0
GO:0051168	nuclear export	  9	0.000570108070592119	0.243487974149252	7	2	2206	7877	3.54691971682482
GO:0051170	nuclear import	 12	0.100843441631321	1	5	7	2208	7872	1.90013556258473
GO:0051205	protein insertion into membrane	  6	0.773649336373543	1	1	5	2212	7874	0.760054225033891
GO:0051209	release of sequestered calcium ion into cytosol	 26	0.00517969901686031	0.674777072890282	12	14	2201	7865	2.1047655462477
GO:0051213	dioxygenase activity	 57	0.904644959381252	1	9	48	2204	7831	0.720051371084738
GO:0051216	cartilage development	 46	0.956746544315144	1	6	40	2207	7839	0.594825045678697
GO:0051219	phosphoprotein binding	 28	0.418293834832541	1	7	21	2206	7858	1.14008133755084
GO:0051225	spindle assembly	 18	0.579729311039596	1	4	14	2209	7865	1.01340563337852
GO:0051233	spindle midzone	 12	0.9488167484775	1	1	11	2212	7868	0.380027112516945
GO:0051246	regulation of protein metabolic process	  6	1	1	0	6	2213	7873	0
GO:0051247	positive regulation of protein metabolic process	  5	1	1	0	5	2213	7874	0
GO:0051258	protein polymerization	  7	0.82331362534889	1	1	6	2212	7873	0.651475050029049
GO:0051259	protein oligomerization	 49	0.385522464311084	1	12	37	2201	7842	1.11681437147837
GO:0051262	protein tetramerization	 24	0.261279616690155	1	7	17	2206	7862	1.33009489380931
GO:0051272	positive regulation of cellular component movement	  8	0.862084765369009	1	1	7	2212	7872	0.570040668775418
GO:0051276	chromosome organization	 19	0.0387789868642295	1	8	11	2205	7868	1.9201369895593
GO:0051279	regulation of release of sequestered calcium ion into cytosol	 11	1	1	0	11	2213	7868	0
GO:0051281	positive regulation of release of sequestered calcium ion into cytosol	 15	0.872984249747857	1	2	13	2211	7866	0.608043380027113
GO:0051287	NAD binding	 23	0.391748984254665	1	6	17	2207	7862	1.18965009135739
GO:0051289	protein homotetramerization	 51	0.898440316449631	1	8	43	2205	7836	0.715345152973074
GO:0051290	protein heterotetramerization	 17	0.985183360207843	1	1	16	2212	7863	0.268254432364903
GO:0051291	protein heterooligomerization	 50	0.114989535936063	1	15	35	2198	7844	1.368097605061
GO:0051292	nuclear pore complex assembly	  9	0.619953536302463	1	2	7	2211	7872	1.01340563337852
GO:0051298	centrosome duplication	 14	0.369358500517811	1	4	10	2209	7869	1.3029501000581
GO:0051310	metaphase plate congression	  5	0.710033128778248	1	1	4	2212	7875	0.912065070040669
GO:0051321	meiotic cell cycle	 36	0.389923262713907	1	9	27	2204	7852	1.14008133755084
GO:0051371	muscle alpha-actinin binding	  8	0.551915645208052	1	2	6	2211	7873	1.14008133755084
GO:0051378	serotonin binding	  5	1	1	0	5	2213	7874	0
GO:0051379	epinephrine binding	  5	0.710033128778248	1	1	4	2212	7875	0.912065070040669
GO:0051382	kinetochore assembly	  5	0.302606661467939	1	2	3	2211	7876	1.82413014008134
GO:0051384	response to glucocorticoid	 40	0.676472902829992	1	8	32	2205	7847	0.912065070040669
GO:0051388	positive regulation of neurotrophin TRK receptor signaling pathway	  5	0.302606661467939	1	2	3	2211	7876	1.82413014008134
GO:0051393	alpha-actinin binding	 12	0.100843441631321	1	5	7	2208	7872	1.90013556258473
GO:0051402	neuron apoptotic process	 29	0.636078361210927	1	6	23	2207	7856	0.943515589697243
GO:0051403	stress-activated MAPK cascade	 17	0.754769220253611	1	3	14	2210	7865	0.804763297094708
GO:0051412	response to corticosterone	  7	0.82331362534889	1	1	6	2212	7873	0.651475050029049
GO:0051415	interphase microtubule nucleation by interphase microtubule organizing center	  5	0.710033128778248	1	1	4	2212	7875	0.912065070040669
GO:0051428	peptide hormone receptor binding	  5	0.302606661467939	1	2	3	2211	7876	1.82413014008134
GO:0051436	negative regulation of ubiquitin-protein ligase activity involved in mitotic cell cycle	 48	0.999299469205673	1	3	45	2210	7834	0.285020334387709
GO:0051437	positive regulation of ubiquitin-protein ligase activity involved in regulation of mitotic cell cycle transition	 52	0.998465264978942	1	4	48	2209	7831	0.35079425770795
GO:0051438	regulation of ubiquitin-protein transferase activity	  5	1	1	0	5	2213	7874	0
GO:0051439	regulation of ubiquitin-protein ligase activity involved in mitotic cell cycle	 10	0.915977754641309	1	1	9	2212	7870	0.456032535020334
GO:0051443	positive regulation of ubiquitin-protein transferase activity	 14	0.846032978004182	1	2	12	2211	7867	0.651475050029049
GO:0051444	negative regulation of ubiquitin-protein transferase activity	  5	0.710033128778248	1	1	4	2212	7875	0.912065070040669
GO:0051451	myoblast migration	  8	0.551915645208052	1	2	6	2211	7873	1.14008133755084
GO:0051453	regulation of intracellular pH	 18	0.789777202096414	1	3	15	2210	7864	0.760054225033891
GO:0051457	maintenance of protein location in nucleus	  8	0.862084765369009	1	1	7	2212	7872	0.570040668775418
GO:0051480	regulation of cytosolic calcium ion concentration	 20	0.992959925266813	1	1	19	2212	7860	0.228016267510167
GO:0051481	negative regulation of cytosolic calcium ion concentration	  6	0.123915802800268	1	3	3	2210	7876	2.28016267510167
GO:0051482	positive regulation of cytosolic calcium ion concentration involved in phospholipase C-activating G-protein coupled signaling pathway	 13	0.813973253692629	1	2	11	2211	7868	0.701588515415899
GO:0051489	regulation of filopodium assembly	  8	0.246907474461687	1	3	5	2210	7874	1.71012200632625
GO:0051491	positive regulation of filopodium assembly	 22	0.546958821448314	1	5	17	2208	7862	1.03643757959167
GO:0051492	regulation of stress fiber assembly	  9	0.892351169002328	1	1	8	2212	7871	0.50670281668926
GO:0051493	regulation of cytoskeleton organization	 15	0.670849711670293	1	3	12	2210	7867	0.912065070040669
GO:0051496	positive regulation of stress fiber assembly	 27	0.989333548477078	1	2	25	2211	7854	0.33780187779284
GO:0051497	negative regulation of stress fiber assembly	 13	0.813973253692629	1	2	11	2211	7868	0.701588515415899
GO:0051536	iron-sulfur cluster binding	 36	0.970678706741602	1	4	32	2209	7847	0.50670281668926
GO:0051537	2 iron, 2 sulfur cluster binding	 14	1	1	0	14	2213	7865	0
GO:0051539	4 iron, 4 sulfur cluster binding	 23	0.97499130551082	1	2	21	2211	7858	0.396550030452465
GO:0051560	mitochondrial calcium ion homeostasis	  8	0.862084765369009	1	1	7	2212	7872	0.570040668775418
GO:0051561	positive regulation of mitochondrial calcium ion concentration	  7	0.475663602521461	1	2	5	2211	7874	1.3029501000581
GO:0051568	histone H3-K4 methylation	 10	0.679711898251496	1	2	8	2211	7871	0.912065070040669
GO:0051571	positive regulation of histone H3-K4 methylation	 11	0.446445648052706	1	3	8	2210	7871	1.24372509551
GO:0051591	response to cAMP	 28	0.767187961599886	1	5	23	2208	7856	0.814343812536311
GO:0051592	response to calcium ion	 40	0.247738556627972	1	11	29	2202	7850	1.25408947130592
GO:0051593	response to folic acid	  8	0.0756163732373509	1	4	4	2209	7875	2.28016267510167
GO:0051597	response to methylmercury	  5	0.710033128778248	1	1	4	2212	7875	0.912065070040669
GO:0051601	exocyst localization	  5	0.710033128778248	1	1	4	2212	7875	0.912065070040669
GO:0051602	response to electrical stimulus	 20	0.847343512007977	1	3	17	2210	7862	0.684048802530502
GO:0051603	proteolysis involved in cellular protein catabolic process	 30	0.819235072417117	1	5	25	2208	7854	0.760054225033891
GO:0051604	protein maturation	 13	0.567559963400701	1	3	10	2210	7869	1.05238277312385
GO:0051639	actin filament network formation	  9	0.892351169002328	1	1	8	2212	7871	0.50670281668926
GO:0051642	centrosome localization	 12	0.100843441631321	1	5	7	2208	7872	1.90013556258473
GO:0051646	mitochondrion localization	  5	0.302606661467939	1	2	3	2211	7876	1.82413014008134
GO:0051647	nucleus localization	  5	0.302606661467939	1	2	3	2211	7876	1.82413014008134
GO:0051661	maintenance of centrosome location	  5	0.710033128778248	1	1	4	2212	7875	0.912065070040669
GO:0051683	establishment of Golgi localization	  8	1	1	0	8	2213	7871	0
GO:0051693	actin filament capping	 13	0.960053706376239	1	1	12	2212	7867	0.35079425770795
GO:0051721	protein phosphatase 2A binding	 20	0.454930598735057	1	5	15	2208	7864	1.14008133755084
GO:0051726	regulation of cell cycle	 86	0.326709368796429	1	21	65	2192	7814	1.11356781807291
GO:0051764	actin crosslink formation	 10	0.915977754641309	1	1	9	2212	7870	0.456032535020334
GO:0051770	positive regulation of nitric-oxide synthase biosynthetic process	  9	0.313783026377615	1	3	6	2210	7873	1.52010845006778
GO:0051775	response to redox state	  9	0.313783026377615	1	3	6	2210	7873	1.52010845006778
GO:0051781	positive regulation of cell division	 27	0.873852824362164	1	4	23	2209	7856	0.675603755585681
GO:0051782	negative regulation of cell division	  6	0.773649336373543	1	1	5	2212	7874	0.760054225033891
GO:0051787	misfolded protein binding	 10	0.679711898251496	1	2	8	2211	7871	0.912065070040669
GO:0051864	histone demethylase activity (H3-K36 specific)	  8	0.246907474461687	1	3	5	2210	7874	1.71012200632625
GO:0051865	protein autoubiquitination	 35	0.811160108955759	1	6	29	2207	7850	0.781770060034859
GO:0051879	Hsp90 protein binding	 25	0.478131092972125	1	6	19	2207	7860	1.0944780840488
GO:0051880	G-quadruplex DNA binding	  5	0.710033128778248	1	1	4	2212	7875	0.912065070040669
GO:0051881	regulation of mitochondrial membrane potential	 21	0.994506756619528	1	1	20	2212	7859	0.217158350009683
GO:0051893	regulation of focal adhesion assembly	 13	0.0117678676580869	0.921424037628202	7	6	2206	7873	2.45555980395565
GO:0051894	positive regulation of focal adhesion assembly	 12	0.508975472817498	1	3	9	2210	7870	1.14008133755084
GO:0051895	negative regulation of focal adhesion assembly	 11	1	1	0	11	2213	7868	0
GO:0051896	regulation of protein kinase B signaling	  7	0.475663602521461	1	2	5	2211	7874	1.3029501000581
GO:0051897	positive regulation of protein kinase B signaling	 51	0.950796526984054	1	7	44	2206	7835	0.625927008851439
GO:0051898	negative regulation of protein kinase B signaling	 25	0.830662443344484	1	4	21	2209	7858	0.729652056032535
GO:0051899	membrane depolarization	 17	0.914292249229749	1	2	15	2211	7864	0.536508864729805
GO:0051901	positive regulation of mitochondrial depolarization	  7	0.475663602521461	1	2	5	2211	7874	1.3029501000581
GO:0051920	peroxiredoxin activity	  7	0.82331362534889	1	1	6	2212	7873	0.651475050029049
GO:0051924	regulation of calcium ion transport	 20	0.847343512007977	1	3	17	2210	7862	0.684048802530502
GO:0051926	negative regulation of calcium ion transport	  7	1	1	0	7	2213	7872	0
GO:0051928	positive regulation of calcium ion transport	 14	0.846032978004182	1	2	12	2211	7867	0.651475050029049
GO:0051930	regulation of sensory perception of pain	 18	0.929856630121416	1	2	16	2211	7863	0.50670281668926
GO:0051932	synaptic transmission, GABAergic	  6	1	1	0	6	2213	7873	0
GO:0051959	dynein light intermediate chain binding	 13	0.0454386598426596	1	6	7	2207	7872	2.1047655462477
GO:0051963	regulation of synapse assembly	  5	0.302606661467939	1	2	3	2211	7876	1.82413014008134
GO:0051964	negative regulation of synapse assembly	  5	0.710033128778248	1	1	4	2212	7875	0.912065070040669
GO:0051965	positive regulation of synapse assembly	 51	0.979709343444412	1	6	45	2207	7834	0.536508864729805
GO:0051966	regulation of synaptic transmission, glutamatergic	 17	0.985183360207843	1	1	16	2212	7863	0.268254432364903
GO:0051967	negative regulation of synaptic transmission, glutamatergic	  5	1	1	0	5	2213	7874	0
GO:0051968	positive regulation of synaptic transmission, glutamatergic	 16	0.98101329485619	1	1	15	2212	7864	0.285020334387709
GO:0051973	positive regulation of telomerase activity	 26	0.85360725893065	1	4	22	2209	7857	0.701588515415899
GO:0051983	regulation of chromosome segregation	  5	0.073752586889371	1	3	2	2210	7877	2.73619521012201
GO:0052629	phosphatidylinositol-3,5-bisphosphate 3-phosphatase activity	 11	0.934420645831428	1	1	10	2212	7869	0.414575031836668
GO:0052659	inositol-1,3,4,5-tetrakisphosphate 5-phosphatase activity	  6	0.773649336373543	1	1	5	2212	7874	0.760054225033891
GO:0052689	carboxylic ester hydrolase activity	 26	0.85360725893065	1	4	22	2209	7857	0.701588515415899
GO:0052723	inositol hexakisphosphate 1-kinase activity	  5	0.710033128778248	1	1	4	2212	7875	0.912065070040669
GO:0052724	inositol hexakisphosphate 3-kinase activity	  5	0.710033128778248	1	1	4	2212	7875	0.912065070040669
GO:0052811	1-phosphatidylinositol-3-phosphate 4-kinase activity	  5	1	1	0	5	2213	7874	0
GO:0055007	cardiac muscle cell differentiation	 15	0.0891240947989735	1	6	9	2207	7870	1.82413014008134
GO:0055010	ventricular cardiac muscle tissue morphogenesis	 13	0.960053706376239	1	1	12	2212	7867	0.35079425770795
GO:0055015	ventricular cardiac muscle cell development	  5	1	1	0	5	2213	7874	0
GO:0055037	recycling endosome	 83	0.564516804228613	1	18	65	2195	7814	0.988986220526026
GO:0055038	recycling endosome membrane	 45	0.980824585378384	1	5	40	2208	7839	0.50670281668926
GO:0055056	D-glucose transmembrane transporter activity	  5	1	1	0	5	2213	7874	0
GO:0055072	iron ion homeostasis	 28	0.418293834832541	1	7	21	2206	7858	1.14008133755084
GO:0055074	calcium ion homeostasis	 16	0.715200159590258	1	3	13	2210	7866	0.855061003163127
GO:0055088	lipid homeostasis	 10	0.915977754641309	1	1	9	2212	7870	0.456032535020334
GO:0055089	fatty acid homeostasis	  7	0.475663602521461	1	2	5	2211	7874	1.3029501000581
GO:0055093	response to hyperoxia	 11	0.934420645831428	1	1	10	2212	7869	0.414575031836668
GO:0055117	regulation of cardiac muscle contraction	  7	0.82331362534889	1	1	6	2212	7873	0.651475050029049
GO:0055119	relaxation of cardiac muscle	  9	1	1	0	9	2213	7870	0
GO:0055123	digestive system development	  5	0.302606661467939	1	2	3	2211	7876	1.82413014008134
GO:0055131	C3HC4-type RING finger domain binding	  5	1	1	0	5	2213	7874	0
GO:0060009	Sertoli cell development	  7	0.475663602521461	1	2	5	2211	7874	1.3029501000581
GO:0060013	righting reflex	  6	0.773649336373543	1	1	5	2212	7874	0.760054225033891
GO:0060020	Bergmann glial cell differentiation	  5	0.710033128778248	1	1	4	2212	7875	0.912065070040669
GO:0060021	palate development	 50	0.550620642474527	1	11	39	2202	7840	1.00327157704474
GO:0060037	pharyngeal system development	  9	1	1	0	9	2213	7870	0
GO:0060038	cardiac muscle cell proliferation	 12	0.77606351672464	1	2	10	2211	7869	0.760054225033891
GO:0060041	retina development in camera-type eye	 42	0.968756818449471	1	5	37	2208	7842	0.542895875024208
GO:0060042	retina morphogenesis in camera-type eye	  7	0.475663602521461	1	2	5	2211	7874	1.3029501000581
GO:0060044	negative regulation of cardiac muscle cell proliferation	  9	0.892351169002328	1	1	8	2212	7871	0.50670281668926
GO:0060045	positive regulation of cardiac muscle cell proliferation	 14	0.621614907823308	1	3	11	2210	7868	0.977212575043574
GO:0060047	heart contraction	  7	0.82331362534889	1	1	6	2212	7873	0.651475050029049
GO:0060048	cardiac muscle contraction	 22	0.969157982950508	1	2	20	2211	7859	0.414575031836668
GO:0060052	neurofilament cytoskeleton organization	  6	0.773649336373543	1	1	5	2212	7874	0.760054225033891
GO:0060055	angiogenesis involved in wound healing	  6	1	1	0	6	2213	7873	0
GO:0060059	embryonic retina morphogenesis in camera-type eye	  6	0.391952090801775	1	2	4	2211	7875	1.52010845006778
GO:0060065	uterus development	  6	0.773649336373543	1	1	5	2212	7874	0.760054225033891
GO:0060068	vagina development	  7	1	1	0	7	2213	7872	0
GO:0060070	canonical Wnt signaling pathway	 49	0.935506285294256	1	7	42	2206	7837	0.651475050029049
GO:0060071	Wnt signaling pathway, planar cell polarity pathway	 75	0.999671397734414	1	6	69	2207	7810	0.364826028016268
GO:0060074	synapse maturation	  6	0.773649336373543	1	1	5	2212	7874	0.760054225033891
GO:0060075	regulation of resting membrane potential	  6	0.391952090801775	1	2	4	2211	7875	1.52010845006778
GO:0060076	excitatory synapse	 23	0.775798815935103	1	4	19	2209	7860	0.793100060904929
GO:0060077	inhibitory synapse	  9	0.619953536302463	1	2	7	2211	7872	1.01340563337852
GO:0060078	regulation of postsynaptic membrane potential	 26	0.986776749649853	1	2	24	2211	7855	0.35079425770795
GO:0060079	excitatory postsynaptic potential	 38	0.758351749702664	1	7	31	2206	7848	0.840059932932195
GO:0060080	inhibitory postsynaptic potential	  5	1	1	0	5	2213	7874	0
GO:0060081	membrane hyperpolarization	  6	1	1	0	6	2213	7873	0
GO:0060087	relaxation of vascular smooth muscle	  6	0.773649336373543	1	1	5	2212	7874	0.760054225033891
GO:0060088	auditory receptor cell stereocilium organization	  6	1	1	0	6	2213	7873	0
GO:0060117	auditory receptor cell development	  5	0.302606661467939	1	2	3	2211	7876	1.82413014008134
GO:0060119	inner ear receptor cell development	  7	0.82331362534889	1	1	6	2212	7873	0.651475050029049
GO:0060122	inner ear receptor stereocilium organization	 15	0.217236222744526	1	5	10	2208	7869	1.52010845006778
GO:0060134	prepulse inhibition	  8	1	1	0	8	2213	7871	0
GO:0060135	maternal process involved in female pregnancy	 10	1	1	0	10	2213	7869	0
GO:0060137	maternal process involved in parturition	  7	0.82331362534889	1	1	6	2212	7873	0.651475050029049
GO:0060158	phospholipase C-activating dopamine receptor signaling pathway	  6	0.391952090801775	1	2	4	2211	7875	1.52010845006778
GO:0060170	ciliary membrane	 32	0.572063532355993	1	7	25	2206	7854	0.997571170356981
GO:0060173	limb development	 26	0.193065881098155	1	8	18	2205	7861	1.4031770308318
GO:0060174	limb bud formation	  5	0.302606661467939	1	2	3	2211	7876	1.82413014008134
GO:0060179	male mating behavior	  5	0.302606661467939	1	2	3	2211	7876	1.82413014008134
GO:0060213	positive regulation of nuclear-transcribed mRNA poly(A) tail shortening	 10	0.679711898251496	1	2	8	2211	7871	0.912065070040669
GO:0060216	definitive hemopoiesis	 12	0.77606351672464	1	2	10	2211	7869	0.760054225033891
GO:0060218	hematopoietic stem cell differentiation	  6	0.391952090801775	1	2	4	2211	7875	1.52010845006778
GO:0060231	mesenchymal to epithelial transition	  5	1	1	0	5	2213	7874	0
GO:0060236	regulation of mitotic spindle organization	 12	0.9488167484775	1	1	11	2212	7868	0.380027112516945
GO:0060252	positive regulation of glial cell proliferation	  7	0.82331362534889	1	1	6	2212	7873	0.651475050029049
GO:0060253	negative regulation of glial cell proliferation	  7	0.82331362534889	1	1	6	2212	7873	0.651475050029049
GO:0060259	regulation of feeding behavior	  5	1	1	0	5	2213	7874	0
GO:0060285	cilium-dependent cell motility	  5	0.073752586889371	1	3	2	2210	7877	2.73619521012201
GO:0060291	long-term synaptic potentiation	 40	0.899688697652325	1	6	34	2207	7845	0.684048802530502
GO:0060292	long term synaptic depression	 12	0.77606351672464	1	2	10	2211	7869	0.760054225033891
GO:0060296	regulation of cilium beat frequency involved in ciliary motility	  5	0.710033128778248	1	1	4	2212	7875	0.912065070040669
GO:0060306	regulation of membrane repolarization	  7	0.82331362534889	1	1	6	2212	7873	0.651475050029049
GO:0060307	regulation of ventricular cardiac muscle cell membrane repolarization	  9	0.619953536302463	1	2	7	2211	7872	1.01340563337852
GO:0060314	regulation of ryanodine-sensitive calcium-release channel activity	 12	1	1	0	12	2213	7867	0
GO:0060315	negative regulation of ryanodine-sensitive calcium-release channel activity	  7	0.475663602521461	1	2	5	2211	7874	1.3029501000581
GO:0060317	cardiac epithelial to mesenchymal transition	  9	1	1	0	9	2213	7870	0
GO:0060322	head development	 10	0.915977754641309	1	1	9	2212	7870	0.456032535020334
GO:0060323	head morphogenesis	  6	1	1	0	6	2213	7873	0
GO:0060324	face development	 11	0.934420645831428	1	1	10	2212	7869	0.414575031836668
GO:0060325	face morphogenesis	 20	0.0525614737396124	1	8	12	2205	7867	1.82413014008134
GO:0060326	cell chemotaxis	 40	0.957145128999306	1	5	35	2208	7844	0.570040668775418
GO:0060333	interferon-gamma-mediated signaling pathway	 43	0.86224828224711	1	7	36	2206	7843	0.74237854538194
GO:0060334	regulation of interferon-gamma-mediated signaling pathway	 10	0.0471961044586633	1	5	5	2208	7874	2.28016267510167
GO:0060337	type I interferon signaling pathway	 43	0.933463995796766	1	6	37	2207	7842	0.636324467470234
GO:0060338	regulation of type I interferon-mediated signaling pathway	 12	0.100843441631321	1	5	7	2208	7872	1.90013556258473
GO:0060340	positive regulation of type I interferon-mediated signaling pathway	  6	0.391952090801775	1	2	4	2211	7875	1.52010845006778
GO:0060346	bone trabecula formation	  6	0.773649336373543	1	1	5	2212	7874	0.760054225033891
GO:0060347	heart trabecula formation	  8	0.862084765369009	1	1	7	2212	7872	0.570040668775418
GO:0060348	bone development	 37	0.424636934939564	1	9	28	2204	7851	1.10926832842784
GO:0060349	bone morphogenesis	 15	0.872984249747857	1	2	13	2211	7866	0.608043380027113
GO:0060384	innervation	 14	0.846032978004182	1	2	12	2211	7867	0.651475050029049
GO:0060389	pathway-restricted SMAD protein phosphorylation	  8	0.862084765369009	1	1	7	2212	7872	0.570040668775418
GO:0060391	positive regulation of SMAD protein import into nucleus	  9	0.619953536302463	1	2	7	2211	7872	1.01340563337852
GO:0060394	negative regulation of pathway-restricted SMAD protein phosphorylation	  8	0.246907474461687	1	3	5	2210	7874	1.71012200632625
GO:0060395	SMAD protein signal transduction	 28	0.418293834832541	1	7	21	2206	7858	1.14008133755084
GO:0060396	growth hormone receptor signaling pathway	  7	0.475663602521461	1	2	5	2211	7874	1.3029501000581
GO:0060397	JAK-STAT cascade involved in growth hormone signaling pathway	  8	0.862084765369009	1	1	7	2212	7872	0.570040668775418
GO:0060402	calcium ion transport into cytosol	 11	0.731548842740116	1	2	9	2211	7870	0.829150063673335
GO:0060411	cardiac septum morphogenesis	  6	1	1	0	6	2213	7873	0
GO:0060412	ventricular septum morphogenesis	 27	0.998760966158666	1	1	26	2212	7853	0.16890093889642
GO:0060413	atrial septum morphogenesis	  8	1	1	0	8	2213	7871	0
GO:0060416	response to growth hormone	  9	0.892351169002328	1	1	8	2212	7871	0.50670281668926
GO:0060425	lung morphogenesis	 11	1	1	0	11	2213	7868	0
GO:0060429	epithelium development	  5	1	1	0	5	2213	7874	0
GO:0060440	trachea formation	  5	1	1	0	5	2213	7874	0
GO:0060441	epithelial tube branching involved in lung morphogenesis	  8	0.862084765369009	1	1	7	2212	7872	0.570040668775418
GO:0060444	branching involved in mammary gland duct morphogenesis	  8	1	1	0	8	2213	7871	0
GO:0060445	branching involved in salivary gland morphogenesis	  6	0.391952090801775	1	2	4	2211	7875	1.52010845006778
GO:0060449	bud elongation involved in lung branching	  5	0.710033128778248	1	1	4	2212	7875	0.912065070040669
GO:0060484	lung-associated mesenchyme development	  6	0.391952090801775	1	2	4	2211	7875	1.52010845006778
GO:0060487	lung epithelial cell differentiation	  7	0.475663602521461	1	2	5	2211	7874	1.3029501000581
GO:0060544	regulation of necroptotic process	  6	0.391952090801775	1	2	4	2211	7875	1.52010845006778
GO:0060546	negative regulation of necroptotic process	  9	0.892351169002328	1	1	8	2212	7871	0.50670281668926
GO:0060548	negative regulation of cell death	 44	0.651683703697105	1	9	35	2204	7844	0.932793821632502
GO:0060563	neuroepithelial cell differentiation	  6	1	1	0	6	2213	7873	0
GO:0060586	multicellular organismal iron ion homeostasis	  5	1	1	0	5	2213	7874	0
GO:0060603	mammary gland duct morphogenesis	  5	1	1	0	5	2213	7874	0
GO:0060612	adipose tissue development	 17	0.985183360207843	1	1	16	2212	7863	0.268254432364903
GO:0060613	fat pad development	  6	1	1	0	6	2213	7873	0
GO:0060627	regulation of vesicle-mediated transport	  6	0.391952090801775	1	2	4	2211	7875	1.52010845006778
GO:0060628	regulation of ER to Golgi vesicle-mediated transport	  5	0.710033128778248	1	1	4	2212	7875	0.912065070040669
GO:0060644	mammary gland epithelial cell differentiation	  9	0.892351169002328	1	1	8	2212	7871	0.50670281668926
GO:0060670	branching involved in labyrinthine layer morphogenesis	  6	0.773649336373543	1	1	5	2212	7874	0.760054225033891
GO:0060674	placenta blood vessel development	  9	0.313783026377615	1	3	6	2210	7873	1.52010845006778
GO:0060711	labyrinthine layer development	  6	1	1	0	6	2213	7873	0
GO:0060716	labyrinthine layer blood vessel development	 13	1	1	0	13	2213	7866	0
GO:0060740	prostate gland epithelium morphogenesis	  6	0.773649336373543	1	1	5	2212	7874	0.760054225033891
GO:0060749	mammary gland alveolus development	  8	1	1	0	8	2213	7871	0
GO:0060754	positive regulation of mast cell chemotaxis	  5	0.710033128778248	1	1	4	2212	7875	0.912065070040669
GO:0060760	positive regulation of response to cytokine stimulus	  5	0.710033128778248	1	1	4	2212	7875	0.912065070040669
GO:0060765	regulation of androgen receptor signaling pathway	  8	0.246907474461687	1	3	5	2210	7874	1.71012200632625
GO:0060766	negative regulation of androgen receptor signaling pathway	  9	0.113156370629833	1	4	5	2209	7874	2.02681126675704
GO:0060789	hair follicle placode formation	  5	0.302606661467939	1	2	3	2211	7876	1.82413014008134
GO:0060828	regulation of canonical Wnt signaling pathway	 19	0.40693083008532	1	5	14	2208	7865	1.20008561847456
GO:0060831	smoothened signaling pathway involved in dorsal/ventral neural tube patterning	  7	0.82331362534889	1	1	6	2212	7873	0.651475050029049
GO:0060840	artery development	  6	1	1	0	6	2213	7873	0
GO:0060964	regulation of gene silencing by miRNA	 41	0.559799073829599	1	9	32	2204	7847	1.00104702809342
GO:0060976	coronary vasculature development	 12	0.508975472817498	1	3	9	2210	7870	1.14008133755084
GO:0060982	coronary artery morphogenesis	  7	1	1	0	7	2213	7872	0
GO:0060992	response to fungicide	  5	1	1	0	5	2213	7874	0
GO:0060993	kidney morphogenesis	  5	0.710033128778248	1	1	4	2212	7875	0.912065070040669
GO:0060996	dendritic spine development	 12	0.77606351672464	1	2	10	2211	7869	0.760054225033891
GO:0060997	dendritic spine morphogenesis	 13	0.313693837540153	1	4	9	2209	7870	1.4031770308318
GO:0060998	regulation of dendritic spine development	  5	1	1	0	5	2213	7874	0
GO:0060999	positive regulation of dendritic spine development	 19	0.40693083008532	1	5	14	2208	7865	1.20008561847456
GO:0061000	negative regulation of dendritic spine development	  5	0.710033128778248	1	1	4	2212	7875	0.912065070040669
GO:0061001	regulation of dendritic spine morphogenesis	 14	0.369358500517811	1	4	10	2209	7869	1.3029501000581
GO:0061002	negative regulation of dendritic spine morphogenesis	  7	0.475663602521461	1	2	5	2211	7874	1.3029501000581
GO:0061003	positive regulation of dendritic spine morphogenesis	 17	0.914292249229749	1	2	15	2211	7864	0.536508864729805
GO:0061014	positive regulation of mRNA catabolic process	  9	0.619953536302463	1	2	7	2211	7872	1.01340563337852
GO:0061025	membrane fusion	 28	0.140901212312353	1	9	19	2204	7860	1.46581886256536
GO:0061028	establishment of endothelial barrier	 12	0.9488167484775	1	1	11	2212	7868	0.380027112516945
GO:0061029	eyelid development in camera-type eye	  7	0.475663602521461	1	2	5	2211	7874	1.3029501000581
GO:0061036	positive regulation of cartilage development	 10	0.679711898251496	1	2	8	2211	7871	0.912065070040669
GO:0061045	negative regulation of wound healing	 10	0.679711898251496	1	2	8	2211	7871	0.912065070040669
GO:0061049	cell growth involved in cardiac muscle cell development	  5	0.302606661467939	1	2	3	2211	7876	1.82413014008134
GO:0061051	positive regulation of cell growth involved in cardiac muscle cell development	  5	1	1	0	5	2213	7874	0
GO:0061053	somite development	 10	0.679711898251496	1	2	8	2211	7871	0.912065070040669
GO:0061072	iris morphogenesis	  5	0.302606661467939	1	2	3	2211	7876	1.82413014008134
GO:0061077	chaperone-mediated protein folding	 34	0.997693872876568	1	2	32	2211	7847	0.268254432364903
GO:0061088	regulation of sequestering of zinc ion	  7	0.475663602521461	1	2	5	2211	7874	1.3029501000581
GO:0061098	positive regulation of protein tyrosine kinase activity	 21	0.501777076676569	1	5	16	2208	7863	1.08579175004842
GO:0061099	negative regulation of protein tyrosine kinase activity	 11	0.446445648052706	1	3	8	2210	7871	1.24372509551
GO:0061136	regulation of proteasomal protein catabolic process	  9	0.892351169002328	1	1	8	2212	7871	0.50670281668926
GO:0061157	mRNA destabilization	  7	0.00710205581442276	0.725336048177351	5	2	2208	7877	3.25737525014525
GO:0061158	3	  7	0.475663602521461	1	2	5	2211	7874	1.3029501000581
GO:0061178	regulation of insulin secretion involved in cellular response to glucose stimulus	 14	0.621614907823308	1	3	11	2210	7868	0.977212575043574
GO:0061179	negative regulation of insulin secretion involved in cellular response to glucose stimulus	  7	0.82331362534889	1	1	6	2212	7873	0.651475050029049
GO:0061202	clathrin-sculpted gamma-aminobutyric acid transport vesicle membrane	  7	1	1	0	7	2213	7872	0
GO:0061298	retina vasculature development in camera-type eye	  7	1	1	0	7	2213	7872	0
GO:0061299	retina vasculature morphogenesis in camera-type eye	  6	0.773649336373543	1	1	5	2212	7874	0.760054225033891
GO:0061314	Notch signaling involved in heart development	  7	1	1	0	7	2213	7872	0
GO:0061337	cardiac conduction	 30	0.819235072417117	1	5	25	2208	7854	0.760054225033891
GO:0061351	neural precursor cell proliferation	  7	0.475663602521461	1	2	5	2211	7874	1.3029501000581
GO:0061384	heart trabecula morphogenesis	  5	0.302606661467939	1	2	3	2211	7876	1.82413014008134
GO:0061418	regulation of transcription from RNA polymerase II promoter in response to hypoxia	 58	0.993439015489783	1	6	52	2207	7827	0.471757794848622
GO:0061436	establishment of skin barrier	  5	1	1	0	5	2213	7874	0
GO:0061458	reproductive system development	  5	0.073752586889371	1	3	2	2210	7877	2.73619521012201
GO:0061462	protein localization to lysosome	  5	1	1	0	5	2213	7874	0
GO:0061512	protein localization to cilium	 15	0.872984249747857	1	2	13	2211	7866	0.608043380027113
GO:0061549	sympathetic ganglion development	  6	0.773649336373543	1	1	5	2212	7874	0.760054225033891
GO:0061564	axon development	  9	0.892351169002328	1	1	8	2212	7871	0.50670281668926
GO:0061578	Lys63-specific deubiquitinase activity	  8	1	1	0	8	2213	7871	0
GO:0061617	MICOS complex	  6	0.773649336373543	1	1	5	2212	7874	0.760054225033891
GO:0061621	canonical glycolysis	 16	0.98101329485619	1	1	15	2212	7864	0.285020334387709
GO:0061626	pharyngeal arch artery morphogenesis	  5	1	1	0	5	2213	7874	0
GO:0061631	ubiquitin conjugating enzyme activity	 23	0.224654598346874	1	7	16	2206	7863	1.38792510658363
GO:0061635	regulation of protein complex stability	  5	0.710033128778248	1	1	4	2212	7875	0.912065070040669
GO:0061700	GATOR2 complex	  7	0.475663602521461	1	2	5	2211	7874	1.3029501000581
GO:0061732	mitochondrial acetyl-CoA biosynthetic process from pyruvate	  6	1	1	0	6	2213	7873	0
GO:0061844	antimicrobial humoral immune response mediated by antimicrobial peptide	 14	1	1	0	14	2213	7865	0
GO:0065009	regulation of molecular function	 44	0.877888950950871	1	7	37	2206	7842	0.725506305714168
GO:0070006	metalloaminopeptidase activity	 12	0.9488167484775	1	1	11	2212	7868	0.380027112516945
GO:0070016	armadillo repeat domain binding	  6	0.773649336373543	1	1	5	2212	7874	0.760054225033891
GO:0070034	telomerase RNA binding	 12	0.508975472817498	1	3	9	2210	7870	1.14008133755084
GO:0070059	intrinsic apoptotic signaling pathway in response to endoplasmic reticulum stress	 19	0.625808905960736	1	4	15	2209	7864	0.960068494779651
GO:0070063	RNA polymerase binding	 13	0.313693837540153	1	4	9	2209	7870	1.4031770308318
GO:0070064	proline-rich region binding	 15	0.872984249747857	1	2	13	2211	7866	0.608043380027113
GO:0070072	vacuolar proton-transporting V-type ATPase complex assembly	  7	0.475663602521461	1	2	5	2211	7874	1.3029501000581
GO:0070097	delta-catenin binding	  5	1	1	0	5	2213	7874	0
GO:0070098	chemokine-mediated signaling pathway	 25	0.997964300506561	1	1	24	2212	7855	0.182413014008134
GO:0070102	interleukin-6-mediated signaling pathway	  9	0.113156370629833	1	4	5	2209	7874	2.02681126675704
GO:0070125	mitochondrial translational elongation	 60	0.967996734647697	1	8	52	2205	7827	0.608043380027113
GO:0070126	mitochondrial translational termination	 60	0.967996734647697	1	8	52	2205	7827	0.608043380027113
GO:0070129	regulation of mitochondrial translation	  6	0.123915802800268	1	3	3	2210	7876	2.28016267510167
GO:0070131	positive regulation of mitochondrial translation	  7	0.82331362534889	1	1	6	2212	7873	0.651475050029049
GO:0070166	enamel mineralization	  5	1	1	0	5	2213	7874	0
GO:0070181	small ribosomal subunit rRNA binding	  6	0.773649336373543	1	1	5	2212	7874	0.760054225033891
GO:0070182	DNA polymerase binding	 12	0.77606351672464	1	2	10	2211	7869	0.760054225033891
GO:0070187	shelterin complex	  5	0.710033128778248	1	1	4	2212	7875	0.912065070040669
GO:0070198	protein localization to chromosome, telomeric region	  8	1	1	0	8	2213	7871	0
GO:0070207	protein homotrimerization	 15	0.424675692435369	1	4	11	2209	7868	1.21608676005423
GO:0070208	protein heterotrimerization	  9	1	1	0	9	2213	7870	0
GO:0070242	thymocyte apoptotic process	  5	0.710033128778248	1	1	4	2212	7875	0.912065070040669
GO:0070244	negative regulation of thymocyte apoptotic process	  5	0.302606661467939	1	2	3	2211	7876	1.82413014008134
GO:0070262	peptidyl-serine dephosphorylation	  6	0.773649336373543	1	1	5	2212	7874	0.760054225033891
GO:0070266	necroptotic process	 11	0.446445648052706	1	3	8	2210	7871	1.24372509551
GO:0070268	cornification	 21	1	1	0	21	2213	7858	0
GO:0070273	phosphatidylinositol-4-phosphate binding	 13	0.313693837540153	1	4	9	2209	7870	1.4031770308318
GO:0070290	N-acylphosphatidylethanolamine-specific phospholipase D activity	  5	0.710033128778248	1	1	4	2212	7875	0.912065070040669
GO:0070300	phosphatidic acid binding	 16	0.715200159590258	1	3	13	2210	7866	0.855061003163127
GO:0070301	cellular response to hydrogen peroxide	 43	0.973400610903774	1	5	38	2208	7841	0.530270389558528
GO:0070306	lens fiber cell differentiation	  7	0.182673311502561	1	3	4	2210	7875	1.95442515008715
GO:0070324	thyroid hormone binding	  5	1	1	0	5	2213	7874	0
GO:0070327	thyroid hormone transport	  5	1	1	0	5	2213	7874	0
GO:0070328	triglyceride homeostasis	 11	0.731548842740116	1	2	9	2211	7870	0.829150063673335
GO:0070330	aromatase activity	  9	1	1	0	9	2213	7870	0
GO:0070365	hepatocyte differentiation	  6	0.773649336373543	1	1	5	2212	7874	0.760054225033891
GO:0070371	ERK1 and ERK2 cascade	 17	0.985183360207843	1	1	16	2212	7863	0.268254432364903
GO:0070372	regulation of ERK1 and ERK2 cascade	 16	0.895524834056086	1	2	14	2211	7865	0.570040668775418
GO:0070373	negative regulation of ERK1 and ERK2 cascade	 42	0.591600213805964	1	9	33	2204	7846	0.977212575043574
GO:0070374	positive regulation of ERK1 and ERK2 cascade	 99	0.981659493064434	1	14	85	2199	7794	0.64489449396815
GO:0070382	exocytic vesicle	 10	1	1	0	10	2213	7869	0
GO:0070389	chaperone cofactor-dependent protein refolding	  5	0.710033128778248	1	1	4	2212	7875	0.912065070040669
GO:0070402	NADPH binding	  8	0.551915645208052	1	2	6	2211	7873	1.14008133755084
GO:0070403	NAD+ binding	  7	1	1	0	7	2213	7872	0
GO:0070410	co-SMAD binding	 10	0.679711898251496	1	2	8	2211	7871	0.912065070040669
GO:0070411	I-SMAD binding	 10	0.380920088506331	1	3	7	2210	7872	1.368097605061
GO:0070412	R-SMAD binding	 17	0.31005409346522	1	5	12	2208	7867	1.34127216182451
GO:0070417	cellular response to cold	  6	1	1	0	6	2213	7873	0
GO:0070419	nonhomologous end joining complex	  6	0.391952090801775	1	2	4	2211	7875	1.52010845006778
GO:0070423	nucleotide-binding oligomerization domain containing signaling pathway	 12	0.508975472817498	1	3	9	2210	7870	1.14008133755084
GO:0070461	SAGA-type complex	  5	0.710033128778248	1	1	4	2212	7875	0.912065070040669
GO:0070469	respiratory chain	 27	0.873852824362164	1	4	23	2209	7856	0.675603755585681
GO:0070491	repressing transcription factor binding	 29	0.4579722441856	1	7	22	2206	7857	1.10076818798012
GO:0070498	interleukin-1-mediated signaling pathway	  9	0.619953536302463	1	2	7	2211	7872	1.01340563337852
GO:0070507	regulation of microtubule cytoskeleton organization	 12	0.508975472817498	1	3	9	2210	7870	1.14008133755084
GO:0070509	calcium ion import	 12	0.9488167484775	1	1	11	2212	7868	0.380027112516945
GO:0070527	platelet aggregation	 30	0.920699322541832	1	4	26	2209	7853	0.608043380027113
GO:0070528	protein kinase C signaling	  8	1	1	0	8	2213	7871	0
GO:0070530	K63-linked polyubiquitin modification-dependent protein binding	 13	0.567559963400701	1	3	10	2210	7869	1.05238277312385
GO:0070534	protein K63-linked ubiquitination	 24	0.979750646601004	1	2	22	2211	7857	0.380027112516945
GO:0070536	protein K63-linked deubiquitination	 21	1	1	0	21	2213	7858	0
GO:0070542	response to fatty acid	 10	0.915977754641309	1	1	9	2212	7870	0.456032535020334
GO:0070544	histone H3-K36 demethylation	  8	0.246907474461687	1	3	5	2210	7874	1.71012200632625
GO:0070552	BRISC complex	  5	1	1	0	5	2213	7874	0
GO:0070555	response to interleukin-1	 24	0.804794893906303	1	4	20	2209	7859	0.760054225033891
GO:0070577	lysine-acetylated histone binding	 15	0.00157069183389773	0.368955511782578	9	6	2204	7873	2.73619521012201
GO:0070578	RISC-loading complex	  6	0.123915802800268	1	3	3	2210	7876	2.28016267510167
GO:0070584	mitochondrion morphogenesis	 13	0.960053706376239	1	1	12	2212	7867	0.35079425770795
GO:0070585	protein localization to mitochondrion	  5	0.710033128778248	1	1	4	2212	7875	0.912065070040669
GO:0070588	calcium ion transmembrane transport	 75	0.0815993343220204	1	22	53	2191	7826	1.33769543605965
GO:0070603	SWI/SNF superfamily-type complex	 11	0.206185263049328	1	4	7	2209	7872	1.65830012734667
GO:0070613	regulation of protein processing	  7	0.82331362534889	1	1	6	2212	7873	0.651475050029049
GO:0070628	proteasome binding	 10	0.915977754641309	1	1	9	2212	7870	0.456032535020334
GO:0070679	inositol 1,4,5 trisphosphate binding	  5	0.302606661467939	1	2	3	2211	7876	1.82413014008134
GO:0070723	response to cholesterol	  5	0.710033128778248	1	1	4	2212	7875	0.912065070040669
GO:0070728	leucine binding	  5	0.710033128778248	1	1	4	2212	7875	0.912065070040669
GO:0070740	tubulin-glutamic acid ligase activity	  5	0.710033128778248	1	1	4	2212	7875	0.912065070040669
GO:0070742	C2H2 zinc finger domain binding	  8	0.862084765369009	1	1	7	2212	7872	0.570040668775418
GO:0070776	MOZ/MORF histone acetyltransferase complex	  6	0.773649336373543	1	1	5	2212	7874	0.760054225033891
GO:0070816	phosphorylation of RNA polymerase II C-terminal domain	  5	0.00951539520558073	0.843458993883364	4	1	2209	7878	3.64826028016268
GO:0070821	tertiary granule membrane	 45	0.539421401961263	1	10	35	2203	7844	1.01340563337852
GO:0070830	bicellular tight junction assembly	 20	0.454930598735057	1	5	15	2208	7864	1.14008133755084
GO:0070840	dynein complex binding	 17	0.0587351915934414	1	7	10	2206	7869	1.87778102655432
GO:0070847	core mediator complex	  5	0.710033128778248	1	1	4	2212	7875	0.912065070040669
GO:0070848	response to growth factor	  8	0.862084765369009	1	1	7	2212	7872	0.570040668775418
GO:0070852	cell body fiber	  7	1	1	0	7	2213	7872	0
GO:0070886	positive regulation of calcineurin-NFAT signaling cascade	  6	0.773649336373543	1	1	5	2212	7874	0.760054225033891
GO:0070888	E-box binding	 24	0.630818426079107	1	5	19	2208	7860	0.950067781292363
GO:0070911	global genome nucleotide-excision repair	 23	0.391748984254665	1	6	17	2207	7862	1.18965009135739
GO:0070914	UV-damage excision repair	  7	0.475663602521461	1	2	5	2211	7874	1.3029501000581
GO:0070932	histone H3 deacetylation	 16	0.11719510586415	1	6	10	2207	7869	1.71012200632625
GO:0070933	histone H4 deacetylation	  7	0.182673311502561	1	3	4	2210	7875	1.95442515008715
GO:0070935	3	  9	0.892351169002328	1	1	8	2212	7871	0.50670281668926
GO:0070936	protein K48-linked ubiquitination	 38	0.109443516093778	1	12	26	2201	7853	1.44010274216948
GO:0070937	CRD-mediated mRNA stability complex	  5	0.00951539520558073	0.843458993883364	4	1	2209	7878	3.64826028016268
GO:0070938	contractile ring	  5	0.302606661467939	1	2	3	2211	7876	1.82413014008134
GO:0070971	endoplasmic reticulum exit site	 11	0.206185263049328	1	4	7	2209	7872	1.65830012734667
GO:0070979	protein K11-linked ubiquitination	 18	0.579729311039596	1	4	14	2209	7865	1.01340563337852
GO:0070986	left/right axis specification	  8	0.0155285424904012	1	5	3	2208	7876	2.85020334387709
GO:0070987	error-free translesion synthesis	 13	0.567559963400701	1	3	10	2210	7869	1.05238277312385
GO:0070997	neuron death	  7	0.475663602521461	1	2	5	2211	7874	1.3029501000581
GO:0071004	U2-type prespliceosome	 13	0.135471430249234	1	5	8	2208	7871	1.75397128853975
GO:0071011	precatalytic spliceosome	 17	0.31005409346522	1	5	12	2208	7867	1.34127216182451
GO:0071013	catalytic step 2 spliceosome	 64	0.000563800157177033	0.243487974149252	26	38	2187	7841	1.85263217352011
GO:0071028	nuclear mRNA surveillance	  9	0.113156370629833	1	4	5	2209	7874	2.02681126675704
GO:0071035	nuclear polyadenylation-dependent rRNA catabolic process	  5	0.302606661467939	1	2	3	2211	7876	1.82413014008134
GO:0071044	histone mRNA catabolic process	  8	0.0756163732373509	1	4	4	2209	7875	2.28016267510167
GO:0071108	protein K48-linked deubiquitination	 19	0.942719615121364	1	2	17	2211	7862	0.480034247389826
GO:0071141	SMAD protein complex	  6	0.123915802800268	1	3	3	2210	7876	2.28016267510167
GO:0071157	negative regulation of cell cycle arrest	 10	0.679711898251496	1	2	8	2211	7871	0.912065070040669
GO:0071158	positive regulation of cell cycle arrest	 16	0.98101329485619	1	1	15	2212	7864	0.285020334387709
GO:0071168	protein localization to chromatin	  5	0.302606661467939	1	2	3	2211	7876	1.82413014008134
GO:0071203	WASH complex	  6	0.773649336373543	1	1	5	2212	7874	0.760054225033891
GO:0071204	histone pre-mRNA 3	  5	0.710033128778248	1	1	4	2212	7875	0.912065070040669
GO:0071205	protein localization to juxtaparanode region of axon	  5	1	1	0	5	2213	7874	0
GO:0071222	cellular response to lipopolysaccharide	 74	0.952311978429952	1	11	63	2202	7816	0.677886200705903
GO:0071223	cellular response to lipoteichoic acid	  7	0.82331362534889	1	1	6	2212	7873	0.651475050029049
GO:0071230	cellular response to amino acid stimulus	 36	0.970678706741602	1	4	32	2209	7847	0.50670281668926
GO:0071233	cellular response to leucine	  6	0.773649336373543	1	1	5	2212	7874	0.760054225033891
GO:0071243	cellular response to arsenic-containing substance	  7	0.475663602521461	1	2	5	2211	7874	1.3029501000581
GO:0071253	connexin binding	  5	1	1	0	5	2213	7874	0
GO:0071257	cellular response to electrical stimulus	  7	0.82331362534889	1	1	6	2212	7873	0.651475050029049
GO:0071260	cellular response to mechanical stimulus	 50	0.798142840176615	1	9	41	2204	7838	0.820858563036602
GO:0071276	cellular response to cadmium ion	 24	0.997390780076392	1	1	23	2212	7856	0.190013556258473
GO:0071277	cellular response to calcium ion	 40	0.527013831960622	1	9	31	2204	7848	1.02607320379575
GO:0071280	cellular response to copper ion	  9	0.892351169002328	1	1	8	2212	7871	0.50670281668926
GO:0071281	cellular response to iron ion	  5	0.302606661467939	1	2	3	2211	7876	1.82413014008134
GO:0071285	cellular response to lithium ion	  9	0.892351169002328	1	1	8	2212	7871	0.50670281668926
GO:0071286	cellular response to magnesium ion	  5	0.302606661467939	1	2	3	2211	7876	1.82413014008134
GO:0071294	cellular response to zinc ion	 12	0.9488167484775	1	1	11	2212	7868	0.380027112516945
GO:0071300	cellular response to retinoic acid	 42	0.845004631553554	1	7	35	2206	7844	0.760054225033891
GO:0071305	cellular response to vitamin D	  8	1	1	0	8	2213	7871	0
GO:0071310	cellular response to organic substance	 24	0.979750646601004	1	2	22	2211	7857	0.380027112516945
GO:0071313	cellular response to caffeine	  6	0.773649336373543	1	1	5	2212	7874	0.760054225033891
GO:0071316	cellular response to nicotine	  6	1	1	0	6	2213	7873	0
GO:0071318	cellular response to ATP	  9	0.113156370629833	1	4	5	2209	7874	2.02681126675704
GO:0071320	cellular response to cAMP	 31	0.999541144196008	1	1	30	2212	7849	0.147107269361398
GO:0071333	cellular response to glucose stimulus	 38	0.459218702472665	1	9	29	2204	7850	1.08007705662711
GO:0071339	MLL1 complex	 21	0.305021869322218	1	6	15	2207	7864	1.3029501000581
GO:0071340	skeletal muscle acetylcholine-gated channel clustering	  6	0.391952090801775	1	2	4	2211	7875	1.52010845006778
GO:0071345	cellular response to cytokine stimulus	 15	0.975670266056184	1	1	14	2212	7865	0.304021690013556
GO:0071346	cellular response to interferon-gamma	 22	0.743498615792167	1	4	18	2209	7861	0.829150063673335
GO:0071347	cellular response to interleukin-1	 32	0.942567870161511	1	4	28	2209	7851	0.570040668775418
GO:0071353	cellular response to interleukin-4	 11	0.934420645831428	1	1	10	2212	7869	0.414575031836668
GO:0071354	cellular response to interleukin-6	 11	0.934420645831428	1	1	10	2212	7869	0.414575031836668
GO:0071356	cellular response to tumor necrosis factor	 63	0.910566524848693	1	10	53	2203	7826	0.723861166698944
GO:0071360	cellular response to exogenous dsRNA	  9	0.892351169002328	1	1	8	2212	7871	0.50670281668926
GO:0071361	cellular response to ethanol	 10	0.915977754641309	1	1	9	2212	7870	0.456032535020334
GO:0071363	cellular response to growth factor stimulus	 41	0.91230944978266	1	6	35	2207	7844	0.667364685395611
GO:0071364	cellular response to epidermal growth factor stimulus	 30	0.670839407999931	1	6	24	2207	7855	0.912065070040669
GO:0071372	cellular response to follicle-stimulating hormone stimulus	  9	0.313783026377615	1	3	6	2210	7873	1.52010845006778
GO:0071374	cellular response to parathyroid hormone stimulus	  5	0.710033128778248	1	1	4	2212	7875	0.912065070040669
GO:0071375	cellular response to peptide hormone stimulus	 12	0.9488167484775	1	1	11	2212	7868	0.380027112516945
GO:0071377	cellular response to glucagon stimulus	 28	0.891630301489211	1	4	24	2209	7855	0.651475050029049
GO:0071380	cellular response to prostaglandin E stimulus	 11	0.206185263049328	1	4	7	2209	7872	1.65830012734667
GO:0071383	cellular response to steroid hormone stimulus	 10	0.380920088506331	1	3	7	2210	7872	1.368097605061
GO:0071385	cellular response to glucocorticoid stimulus	 11	0.934420645831428	1	1	10	2212	7869	0.414575031836668
GO:0071391	cellular response to estrogen stimulus	  8	0.862084765369009	1	1	7	2212	7872	0.570040668775418
GO:0071392	cellular response to estradiol stimulus	 22	0.546958821448314	1	5	17	2208	7862	1.03643757959167
GO:0071394	cellular response to testosterone stimulus	  7	1	1	0	7	2213	7872	0
GO:0071397	cellular response to cholesterol	 11	0.446445648052706	1	3	8	2210	7871	1.24372509551
GO:0071398	cellular response to fatty acid	 10	1	1	0	10	2213	7869	0
GO:0071404	cellular response to low-density lipoprotein particle stimulus	  9	0.619953536302463	1	2	7	2211	7872	1.01340563337852
GO:0071407	cellular response to organic cyclic compound	 54	0.967689030998185	1	7	47	2206	7832	0.591153286137471
GO:0071420	cellular response to histamine	  7	0.82331362534889	1	1	6	2212	7873	0.651475050029049
GO:0071425	hematopoietic stem cell proliferation	 11	0.446445648052706	1	3	8	2210	7871	1.24372509551
GO:0071437	invadopodium	  6	0.773649336373543	1	1	5	2212	7874	0.760054225033891
GO:0071439	clathrin complex	  6	0.773649336373543	1	1	5	2212	7874	0.760054225033891
GO:0071455	cellular response to hyperoxia	  5	1	1	0	5	2213	7874	0
GO:0071456	cellular response to hypoxia	 73	0.946433732574316	1	11	62	2202	7817	0.687172313044339
GO:0071458	integral component of cytoplasmic side of endoplasmic reticulum membrane	  5	0.073752586889371	1	3	2	2210	7877	2.73619521012201
GO:0071467	cellular response to pH	  5	0.710033128778248	1	1	4	2212	7875	0.912065070040669
GO:0071468	cellular response to acidic pH	  5	0.710033128778248	1	1	4	2212	7875	0.912065070040669
GO:0071474	cellular hyperosmotic response	  6	1	1	0	6	2213	7873	0
GO:0071476	cellular hypotonic response	  5	0.710033128778248	1	1	4	2212	7875	0.912065070040669
GO:0071479	cellular response to ionizing radiation	 18	0.579729311039596	1	4	14	2209	7865	1.01340563337852
GO:0071480	cellular response to gamma radiation	 16	0.895524834056086	1	2	14	2211	7865	0.570040668775418
GO:0071481	cellular response to X-ray	 10	0.679711898251496	1	2	8	2211	7871	0.912065070040669
GO:0071498	cellular response to fluid shear stress	  9	0.892351169002328	1	1	8	2212	7871	0.50670281668926
GO:0071499	cellular response to laminar fluid shear stress	  5	1	1	0	5	2213	7874	0
GO:0071526	semaphorin-plexin signaling pathway	 16	0.895524834056086	1	2	14	2211	7865	0.570040668775418
GO:0071532	ankyrin repeat binding	  5	0.710033128778248	1	1	4	2212	7875	0.912065070040669
GO:0071539	protein localization to centrosome	 11	0.206185263049328	1	4	7	2209	7872	1.65830012734667
GO:0071541	eukaryotic translation initiation factor 3 complex, eIF3m	  5	0.302606661467939	1	2	3	2211	7876	1.82413014008134
GO:0071542	dopaminergic neuron differentiation	  8	0.551915645208052	1	2	6	2211	7873	1.14008133755084
GO:0071548	response to dexamethasone	  6	0.773649336373543	1	1	5	2212	7874	0.760054225033891
GO:0071549	cellular response to dexamethasone stimulus	 22	0.546958821448314	1	5	17	2208	7862	1.03643757959167
GO:0071556	integral component of lumenal side of endoplasmic reticulum membrane	 18	0.579729311039596	1	4	14	2209	7865	1.01340563337852
GO:0071559	response to transforming growth factor beta	  6	0.773649336373543	1	1	5	2212	7874	0.760054225033891
GO:0071560	cellular response to transforming growth factor beta stimulus	 37	0.424636934939564	1	9	28	2204	7851	1.10926832842784
GO:0071564	npBAF complex	  9	0.113156370629833	1	4	5	2209	7874	2.02681126675704
GO:0071565	nBAF complex	 11	0.0182918735576292	1	6	5	2207	7874	2.48745019102001
GO:0071577	zinc II ion transmembrane transport	 14	0.621614907823308	1	3	11	2210	7868	0.977212575043574
GO:0071578	zinc II ion transmembrane import	  6	0.391952090801775	1	2	4	2211	7875	1.52010845006778
GO:0071625	vocalization behavior	 12	0.508975472817498	1	3	9	2210	7870	1.14008133755084
GO:0071679	commissural neuron axon guidance	  7	0.82331362534889	1	1	6	2212	7873	0.651475050029049
GO:0071682	endocytic vesicle lumen	  9	0.619953536302463	1	2	7	2211	7872	1.01340563337852
GO:0071704	organic substance metabolic process	  5	0.302606661467939	1	2	3	2211	7876	1.82413014008134
GO:0071711	basement membrane organization	  7	1	1	0	7	2213	7872	0
GO:0071712	ER-associated misfolded protein catabolic process	  9	0.619953536302463	1	2	7	2211	7872	1.01340563337852
GO:0071732	cellular response to nitric oxide	 11	0.446445648052706	1	3	8	2210	7871	1.24372509551
GO:0071773	cellular response to BMP stimulus	 19	0.820521257621854	1	3	16	2210	7863	0.720051371084738
GO:0071774	response to fibroblast growth factor	  5	0.710033128778248	1	1	4	2212	7875	0.912065070040669
GO:0071782	endoplasmic reticulum tubular network	 10	0.380920088506331	1	3	7	2210	7872	1.368097605061
GO:0071786	endoplasmic reticulum tubular network organization	  7	0.475663602521461	1	2	5	2211	7874	1.3029501000581
GO:0071787	endoplasmic reticulum tubular network formation	  5	1	1	0	5	2213	7874	0
GO:0071803	positive regulation of podosome assembly	  5	1	1	0	5	2213	7874	0
GO:0071805	potassium ion transmembrane transport	 80	0.865075118137001	1	14	66	2199	7813	0.798056936285585
GO:0071806	protein transmembrane transport	  6	0.773649336373543	1	1	5	2212	7874	0.760054225033891
GO:0071837	HMG box domain binding	  8	0.862084765369009	1	1	7	2212	7872	0.570040668775418
GO:0071850	mitotic cell cycle arrest	 10	0.380920088506331	1	3	7	2210	7872	1.368097605061
GO:0071870	cellular response to catecholamine stimulus	  7	0.475663602521461	1	2	5	2211	7874	1.3029501000581
GO:0071872	cellular response to epinephrine stimulus	  7	0.475663602521461	1	2	5	2211	7874	1.3029501000581
GO:0071880	adenylate cyclase-activating adrenergic receptor signaling pathway	  7	0.182673311502561	1	3	4	2210	7875	1.95442515008715
GO:0071889	14-3-3 protein binding	 21	0.707764107729648	1	4	17	2209	7862	0.868633400038732
GO:0071897	DNA biosynthetic process	 17	0.31005409346522	1	5	12	2208	7867	1.34127216182451
GO:0071901	negative regulation of protein serine/threonine kinase activity	 22	0.743498615792167	1	4	18	2209	7861	0.829150063673335
GO:0071902	positive regulation of protein serine/threonine kinase activity	 29	0.968771645692927	1	3	26	2210	7853	0.471757794848622
GO:0071944	cell periphery	 38	0.979295776749504	1	4	34	2209	7845	0.480034247389826
GO:0071949	FAD binding	 15	0.217236222744526	1	5	10	2208	7869	1.52010845006778
GO:0071985	multivesicular body sorting pathway	  8	0.862084765369009	1	1	7	2212	7872	0.570040668775418
GO:0071986	Ragulator complex	  5	0.302606661467939	1	2	3	2211	7876	1.82413014008134
GO:0072001	renal system development	 18	0.929856630121416	1	2	16	2211	7863	0.50670281668926
GO:0072006	nephron development	  5	0.710033128778248	1	1	4	2212	7875	0.912065070040669
GO:0072015	glomerular visceral epithelial cell development	  7	0.475663602521461	1	2	5	2211	7874	1.3029501000581
GO:0072075	metanephric mesenchyme development	  5	0.710033128778248	1	1	4	2212	7875	0.912065070040669
GO:0072089	stem cell proliferation	  5	0.710033128778248	1	1	4	2212	7875	0.912065070040669
GO:0072091	regulation of stem cell proliferation	  6	0.123915802800268	1	3	3	2210	7876	2.28016267510167
GO:0072201	negative regulation of mesenchymal cell proliferation	  5	1	1	0	5	2213	7874	0
GO:0072321	chaperone-mediated protein transport	  5	1	1	0	5	2213	7874	0
GO:0072332	intrinsic apoptotic signaling pathway by p53 class mediator	 22	0.348159144452633	1	6	16	2207	7863	1.24372509551
GO:0072358	cardiovascular system development	 11	0.731548842740116	1	2	9	2211	7870	0.829150063673335
GO:0072383	plus-end-directed vesicle transport along microtubule	  6	0.123915802800268	1	3	3	2210	7876	2.28016267510167
GO:0072384	organelle transport along microtubule	  5	1	1	0	5	2213	7874	0
GO:0072488	ammonium transmembrane transport	  6	0.773649336373543	1	1	5	2212	7874	0.760054225033891
GO:0072520	seminiferous tubule development	  8	0.551915645208052	1	2	6	2211	7873	1.14008133755084
GO:0072546	ER membrane protein complex	  8	0.862084765369009	1	1	7	2212	7872	0.570040668775418
GO:0072562	blood microparticle	 53	0.998736832678661	1	4	49	2209	7830	0.344175498128554
GO:0072577	endothelial cell apoptotic process	  5	1	1	0	5	2213	7874	0
GO:0072583	clathrin-dependent endocytosis	 21	0.707764107729648	1	4	17	2209	7862	0.868633400038732
GO:0072593	reactive oxygen species metabolic process	 25	0.997964300506561	1	1	24	2212	7855	0.182413014008134
GO:0072655	establishment of protein localization to mitochondrion	  5	1	1	0	5	2213	7874	0
GO:0072656	maintenance of protein location in mitochondrion	  5	1	1	0	5	2213	7874	0
GO:0072657	protein localization to membrane	 10	0.915977754641309	1	1	9	2212	7870	0.456032535020334
GO:0072659	protein localization to plasma membrane	 99	0.99595757464901	1	12	87	2201	7792	0.552766709115557
GO:0072669	tRNA-splicing ligase complex	  8	0.551915645208052	1	2	6	2211	7873	1.14008133755084
GO:0072673	lamellipodium morphogenesis	  6	0.391952090801775	1	2	4	2211	7875	1.52010845006778
GO:0072686	mitotic spindle	 39	0.88553881551563	1	6	33	2207	7846	0.701588515415899
GO:0075522	IRES-dependent viral translational initiation	 10	0.380920088506331	1	3	7	2210	7872	1.368097605061
GO:0075713	establishment of integrated proviral latency	  7	0.475663602521461	1	2	5	2211	7874	1.3029501000581
GO:0075733	intracellular transport of virus	 34	0.47700764043548	1	8	26	2205	7853	1.07301772945961
GO:0080008	Cul4-RING E3 ubiquitin ligase complex	 13	0.313693837540153	1	4	9	2209	7870	1.4031770308318
GO:0080009	mRNA methylation	  5	0.302606661467939	1	2	3	2211	7876	1.82413014008134
GO:0080025	phosphatidylinositol-3,5-bisphosphate binding	 17	0.31005409346522	1	5	12	2208	7867	1.34127216182451
GO:0080111	DNA demethylation	  9	1	1	0	9	2213	7870	0
GO:0080182	histone H3-K4 trimethylation	 10	0.679711898251496	1	2	8	2211	7871	0.912065070040669
GO:0086002	cardiac muscle cell action potential involved in contraction	 12	0.77606351672464	1	2	10	2211	7869	0.760054225033891
GO:0086004	regulation of cardiac muscle cell contraction	 10	0.915977754641309	1	1	9	2212	7870	0.456032535020334
GO:0086005	ventricular cardiac muscle cell action potential	  9	0.892351169002328	1	1	8	2212	7871	0.50670281668926
GO:0086009	membrane repolarization	  7	0.82331362534889	1	1	6	2212	7873	0.651475050029049
GO:0086010	membrane depolarization during action potential	 16	0.478664437350441	1	4	12	2209	7867	1.14008133755084
GO:0086012	membrane depolarization during cardiac muscle cell action potential	 10	0.915977754641309	1	1	9	2212	7870	0.456032535020334
GO:0086013	membrane repolarization during cardiac muscle cell action potential	  7	0.82331362534889	1	1	6	2212	7873	0.651475050029049
GO:0086014	atrial cardiac muscle cell action potential	  5	1	1	0	5	2213	7874	0
GO:0086064	cell communication by electrical coupling involved in cardiac conduction	 12	0.9488167484775	1	1	11	2212	7868	0.380027112516945
GO:0086091	regulation of heart rate by cardiac conduction	 25	0.935180750360745	1	3	22	2210	7857	0.547239042024401
GO:0089711	L-glutamate transmembrane transport	 11	0.446445648052706	1	3	8	2210	7871	1.24372509551
GO:0089720	caspase binding	  5	0.302606661467939	1	2	3	2211	7876	1.82413014008134
GO:0090023	positive regulation of neutrophil chemotaxis	 15	0.872984249747857	1	2	13	2211	7866	0.608043380027113
GO:0090026	positive regulation of monocyte chemotaxis	  9	0.892351169002328	1	1	8	2212	7871	0.50670281668926
GO:0090050	positive regulation of cell migration involved in sprouting angiogenesis	  5	1	1	0	5	2213	7874	0
GO:0090051	negative regulation of cell migration involved in sprouting angiogenesis	 10	0.915977754641309	1	1	9	2212	7870	0.456032535020334
GO:0090073	positive regulation of protein homodimerization activity	  6	1	1	0	6	2213	7873	0
GO:0090084	negative regulation of inclusion body assembly	  9	1	1	0	9	2213	7870	0
GO:0090102	cochlea development	 18	0.358397855587164	1	5	13	2208	7866	1.26675704172315
GO:0090103	cochlea morphogenesis	 12	0.9488167484775	1	1	11	2212	7868	0.380027112516945
GO:0090110	cargo loading into COPII-coated vesicle	  8	0.551915645208052	1	2	6	2211	7873	1.14008133755084
GO:0090129	positive regulation of synapse maturation	  9	0.619953536302463	1	2	7	2211	7872	1.01340563337852
GO:0090136	epithelial cell-cell adhesion	  7	0.82331362534889	1	1	6	2212	7873	0.651475050029049
GO:0090140	regulation of mitochondrial fission	  7	0.0455724578638761	1	4	3	2209	7876	2.6059002001162
GO:0090141	positive regulation of mitochondrial fission	 10	0.679711898251496	1	2	8	2211	7871	0.912065070040669
GO:0090150	establishment of protein localization to membrane	  9	0.313783026377615	1	3	6	2210	7873	1.52010845006778
GO:0090160	Golgi to lysosome transport	  6	0.391952090801775	1	2	4	2211	7875	1.52010845006778
GO:0090161	Golgi ribbon formation	  9	0.113156370629833	1	4	5	2209	7874	2.02681126675704
GO:0090162	establishment of epithelial cell polarity	 10	0.157129881410612	1	4	6	2209	7873	1.82413014008134
GO:0090179	planar cell polarity pathway involved in neural tube closure	  9	1	1	0	9	2213	7870	0
GO:0090181	regulation of cholesterol metabolic process	  9	1	1	0	9	2213	7870	0
GO:0090190	positive regulation of branching involved in ureteric bud morphogenesis	 13	0.567559963400701	1	3	10	2210	7869	1.05238277312385
GO:0090197	positive regulation of chemokine secretion	  7	1	1	0	7	2213	7872	0
GO:0090200	positive regulation of release of cytochrome c from mitochondria	 23	0.97499130551082	1	2	21	2211	7858	0.396550030452465
GO:0090201	negative regulation of release of cytochrome c from mitochondria	 12	0.9488167484775	1	1	11	2212	7868	0.380027112516945
GO:0090263	positive regulation of canonical Wnt signaling pathway	 86	0.923770049123425	1	14	72	2199	7807	0.74237854538194
GO:0090279	regulation of calcium ion import	  5	0.073752586889371	1	3	2	2210	7877	2.73619521012201
GO:0090280	positive regulation of calcium ion import	  9	1	1	0	9	2213	7870	0
GO:0090303	positive regulation of wound healing	 12	0.77606351672464	1	2	10	2211	7869	0.760054225033891
GO:0090305	nucleic acid phosphodiester bond hydrolysis	 73	0.328221322601397	1	18	55	2195	7824	1.12446378498165
GO:0090307	mitotic spindle assembly	 21	0.501777076676569	1	5	16	2208	7863	1.08579175004842
GO:0090314	positive regulation of protein targeting to membrane	 22	0.348159144452633	1	6	16	2207	7863	1.24372509551
GO:0090316	positive regulation of intracellular protein transport	 21	0.305021869322218	1	6	15	2207	7864	1.3029501000581
GO:0090331	negative regulation of platelet aggregation	  8	0.551915645208052	1	2	6	2211	7873	1.14008133755084
GO:0090383	phagosome acidification	 16	0.895524834056086	1	2	14	2211	7865	0.570040668775418
GO:0090385	phagosome-lysosome fusion	  5	1	1	0	5	2213	7874	0
GO:0090394	negative regulation of excitatory postsynaptic potential	  9	0.892351169002328	1	1	8	2212	7871	0.50670281668926
GO:0090398	cellular senescence	 14	0.846032978004182	1	2	12	2211	7867	0.651475050029049
GO:0090501	RNA phosphodiester bond hydrolysis	 25	0.478131092972125	1	6	19	2207	7860	1.0944780840488
GO:0090502	RNA phosphodiester bond hydrolysis, endonucleolytic	 30	0.329625903186429	1	8	22	2205	7857	1.21608676005423
GO:0090503	RNA phosphodiester bond hydrolysis, exonucleolytic	 24	0.0608451264860104	1	9	15	2204	7864	1.71012200632625
GO:0090527	actin filament reorganization	  5	0.710033128778248	1	1	4	2212	7875	0.912065070040669
GO:0090543	Flemming body	  5	0.710033128778248	1	1	4	2212	7875	0.912065070040669
GO:0090557	establishment of endothelial intestinal barrier	  9	1	1	0	9	2213	7870	0
GO:0090575	RNA polymerase II transcription factor complex	 26	0.0416681048122677	1	10	16	2203	7863	1.75397128853975
GO:0090630	activation of GTPase activity	 48	0.967868485202187	1	6	42	2207	7837	0.570040668775418
GO:0090656	t-circle formation	  5	1	1	0	5	2213	7874	0
GO:0090662	ATP hydrolysis coupled transmembrane transport	  5	1	1	0	5	2213	7874	0
GO:0090724	central region of growth cone	  5	1	1	0	5	2213	7874	0
GO:0097009	energy homeostasis	 11	0.446445648052706	1	3	8	2210	7871	1.24372509551
GO:0097011	cellular response to granulocyte macrophage colony-stimulating factor stimulus	  6	1	1	0	6	2213	7873	0
GO:0097028	dendritic cell differentiation	  5	0.710033128778248	1	1	4	2212	7875	0.912065070040669
GO:0097038	perinuclear endoplasmic reticulum	 10	0.380920088506331	1	3	7	2210	7872	1.368097605061
GO:0097060	synaptic membrane	 18	0.988437873742338	1	1	17	2212	7862	0.25335140834463
GO:0097067	cellular response to thyroid hormone stimulus	 13	0.313693837540153	1	4	9	2209	7870	1.4031770308318
GO:0097084	vascular smooth muscle cell development	  6	0.773649336373543	1	1	5	2212	7874	0.760054225033891
GO:0097100	supercoiled DNA binding	  5	0.073752586889371	1	3	2	2210	7877	2.73619521012201
GO:0097104	postsynaptic membrane assembly	  8	0.862084765369009	1	1	7	2212	7872	0.570040668775418
GO:0097105	presynaptic membrane assembly	 10	1	1	0	10	2213	7869	0
GO:0097110	scaffold protein binding	 31	0.84151041812627	1	5	26	2208	7853	0.735536346806991
GO:0097114	NMDA glutamate receptor clustering	  5	1	1	0	5	2213	7874	0
GO:0097119	postsynaptic density protein 95 clustering	  6	0.773649336373543	1	1	5	2212	7874	0.760054225033891
GO:0097120	receptor localization to synapse	  8	1	1	0	8	2213	7871	0
GO:0097136	Bcl-2 family protein complex	  5	0.302606661467939	1	2	3	2211	7876	1.82413014008134
GO:0097150	neuronal stem cell population maintenance	 14	0.369358500517811	1	4	10	2209	7869	1.3029501000581
GO:0097153	cysteine-type endopeptidase activity involved in apoptotic process	  5	1	1	0	5	2213	7874	0
GO:0097157	pre-mRNA intronic binding	  7	0.82331362534889	1	1	6	2212	7873	0.651475050029049
GO:0097165	nuclear stress granule	  5	0.073752586889371	1	3	2	2210	7877	2.73619521012201
GO:0097178	ruffle assembly	  6	1	1	0	6	2213	7873	0
GO:0097186	amelogenesis	  6	0.773649336373543	1	1	5	2212	7874	0.760054225033891
GO:0097190	apoptotic signaling pathway	 44	0.992992588927621	1	4	40	2209	7839	0.414575031836668
GO:0097191	extrinsic apoptotic signaling pathway	 28	0.96239913984799	1	3	25	2210	7854	0.488606287521787
GO:0097192	extrinsic apoptotic signaling pathway in absence of ligand	 25	0.668990259355853	1	5	20	2208	7859	0.912065070040669
GO:0097193	intrinsic apoptotic signaling pathway	 19	0.40693083008532	1	5	14	2208	7865	1.20008561847456
GO:0097194	execution phase of apoptosis	 25	0.0316970379811876	1	10	15	2203	7864	1.82413014008134
GO:0097200	cysteine-type endopeptidase activity involved in execution phase of apoptosis	  7	0.475663602521461	1	2	5	2211	7874	1.3029501000581
GO:0097202	activation of cysteine-type endopeptidase activity	  9	0.619953536302463	1	2	7	2211	7872	1.01340563337852
GO:0097225	sperm midpiece	  7	0.475663602521461	1	2	5	2211	7874	1.3029501000581
GO:0097227	sperm annulus	  5	0.073752586889371	1	3	2	2210	7877	2.73619521012201
GO:0097228	sperm principal piece	  9	0.313783026377615	1	3	6	2210	7873	1.52010845006778
GO:0097237	cellular response to toxic substance	  5	0.710033128778248	1	1	4	2212	7875	0.912065070040669
GO:0097264	self proteolysis	  6	1	1	0	6	2213	7873	0
GO:0097284	hepatocyte apoptotic process	  7	0.82331362534889	1	1	6	2212	7873	0.651475050029049
GO:0097296	activation of cysteine-type endopeptidase activity involved in apoptotic signaling pathway	  8	0.862084765369009	1	1	7	2212	7872	0.570040668775418
GO:0097320	plasma membrane tubulation	  8	0.862084765369009	1	1	7	2212	7872	0.570040668775418
GO:0097322	7SK snRNA binding	  6	0.391952090801775	1	2	4	2211	7875	1.52010845006778
GO:0097345	mitochondrial outer membrane permeabilization	  6	0.773649336373543	1	1	5	2212	7874	0.760054225033891
GO:0097352	autophagosome maturation	 19	0.820521257621854	1	3	16	2210	7863	0.720051371084738
GO:0097398	cellular response to interleukin-17	  6	1	1	0	6	2213	7873	0
GO:0097421	liver regeneration	 21	0.501777076676569	1	5	16	2208	7863	1.08579175004842
GO:0097427	microtubule bundle	  5	1	1	0	5	2213	7874	0
GO:0097431	mitotic spindle pole	 15	0.424675692435369	1	4	11	2209	7868	1.21608676005423
GO:0097435	supramolecular fiber organization	  9	0.892351169002328	1	1	8	2212	7871	0.50670281668926
GO:0097440	apical dendrite	  9	1	1	0	9	2213	7870	0
GO:0097449	astrocyte projection	  8	1	1	0	8	2213	7871	0
GO:0097470	ribbon synapse	  5	0.710033128778248	1	1	4	2212	7875	0.912065070040669
GO:0097484	dendrite extension	  8	0.246907474461687	1	3	5	2210	7874	1.71012200632625
GO:0097485	neuron projection guidance	  5	1	1	0	5	2213	7874	0
GO:0097493	structural molecule activity conferring elasticity	  5	0.710033128778248	1	1	4	2212	7875	0.912065070040669
GO:0097502	mannosylation	 10	0.915977754641309	1	1	9	2212	7870	0.456032535020334
GO:0097503	sialylation	 13	0.813973253692629	1	2	11	2211	7868	0.701588515415899
GO:0097504	Gemini of coiled bodies	  8	0.551915645208052	1	2	6	2211	7873	1.14008133755084
GO:0097539	ciliary transition fiber	  7	0.0455724578638761	1	4	3	2209	7876	2.6059002001162
GO:0097542	ciliary tip	 38	0.0258650246612942	1	14	24	2199	7855	1.68011986586439
GO:0097546	ciliary base	 23	0.391748984254665	1	6	17	2207	7862	1.18965009135739
GO:0097602	cullin family protein binding	 10	0.679711898251496	1	2	8	2211	7871	0.912065070040669
GO:0097711	ciliary basal body-plasma membrane docking	 70	0.00570988258634514	0.674777072890282	25	45	2188	7834	1.62868762507262
GO:0097718	disordered domain specific binding	 22	0.969157982950508	1	2	20	2211	7859	0.414575031836668
GO:0097730	non-motile cilium	 16	0.262709457690152	1	5	11	2208	7868	1.42510167193854
GO:0097746	regulation of blood vessel diameter	  6	1	1	0	6	2213	7873	0
GO:0097755	positive regulation of blood vessel diameter	 13	1	1	0	13	2213	7866	0
GO:0098505	G-rich strand telomeric DNA binding	  9	0.313783026377615	1	3	6	2210	7873	1.52010845006778
GO:0098574	cytoplasmic side of lysosomal membrane	  6	1	1	0	6	2213	7873	0
GO:0098586	cellular response to virus	 10	0.679711898251496	1	2	8	2211	7871	0.912065070040669
GO:0098609	cell-cell adhesion	 76	0.992201228134663	1	9	67	2204	7812	0.540038528313554
GO:0098641	cadherin binding involved in cell-cell adhesion	 13	0.813973253692629	1	2	11	2211	7868	0.701588515415899
GO:0098655	cation transmembrane transport	 34	0.641364935399031	1	7	27	2206	7852	0.938890513277159
GO:0098656	anion transmembrane transport	 21	0.305021869322218	1	6	15	2207	7864	1.3029501000581
GO:0098664	G-protein coupled serotonin receptor signaling pathway	  5	1	1	0	5	2213	7874	0
GO:0098703	calcium ion import across plasma membrane	  7	0.0455724578638761	1	4	3	2209	7876	2.6059002001162
GO:0098719	sodium ion import across plasma membrane	  5	1	1	0	5	2213	7874	0
GO:0098742	cell-cell adhesion via plasma-membrane adhesion molecules	  7	0.475663602521461	1	2	5	2211	7874	1.3029501000581
GO:0098780	response to mitochondrial depolarisation	  5	1	1	0	5	2213	7874	0
GO:0098789	pre-mRNA cleavage required for polyadenylation	  6	0.391952090801775	1	2	4	2211	7875	1.52010845006778
GO:0098793	presynapse	 44	0.366473724682978	1	11	33	2202	7846	1.14008133755084
GO:0098794	postsynapse	 32	0.255275651027849	1	9	23	2204	7856	1.28259150474469
GO:0098821	BMP receptor activity	  5	1	1	0	5	2213	7874	0
GO:0098839	postsynaptic density membrane	  6	1	1	0	6	2213	7873	0
GO:0098869	cellular oxidant detoxification	 38	0.941703554623843	1	5	33	2208	7846	0.600042809237282
GO:0098909	regulation of cardiac muscle cell action potential involved in regulation of contraction	  6	1	1	0	6	2213	7873	0
GO:0098911	regulation of ventricular cardiac muscle cell action potential	  9	0.892351169002328	1	1	8	2212	7871	0.50670281668926
GO:0099078	BORC complex	  6	0.391952090801775	1	2	4	2211	7875	1.52010845006778
GO:0099132	ATP hydrolysis coupled cation transmembrane transport	 18	0.789777202096414	1	3	15	2210	7864	0.760054225033891
GO:0099133	ATP hydrolysis coupled anion transmembrane transport	  7	0.182673311502561	1	3	4	2210	7875	1.95442515008715
GO:0099565	chemical synaptic transmission, postsynaptic	  6	1	1	0	6	2213	7873	0
GO:0099738	cell cortex region	  8	0.0756163732373509	1	4	4	2209	7875	2.28016267510167
GO:0101003	ficolin-1-rich granule membrane	 33	0.997122497181859	1	2	31	2211	7848	0.276383354557778
GO:0102336	3-oxo-arachidoyl-CoA synthase activity	  5	0.073752586889371	1	3	2	2210	7877	2.73619521012201
GO:0102337	3-oxo-cerotoyl-CoA synthase activity	  5	0.073752586889371	1	3	2	2210	7877	2.73619521012201
GO:0102338	3-oxo-lignoceronyl-CoA synthase activity	  5	0.073752586889371	1	3	2	2210	7877	2.73619521012201
GO:0102391	decanoate--CoA ligase activity	  6	0.773649336373543	1	1	5	2212	7874	0.760054225033891
GO:0106003	amyloid-beta complex	  6	0.391952090801775	1	2	4	2211	7875	1.52010845006778
GO:1900006	positive regulation of dendrite development	 11	1	1	0	11	2213	7868	0
GO:1900016	negative regulation of cytokine production involved in inflammatory response	  7	1	1	0	7	2213	7872	0
GO:1900017	positive regulation of cytokine production involved in inflammatory response	  8	0.862084765369009	1	1	7	2212	7872	0.570040668775418
GO:1900025	negative regulation of substrate adhesion-dependent cell spreading	 10	0.915977754641309	1	1	9	2212	7870	0.456032535020334
GO:1900026	positive regulation of substrate adhesion-dependent cell spreading	 22	0.743498615792167	1	4	18	2209	7861	0.829150063673335
GO:1900027	regulation of ruffle assembly	  8	0.246907474461687	1	3	5	2210	7874	1.71012200632625
GO:1900029	positive regulation of ruffle assembly	  6	1	1	0	6	2213	7873	0
GO:1900034	regulation of cellular response to heat	 62	0.900127144036547	1	10	52	2203	7827	0.735536346806991
GO:1900087	positive regulation of G1/S transition of mitotic cell cycle	 16	0.715200159590258	1	3	13	2210	7866	0.855061003163127
GO:1900119	positive regulation of execution phase of apoptosis	  6	1	1	0	6	2213	7873	0
GO:1900153	positive regulation of nuclear-transcribed mRNA catabolic process, deadenylation-dependent decay	 11	0.731548842740116	1	2	9	2211	7870	0.829150063673335
GO:1900181	negative regulation of protein localization to nucleus	  8	0.551915645208052	1	2	6	2211	7873	1.14008133755084
GO:1900182	positive regulation of protein localization to nucleus	 11	0.934420645831428	1	1	10	2212	7869	0.414575031836668
GO:1900246	positive regulation of RIG-I signaling pathway	  5	0.710033128778248	1	1	4	2212	7875	0.912065070040669
GO:1900264	positive regulation of DNA-directed DNA polymerase activity	  6	0.773649336373543	1	1	5	2212	7874	0.760054225033891
GO:1900271	regulation of long-term synaptic potentiation	  6	0.391952090801775	1	2	4	2211	7875	1.52010845006778
GO:1900272	negative regulation of long-term synaptic potentiation	  6	0.391952090801775	1	2	4	2211	7875	1.52010845006778
GO:1900273	positive regulation of long-term synaptic potentiation	 11	1	1	0	11	2213	7868	0
GO:1900364	negative regulation of mRNA polyadenylation	  6	0.391952090801775	1	2	4	2211	7875	1.52010845006778
GO:1900740	positive regulation of protein insertion into mitochondrial membrane involved in apoptotic signaling pathway	 20	0.847343512007977	1	3	17	2210	7862	0.684048802530502
GO:1900745	positive regulation of p38MAPK cascade	 12	0.77606351672464	1	2	10	2211	7869	0.760054225033891
GO:1901016	regulation of potassium ion transmembrane transporter activity	  7	0.82331362534889	1	1	6	2212	7873	0.651475050029049
GO:1901017	negative regulation of potassium ion transmembrane transporter activity	  7	0.475663602521461	1	2	5	2211	7874	1.3029501000581
GO:1901018	positive regulation of potassium ion transmembrane transporter activity	  5	1	1	0	5	2213	7874	0
GO:1901029	negative regulation of mitochondrial outer membrane permeabilization involved in apoptotic signaling pathway	  7	1	1	0	7	2213	7872	0
GO:1901030	positive regulation of mitochondrial outer membrane permeabilization involved in apoptotic signaling pathway	  9	1	1	0	9	2213	7870	0
GO:1901185	negative regulation of ERBB signaling pathway	 10	0.679711898251496	1	2	8	2211	7871	0.912065070040669
GO:1901214	regulation of neuron death	 11	0.934420645831428	1	1	10	2212	7869	0.414575031836668
GO:1901215	negative regulation of neuron death	 32	0.942567870161511	1	4	28	2209	7851	0.570040668775418
GO:1901216	positive regulation of neuron death	 22	0.546958821448314	1	5	17	2208	7862	1.03643757959167
GO:1901222	regulation of NIK/NF-kappaB signaling	  6	0.123915802800268	1	3	3	2210	7876	2.28016267510167
GO:1901223	negative regulation of NIK/NF-kappaB signaling	  7	0.82331362534889	1	1	6	2212	7873	0.651475050029049
GO:1901224	positive regulation of NIK/NF-kappaB signaling	 18	0.358397855587164	1	5	13	2208	7866	1.26675704172315
GO:1901379	regulation of potassium ion transmembrane transport	 13	0.813973253692629	1	2	11	2211	7868	0.701588515415899
GO:1901380	negative regulation of potassium ion transmembrane transport	  6	0.391952090801775	1	2	4	2211	7875	1.52010845006778
GO:1901381	positive regulation of potassium ion transmembrane transport	 10	0.679711898251496	1	2	8	2211	7871	0.912065070040669
GO:1901385	regulation of voltage-gated calcium channel activity	  6	0.773649336373543	1	1	5	2212	7874	0.760054225033891
GO:1901409	positive regulation of phosphorylation of RNA polymerase II C-terminal domain	  7	0.0455724578638761	1	4	3	2209	7876	2.6059002001162
GO:1901522	positive regulation of transcription from RNA polymerase II promoter involved in cellular response to chemical stimulus	  8	0.246907474461687	1	3	5	2210	7874	1.71012200632625
GO:1901612	cardiolipin binding	  6	0.773649336373543	1	1	5	2212	7874	0.760054225033891
GO:1901621	negative regulation of smoothened signaling pathway involved in dorsal/ventral neural tube patterning	  5	1	1	0	5	2213	7874	0
GO:1901652	response to peptide	  7	1	1	0	7	2213	7872	0
GO:1901653	cellular response to peptide	 12	0.508975472817498	1	3	9	2210	7870	1.14008133755084
GO:1901673	regulation of mitotic spindle assembly	 11	0.446445648052706	1	3	8	2210	7871	1.24372509551
GO:1901687	glutathione derivative biosynthetic process	 11	0.934420645831428	1	1	10	2212	7869	0.414575031836668
GO:1901727	positive regulation of histone deacetylase activity	  5	1	1	0	5	2213	7874	0
GO:1901741	positive regulation of myoblast fusion	  8	1	1	0	8	2213	7871	0
GO:1901796	regulation of signal transduction by p53 class mediator	 82	0.334577777232454	1	20	62	2193	7817	1.11227447565935
GO:1901799	negative regulation of proteasomal protein catabolic process	  6	0.391952090801775	1	2	4	2211	7875	1.52010845006778
GO:1901800	positive regulation of proteasomal protein catabolic process	 12	0.9488167484775	1	1	11	2212	7868	0.380027112516945
GO:1901838	positive regulation of transcription of nuclear large rRNA transcript from RNA polymerase I promoter	  5	0.710033128778248	1	1	4	2212	7875	0.912065070040669
GO:1901981	phosphatidylinositol phosphate binding	  6	0.773649336373543	1	1	5	2212	7874	0.760054225033891
GO:1901998	toxin transport	 26	0.85360725893065	1	4	22	2209	7857	0.701588515415899
GO:1902017	regulation of cilium assembly	 10	0.157129881410612	1	4	6	2209	7873	1.82413014008134
GO:1902018	negative regulation of cilium assembly	  5	0.073752586889371	1	3	2	2210	7877	2.73619521012201
GO:1902036	regulation of hematopoietic stem cell differentiation	 57	0.979122339004424	1	7	50	2206	7829	0.56003995528813
GO:1902041	regulation of extrinsic apoptotic signaling pathway via death domain receptors	 13	0.960053706376239	1	1	12	2212	7867	0.35079425770795
GO:1902042	negative regulation of extrinsic apoptotic signaling pathway via death domain receptors	 24	0.804794893906303	1	4	20	2209	7859	0.760054225033891
GO:1902043	positive regulation of extrinsic apoptotic signaling pathway via death domain receptors	  9	0.313783026377615	1	3	6	2210	7873	1.52010845006778
GO:1902065	response to L-glutamate	  6	0.391952090801775	1	2	4	2211	7875	1.52010845006778
GO:1902083	negative regulation of peptidyl-cysteine S-nitrosylation	  5	0.710033128778248	1	1	4	2212	7875	0.912065070040669
GO:1902166	negative regulation of intrinsic apoptotic signaling pathway in response to DNA damage by p53 class mediator	  6	1	1	0	6	2213	7873	0
GO:1902176	negative regulation of oxidative stress-induced intrinsic apoptotic signaling pathway	  7	0.82331362534889	1	1	6	2212	7873	0.651475050029049
GO:1902187	negative regulation of viral release from host cell	  5	0.302606661467939	1	2	3	2211	7876	1.82413014008134
GO:1902188	positive regulation of viral release from host cell	  7	0.475663602521461	1	2	5	2211	7874	1.3029501000581
GO:1902230	negative regulation of intrinsic apoptotic signaling pathway in response to DNA damage	 10	0.915977754641309	1	1	9	2212	7870	0.456032535020334
GO:1902236	negative regulation of endoplasmic reticulum stress-induced intrinsic apoptotic signaling pathway	 10	0.679711898251496	1	2	8	2211	7871	0.912065070040669
GO:1902237	positive regulation of endoplasmic reticulum stress-induced intrinsic apoptotic signaling pathway	  7	0.182673311502561	1	3	4	2210	7875	1.95442515008715
GO:1902259	regulation of delayed rectifier potassium channel activity	  5	0.710033128778248	1	1	4	2212	7875	0.912065070040669
GO:1902262	apoptotic process involved in blood vessel morphogenesis	  5	1	1	0	5	2213	7874	0
GO:1902305	regulation of sodium ion transmembrane transport	  6	0.773649336373543	1	1	5	2212	7874	0.760054225033891
GO:1902358	sulfate transmembrane transport	  6	0.773649336373543	1	1	5	2212	7874	0.760054225033891
GO:1902475	L-alpha-amino acid transmembrane transport	  8	0.862084765369009	1	1	7	2212	7872	0.570040668775418
GO:1902476	chloride transmembrane transport	 51	0.57969765634549	1	11	40	2202	7839	0.983599585337976
GO:1902600	hydrogen ion transmembrane transport	 25	0.830662443344484	1	4	21	2209	7858	0.729652056032535
GO:1902711	GABA-A receptor complex	 10	0.915977754641309	1	1	9	2212	7870	0.456032535020334
GO:1902741	positive regulation of interferon-alpha secretion	  6	0.773649336373543	1	1	5	2212	7874	0.760054225033891
GO:1902857	positive regulation of non-motile cilium assembly	  5	0.710033128778248	1	1	4	2212	7875	0.912065070040669
GO:1902894	negative regulation of pri-miRNA transcription from RNA polymerase II promoter	  8	0.862084765369009	1	1	7	2212	7872	0.570040668775418
GO:1902895	positive regulation of pri-miRNA transcription from RNA polymerase II promoter	 15	0.872984249747857	1	2	13	2211	7866	0.608043380027113
GO:1902902	negative regulation of autophagosome assembly	 11	0.446445648052706	1	3	8	2210	7871	1.24372509551
GO:1902916	positive regulation of protein polyubiquitination	  5	0.073752586889371	1	3	2	2210	7877	2.73619521012201
GO:1903071	positive regulation of ER-associated ubiquitin-dependent protein catabolic process	  5	1	1	0	5	2213	7874	0
GO:1903076	regulation of protein localization to plasma membrane	 13	0.960053706376239	1	1	12	2212	7867	0.35079425770795
GO:1903077	negative regulation of protein localization to plasma membrane	 13	0.313693837540153	1	4	9	2209	7870	1.4031770308318
GO:1903078	positive regulation of protein localization to plasma membrane	 34	0.47700764043548	1	8	26	2205	7853	1.07301772945961
GO:1903142	positive regulation of establishment of endothelial barrier	  5	0.710033128778248	1	1	4	2212	7875	0.912065070040669
GO:1903146	regulation of autophagy of mitochondrion	 21	0.870606746054365	1	3	18	2210	7861	0.651475050029049
GO:1903204	negative regulation of oxidative stress-induced neuron death	  8	0.551915645208052	1	2	6	2211	7873	1.14008133755084
GO:1903206	negative regulation of hydrogen peroxide-induced cell death	  9	0.892351169002328	1	1	8	2212	7871	0.50670281668926
GO:1903265	positive regulation of tumor necrosis factor-mediated signaling pathway	  6	1	1	0	6	2213	7873	0
GO:1903351	cellular response to dopamine	  8	0.551915645208052	1	2	6	2211	7873	1.14008133755084
GO:1903361	protein localization to basolateral plasma membrane	  5	0.710033128778248	1	1	4	2212	7875	0.912065070040669
GO:1903364	positive regulation of cellular protein catabolic process	 10	0.915977754641309	1	1	9	2212	7870	0.456032535020334
GO:1903427	negative regulation of reactive oxygen species biosynthetic process	  5	0.302606661467939	1	2	3	2211	7876	1.82413014008134
GO:1903428	positive regulation of reactive oxygen species biosynthetic process	  6	0.123915802800268	1	3	3	2210	7876	2.28016267510167
GO:1903506	regulation of nucleic acid-templated transcription	 23	0.00527914092815981	0.674777072890282	11	12	2202	7867	2.18102516748856
GO:1903507	negative regulation of nucleic acid-templated transcription	 26	0.85360725893065	1	4	22	2209	7857	0.701588515415899
GO:1903543	positive regulation of exosomal secretion	  8	0.862084765369009	1	1	7	2212	7872	0.570040668775418
GO:1903561	extracellular vesicle	 40	0.527013831960622	1	9	31	2204	7848	1.02607320379575
GO:1903599	positive regulation of autophagy of mitochondrion	  5	0.710033128778248	1	1	4	2212	7875	0.912065070040669
GO:1903608	protein localization to cytoplasmic stress granule	  6	0.00247840731913399	0.46574230341166	5	1	2208	7878	3.80027112516945
GO:1903672	positive regulation of sprouting angiogenesis	  6	0.0235893709784742	1	4	2	2209	7877	3.04021690013556
GO:1903715	regulation of aerobic respiration	  5	0.710033128778248	1	1	4	2212	7875	0.912065070040669
GO:1903779	regulation of cardiac conduction	 35	0.909084510759699	1	5	30	2208	7849	0.651475050029049
GO:1903800	positive regulation of production of miRNAs involved in gene silencing by miRNA	  6	1	1	0	6	2213	7873	0
GO:1903818	positive regulation of voltage-gated potassium channel activity	  5	0.073752586889371	1	3	2	2210	7877	2.73619521012201
GO:1903825	organic acid transmembrane transport	  5	0.710033128778248	1	1	4	2212	7875	0.912065070040669
GO:1903829	positive regulation of cellular protein localization	  5	0.302606661467939	1	2	3	2211	7876	1.82413014008134
GO:1903830	magnesium ion transmembrane transport	 12	0.508975472817498	1	3	9	2210	7870	1.14008133755084
GO:1903861	positive regulation of dendrite extension	 14	0.174532180096009	1	5	9	2208	7870	1.62868762507262
GO:1903896	positive regulation of IRE1-mediated unfolded protein response	  6	0.773649336373543	1	1	5	2212	7874	0.760054225033891
GO:1903955	positive regulation of protein targeting to mitochondrion	 53	0.754898167775187	1	10	43	2203	7836	0.860438745321386
GO:1903959	regulation of anion transmembrane transport	  8	1	1	0	8	2213	7871	0
GO:1904115	axon cytoplasm	 29	0.4579722441856	1	7	22	2206	7857	1.10076818798012
GO:1904153	negative regulation of retrograde protein transport, ER to cytosol	  7	0.182673311502561	1	3	4	2210	7875	1.95442515008715
GO:1904262	negative regulation of TORC1 signaling	  9	0.619953536302463	1	2	7	2211	7872	1.01340563337852
GO:1904263	positive regulation of TORC1 signaling	  6	1	1	0	6	2213	7873	0
GO:1904264	ubiquitin protein ligase activity involved in ERAD pathway	  7	0.475663602521461	1	2	5	2211	7874	1.3029501000581
GO:1904322	cellular response to forskolin	  9	0.892351169002328	1	1	8	2212	7871	0.50670281668926
GO:1904355	positive regulation of telomere capping	 13	0.813973253692629	1	2	11	2211	7868	0.701588515415899
GO:1904357	negative regulation of telomere maintenance via telomere lengthening	  5	1	1	0	5	2213	7874	0
GO:1904380	endoplasmic reticulum mannose trimming	 11	0.206185263049328	1	4	7	2209	7872	1.65830012734667
GO:1904385	cellular response to angiotensin	  5	1	1	0	5	2213	7874	0
GO:1904469	positive regulation of tumor necrosis factor secretion	  5	0.710033128778248	1	1	4	2212	7875	0.912065070040669
GO:1904504	positive regulation of lipophagy	  5	0.302606661467939	1	2	3	2211	7876	1.82413014008134
GO:1904646	cellular response to amyloid-beta	  8	0.0756163732373509	1	4	4	2209	7875	2.28016267510167
GO:1904659	glucose transmembrane transport	 11	0.731548842740116	1	2	9	2211	7870	0.829150063673335
GO:1904668	positive regulation of ubiquitin protein ligase activity	  6	0.391952090801775	1	2	4	2211	7875	1.52010845006778
GO:1904707	positive regulation of vascular smooth muscle cell proliferation	  8	0.862084765369009	1	1	7	2212	7872	0.570040668775418
GO:1904714	regulation of chaperone-mediated autophagy	  5	1	1	0	5	2213	7874	0
GO:1904724	tertiary granule lumen	 36	0.970678706741602	1	4	32	2209	7847	0.50670281668926
GO:1904754	positive regulation of vascular associated smooth muscle cell migration	  9	0.619953536302463	1	2	7	2211	7872	1.01340563337852
GO:1904778	positive regulation of protein localization to cell cortex	  5	0.073752586889371	1	3	2	2210	7877	2.73619521012201
GO:1904813	ficolin-1-rich granule lumen	 95	0.985106541727063	1	13	82	2200	7797	0.624044521606773
GO:1904837	beta-catenin-TCF complex assembly	 24	0.922638553518794	1	3	21	2210	7858	0.570040668775418
GO:1904851	positive regulation of establishment of protein localization to telomere	  6	1	1	0	6	2213	7873	0
GO:1904871	positive regulation of protein localization to Cajal body	  7	1	1	0	7	2213	7872	0
GO:1904874	positive regulation of telomerase RNA localization to Cajal body	  9	1	1	0	9	2213	7870	0
GO:1904886	beta-catenin destruction complex disassembly	 18	0.579729311039596	1	4	14	2209	7865	1.01340563337852
GO:1904903	ESCRT III complex disassembly	  7	0.82331362534889	1	1	6	2212	7873	0.651475050029049
GO:1905007	positive regulation of epithelial to mesenchymal transition involved in endocardial cushion formation	  5	1	1	0	5	2213	7874	0
GO:1905515	non-motile cilium assembly	 31	0.224105618360784	1	9	22	2204	7857	1.32396542425258
GO:1990000	amyloid fibril formation	  5	0.710033128778248	1	1	4	2212	7875	0.912065070040669
GO:1990001	inhibition of cysteine-type endopeptidase activity involved in apoptotic process	  5	0.302606661467939	1	2	3	2211	7876	1.82413014008134
GO:1990023	mitotic spindle midzone	  5	1	1	0	5	2213	7874	0
GO:1990090	cellular response to nerve growth factor stimulus	 30	0.329625903186429	1	8	22	2205	7857	1.21608676005423
GO:1990124	messenger ribonucleoprotein complex	  6	0.391952090801775	1	2	4	2211	7875	1.52010845006778
GO:1990126	retrograde transport, endosome to plasma membrane	  9	0.892351169002328	1	1	8	2212	7871	0.50670281668926
GO:1990138	neuron projection extension	 15	0.975670266056184	1	1	14	2212	7865	0.304021690013556
GO:1990239	steroid hormone binding	  5	0.710033128778248	1	1	4	2212	7875	0.912065070040669
GO:1990247	N6-methyladenosine-containing RNA binding	  6	0.391952090801775	1	2	4	2211	7875	1.52010845006778
GO:1990253	cellular response to leucine starvation	  6	1	1	0	6	2213	7873	0
GO:1990314	cellular response to insulin-like growth factor stimulus	  6	0.773649336373543	1	1	5	2212	7874	0.760054225033891
GO:1990316	ATG1/ULK1 kinase complex	  8	1	1	0	8	2213	7871	0
GO:1990380	Lys48-specific deubiquitinase activity	  9	0.892351169002328	1	1	8	2212	7871	0.50670281668926
GO:1990381	ubiquitin-specific protease binding	  9	0.113156370629833	1	4	5	2209	7874	2.02681126675704
GO:1990403	embryonic brain development	  5	0.710033128778248	1	1	4	2212	7875	0.912065070040669
GO:1990416	cellular response to brain-derived neurotrophic factor stimulus	  8	0.551915645208052	1	2	6	2211	7873	1.14008133755084
GO:1990440	positive regulation of transcription from RNA polymerase II promoter in response to endoplasmic reticulum stress	  6	0.391952090801775	1	2	4	2211	7875	1.52010845006778
GO:1990454	L-type voltage-gated calcium channel complex	  6	0.123915802800268	1	3	3	2210	7876	2.28016267510167
GO:1990459	transferrin receptor binding	  5	0.073752586889371	1	3	2	2210	7877	2.73619521012201
GO:1990573	potassium ion import across plasma membrane	  6	1	1	0	6	2213	7873	0
GO:1990668	vesicle fusion with endoplasmic reticulum-Golgi intermediate compartment (ERGIC) membrane	  6	0.391952090801775	1	2	4	2211	7875	1.52010845006778
GO:1990712	HFE-transferrin receptor complex	  6	0.123915802800268	1	3	3	2210	7876	2.28016267510167
GO:1990782	protein tyrosine kinase binding	  7	0.475663602521461	1	2	5	2211	7874	1.3029501000581
GO:1990825	sequence-specific mRNA binding	  5	0.302606661467939	1	2	3	2211	7876	1.82413014008134
GO:1990830	cellular response to leukemia inhibitory factor	 67	0.896266083490766	1	11	56	2202	7823	0.748710132122937
GO:1990841	promoter-specific chromatin binding	 18	0.929856630121416	1	2	16	2211	7863	0.50670281668926
GO:1990909	Wnt signalosome	  8	0.551915645208052	1	2	6	2211	7873	1.14008133755084
GO:2000001	regulation of DNA damage checkpoint	  7	0.182673311502561	1	3	4	2210	7875	1.95442515008715
GO:2000008	regulation of protein localization to cell surface	  6	1	1	0	6	2213	7873	0
GO:2000009	negative regulation of protein localization to cell surface	 10	0.380920088506331	1	3	7	2210	7872	1.368097605061
GO:2000010	positive regulation of protein localization to cell surface	  9	0.892351169002328	1	1	8	2212	7871	0.50670281668926
GO:2000036	regulation of stem cell population maintenance	  6	0.391952090801775	1	2	4	2211	7875	1.52010845006778
GO:2000045	regulation of G1/S transition of mitotic cell cycle	  6	1	1	0	6	2213	7873	0
GO:2000060	positive regulation of protein ubiquitination involved in ubiquitin-dependent protein catabolic process	  7	0.82331362534889	1	1	6	2212	7873	0.651475050029049
GO:2000096	positive regulation of Wnt signaling pathway, planar cell polarity pathway	  6	0.391952090801775	1	2	4	2211	7875	1.52010845006778
GO:2000114	regulation of establishment of cell polarity	 13	0.313693837540153	1	4	9	2209	7870	1.4031770308318
GO:2000117	negative regulation of cysteine-type endopeptidase activity	  8	1	1	0	8	2213	7871	0
GO:2000134	negative regulation of G1/S transition of mitotic cell cycle	 22	0.03516713844378	1	9	13	2204	7866	1.865587643265
GO:2000144	positive regulation of DNA-templated transcription, initiation	  6	0.391952090801775	1	2	4	2211	7875	1.52010845006778
GO:2000145	regulation of cell motility	 19	0.40693083008532	1	5	14	2208	7865	1.20008561847456
GO:2000146	negative regulation of cell motility	 10	0.380920088506331	1	3	7	2210	7872	1.368097605061
GO:2000147	positive regulation of cell motility	  8	0.862084765369009	1	1	7	2212	7872	0.570040668775418
GO:2000171	negative regulation of dendrite development	  6	0.391952090801775	1	2	4	2211	7875	1.52010845006778
GO:2000177	regulation of neural precursor cell proliferation	  6	0.391952090801775	1	2	4	2211	7875	1.52010845006778
GO:2000178	negative regulation of neural precursor cell proliferation	  8	1	1	0	8	2213	7871	0
GO:2000179	positive regulation of neural precursor cell proliferation	 11	0.934420645831428	1	1	10	2212	7869	0.414575031836668
GO:2000188	regulation of cholesterol homeostasis	  6	0.391952090801775	1	2	4	2211	7875	1.52010845006778
GO:2000249	regulation of actin cytoskeleton reorganization	 13	1	1	0	13	2213	7866	0
GO:2000251	positive regulation of actin cytoskeleton reorganization	  8	0.862084765369009	1	1	7	2212	7872	0.570040668775418
GO:2000270	negative regulation of fibroblast apoptotic process	  5	0.710033128778248	1	1	4	2212	7875	0.912065070040669
GO:2000271	positive regulation of fibroblast apoptotic process	  6	0.391952090801775	1	2	4	2211	7875	1.52010845006778
GO:2000273	positive regulation of receptor activity	 10	0.380920088506331	1	3	7	2210	7872	1.368097605061
GO:2000279	negative regulation of DNA biosynthetic process	  9	0.892351169002328	1	1	8	2212	7871	0.50670281668926
GO:2000300	regulation of synaptic vesicle exocytosis	 12	0.258856173758332	1	4	8	2209	7871	1.52010845006778
GO:2000304	positive regulation of ceramide biosynthetic process	  6	0.391952090801775	1	2	4	2211	7875	1.52010845006778
GO:2000310	regulation of NMDA receptor activity	 14	1	1	0	14	2213	7865	0
GO:2000311	regulation of AMPA receptor activity	 15	0.975670266056184	1	1	14	2212	7865	0.304021690013556
GO:2000323	negative regulation of glucocorticoid receptor signaling pathway	  6	0.391952090801775	1	2	4	2211	7875	1.52010845006778
GO:2000352	negative regulation of endothelial cell apoptotic process	 15	0.975670266056184	1	1	14	2212	7865	0.304021690013556
GO:2000353	positive regulation of endothelial cell apoptotic process	 11	0.934420645831428	1	1	10	2212	7869	0.414575031836668
GO:2000369	regulation of clathrin-dependent endocytosis	  7	0.82331362534889	1	1	6	2212	7873	0.651475050029049
GO:2000377	regulation of reactive oxygen species metabolic process	 14	0.846032978004182	1	2	12	2211	7867	0.651475050029049
GO:2000378	negative regulation of reactive oxygen species metabolic process	 14	1	1	0	14	2213	7865	0
GO:2000379	positive regulation of reactive oxygen species metabolic process	 17	1	1	0	17	2213	7862	0
GO:2000394	positive regulation of lamellipodium morphogenesis	  5	0.302606661467939	1	2	3	2211	7876	1.82413014008134
GO:2000406	positive regulation of T cell migration	  5	1	1	0	5	2213	7874	0
GO:2000463	positive regulation of excitatory postsynaptic potential	 22	0.969157982950508	1	2	20	2211	7859	0.414575031836668
GO:2000480	negative regulation of cAMP-dependent protein kinase activity	  7	0.475663602521461	1	2	5	2211	7874	1.3029501000581
GO:2000484	positive regulation of interleukin-8 secretion	  7	1	1	0	7	2213	7872	0
GO:2000505	regulation of energy homeostasis	 10	0.157129881410612	1	4	6	2209	7873	1.82413014008134
GO:2000510	positive regulation of dendritic cell chemotaxis	  5	1	1	0	5	2213	7874	0
GO:2000535	regulation of entry of bacterium into host cell	  5	1	1	0	5	2213	7874	0
GO:2000573	positive regulation of DNA biosynthetic process	  9	1	1	0	9	2213	7870	0
GO:2000587	negative regulation of platelet-derived growth factor receptor-beta signaling pathway	  5	0.710033128778248	1	1	4	2212	7875	0.912065070040669
GO:2000601	positive regulation of Arp2/3 complex-mediated actin nucleation	  6	0.773649336373543	1	1	5	2212	7874	0.760054225033891
GO:2000637	positive regulation of gene silencing by miRNA	  8	0.862084765369009	1	1	7	2212	7872	0.570040668775418
GO:2000641	regulation of early endosome to late endosome transport	  5	0.710033128778248	1	1	4	2212	7875	0.912065070040669
GO:2000643	positive regulation of early endosome to late endosome transport	  8	0.246907474461687	1	3	5	2210	7874	1.71012200632625
GO:2000649	regulation of sodium ion transmembrane transporter activity	 12	0.9488167484775	1	1	11	2212	7868	0.380027112516945
GO:2000650	negative regulation of sodium ion transmembrane transporter activity	  5	0.710033128778248	1	1	4	2212	7875	0.912065070040669
GO:2000651	positive regulation of sodium ion transmembrane transporter activity	  6	0.123915802800268	1	3	3	2210	7876	2.28016267510167
GO:2000675	negative regulation of type B pancreatic cell apoptotic process	  6	0.123915802800268	1	3	3	2210	7876	2.28016267510167
GO:2000678	negative regulation of transcription regulatory region DNA binding	  9	1	1	0	9	2213	7870	0
GO:2000679	positive regulation of transcription regulatory region DNA binding	  6	0.123915802800268	1	3	3	2210	7876	2.28016267510167
GO:2000727	positive regulation of cardiac muscle cell differentiation	  7	0.475663602521461	1	2	5	2211	7874	1.3029501000581
GO:2000737	negative regulation of stem cell differentiation	  9	0.619953536302463	1	2	7	2211	7872	1.01340563337852
GO:2000766	negative regulation of cytoplasmic translation	  5	0.710033128778248	1	1	4	2212	7875	0.912065070040669
GO:2000772	regulation of cellular senescence	 10	0.679711898251496	1	2	8	2211	7871	0.912065070040669
GO:2000773	negative regulation of cellular senescence	  6	0.773649336373543	1	1	5	2212	7874	0.760054225033891
GO:2000774	positive regulation of cellular senescence	  5	0.710033128778248	1	1	4	2212	7875	0.912065070040669
GO:2000778	positive regulation of interleukin-6 secretion	 10	0.380920088506331	1	3	7	2210	7872	1.368097605061
GO:2000785	regulation of autophagosome assembly	 11	0.0712829635428583	1	5	6	2208	7873	2.07287515918334
GO:2000786	positive regulation of autophagosome assembly	 10	0.915977754641309	1	1	9	2212	7870	0.456032535020334
GO:2000810	regulation of bicellular tight junction assembly	 10	0.915977754641309	1	1	9	2212	7870	0.456032535020334
GO:2000811	negative regulation of anoikis	 13	0.813973253692629	1	2	11	2211	7868	0.701588515415899
GO:2000821	regulation of grooming behavior	  5	0.710033128778248	1	1	4	2212	7875	0.912065070040669
GO:2000969	positive regulation of AMPA receptor activity	  5	1	1	0	5	2213	7874	0
GO:2001014	regulation of skeletal muscle cell differentiation	  5	0.710033128778248	1	1	4	2212	7875	0.912065070040669
GO:2001020	regulation of response to DNA damage stimulus	 10	0.380920088506331	1	3	7	2210	7872	1.368097605061
GO:2001022	positive regulation of response to DNA damage stimulus	  9	0.313783026377615	1	3	6	2210	7873	1.52010845006778
GO:2001028	positive regulation of endothelial cell chemotaxis	  5	1	1	0	5	2213	7874	0
GO:2001214	positive regulation of vasculogenesis	  8	1	1	0	8	2213	7871	0
GO:2001222	regulation of neuron migration	  6	0.773649336373543	1	1	5	2212	7874	0.760054225033891
GO:2001223	negative regulation of neuron migration	  6	1	1	0	6	2213	7873	0
GO:2001224	positive regulation of neuron migration	  7	0.82331362534889	1	1	6	2212	7873	0.651475050029049
GO:2001234	negative regulation of apoptotic signaling pathway	 13	0.313693837540153	1	4	9	2209	7870	1.4031770308318
GO:2001235	positive regulation of apoptotic signaling pathway	 22	0.969157982950508	1	2	20	2211	7859	0.414575031836668
GO:2001237	negative regulation of extrinsic apoptotic signaling pathway	 30	0.101800677260751	1	10	20	2203	7859	1.52010845006778
GO:2001238	positive regulation of extrinsic apoptotic signaling pathway	 23	0.996655774514918	1	1	22	2212	7857	0.198275015226232
GO:2001240	negative regulation of extrinsic apoptotic signaling pathway in absence of ligand	 18	0.929856630121416	1	2	16	2211	7863	0.50670281668926
GO:2001241	positive regulation of extrinsic apoptotic signaling pathway in absence of ligand	 10	0.380920088506331	1	3	7	2210	7872	1.368097605061
GO:2001243	negative regulation of intrinsic apoptotic signaling pathway	 13	0.313693837540153	1	4	9	2209	7870	1.4031770308318
GO:2001244	positive regulation of intrinsic apoptotic signaling pathway	 22	0.546958821448314	1	5	17	2208	7862	1.03643757959167
GO:2001259	positive regulation of cation channel activity	  6	0.773649336373543	1	1	5	2212	7874	0.760054225033891
GO:2001275	positive regulation of glucose import in response to insulin stimulus	 10	0.380920088506331	1	3	7	2210	7872	1.368097605061
