Term	Accession	Genes (tot)	Stat (non-dir.) p	p adj (non-dir.)	Significant..in.gene.set.	Non.significant..in.gene.set.	Significant..not.in.gene.set.	Non.significant..not.in.gene.set.	effect.size
GO:0000002	mitochondrial genome maintenance	 10	0.0390070262266277	0.625040317669623	8	2	6716	7437	1.68506841165973
GO:0000012	single strand break repair	  8	0.309544448231027	1	5	3	6719	7436	1.31645969660916
GO:0000027	ribosomal large subunit assembly	 18	0.506938913103874	1	9	9	6715	7430	1.05316775728733
GO:0000028	ribosomal small subunit assembly	 10	0.316545776550851	1	6	4	6718	7435	1.26380130874479
GO:0000030	mannosyltransferase activity	 11	0.0838548499097086	0.807895728316903	8	3	6716	7436	1.53188037423611
GO:0000038	very long-chain fatty acid metabolic process	 13	0.230372725000093	1	8	5	6716	7434	1.29620647050748
GO:0000042	protein targeting to Golgi	 13	0.230372725000093	1	8	5	6716	7434	1.29620647050748
GO:0000045	autophagosome assembly	 42	0.0790753478856034	0.807895728316903	25	17	6699	7422	1.25377113962777
GO:0000049	tRNA binding	 48	0.00233171019802724	0.239639566866816	33	15	6691	7424	1.44810566627008
GO:0000050	urea cycle	  8	0.952366339066048	1	2	6	6722	7433	0.526583878643665
GO:0000055	ribosomal large subunit export from nucleus	  8	0.580280354503036	1	4	4	6720	7435	1.05316775728733
GO:0000056	ribosomal small subunit export from nucleus	  5	0.452745275304033	1	3	2	6721	7437	1.26380130874479
GO:0000060	protein import into nucleus, translocation	 23	0.92480513956827	1	8	15	6716	7424	0.732638439852055
GO:0000062	fatty-acyl-CoA binding	 15	0.237875362689918	1	9	6	6715	7433	1.26380130874479
GO:0000070	mitotic sister chromatid segregation	 21	0.738560418161868	1	9	12	6715	7427	0.902715220531996
GO:0000075	cell cycle checkpoint	  8	0.309544448231027	1	5	3	6719	7436	1.31645969660916
GO:0000076	DNA replication checkpoint	  5	0.452745275304033	1	3	2	6721	7437	1.26380130874479
GO:0000077	DNA damage checkpoint	 25	0.0725535511024713	0.807895728316903	16	9	6708	7430	1.34805472932778
GO:0000079	regulation of cyclin-dependent protein serine/threonine kinase activity	 32	0.063268776163272	0.772066334068511	20	12	6704	7427	1.31645969660916
GO:0000082	G1/S transition of mitotic cell cycle	 85	0.400887805734913	1	42	43	6682	7396	1.04077754837807
GO:0000083	regulation of transcription involved in G1/S transition of mitotic cell cycle	 17	0.895242422289557	1	6	11	6718	7428	0.743412534555762
GO:0000096	sulfur amino acid metabolic process	  6	0.297654371351411	1	4	2	6720	7437	1.40422367638311
GO:0000118	histone deacetylase complex	 34	0.449969687236123	1	17	17	6707	7422	1.05316775728733
GO:0000123	histone acetyltransferase complex	 23	0.00925520247229722	0.417351786485153	17	6	6707	7433	1.55685668468562
GO:0000124	SAGA complex	 10	0.559603563591584	1	5	5	6719	7434	1.05316775728733
GO:0000127	transcription factor TFIIIC complex	  5	0.77940058892516	1	2	3	6722	7436	0.842534205829863
GO:0000132	establishment of mitotic spindle orientation	 18	0.832783288477324	1	7	11	6717	7428	0.819130477890145
GO:0000137	Golgi cis cisterna	  6	0.297654371351411	1	4	2	6720	7437	1.40422367638311
GO:0000145	exocyst	 18	0.506938913103874	1	9	9	6715	7430	1.05316775728733
GO:0000146	microfilament motor activity	 13	0.933471720877997	1	4	9	6720	7430	0.648103235253741
GO:0000149	SNARE binding	 50	0.00104601892708338	0.165233002219546	35	15	6689	7424	1.47443486020226
GO:0000150	recombinase activity	  6	0.0874151689581943	0.807895728316903	5	1	6719	7438	1.75527959547888
GO:0000151	ubiquitin ligase complex	 94	0.156298642448778	0.919686434773344	50	44	6674	7395	1.12039123115673
GO:0000154	rRNA modification	  8	0.113810689204897	0.88413902838582	6	2	6718	7437	1.57975163593099
GO:0000155	phosphorelay sensor kinase activity	  6	0.865182793759413	1	2	4	6722	7435	0.702111838191553
GO:0000159	protein phosphatase type 2A complex	 20	0.000604341949448324	0.129194878970953	17	3	6707	7436	1.79038518738846
GO:0000160	phosphorelay signal transduction system	  7	0.730029012673872	1	3	4	6721	7435	0.902715220531996
GO:0000164	protein phosphatase type 1 complex	  9	0.882794860340315	1	3	6	6721	7433	0.702111838191553
GO:0000172	ribonuclease MRP complex	  6	0.865182793759413	1	2	4	6722	7435	0.702111838191553
GO:0000175	3	 21	0.0609416617953418	0.764685373658072	14	7	6710	7432	1.40422367638311
GO:0000176	nuclear exosome (RNase complex)	 12	0.012434352666713	0.427208830906354	10	2	6714	7437	1.75527959547888
GO:0000177	cytoplasmic exosome (RNase complex)	 11	0.220387996626296	1	7	4	6717	7435	1.3403953274566
GO:0000178	exosome (RNase complex)	 16	0.0242540767935066	0.495149842313607	12	4	6712	7435	1.57975163593099
GO:0000182	rDNA binding	  5	0.157494903089267	0.919686434773344	4	1	6720	7438	1.68506841165973
GO:0000183	chromatin silencing at rDNA	 13	0.982330979346752	1	3	10	6721	7429	0.486077426440306
GO:0000184	nuclear-transcribed mRNA catabolic process, nonsense-mediated decay	 73	0.183225388482738	0.949543953868825	39	34	6685	7405	1.12530253518372
GO:0000185	activation of MAPKKK activity	 16	0.706693964264422	1	7	9	6717	7430	0.921521787626413
GO:0000186	activation of MAPKK activity	 48	0.0258381186468233	0.500461814863973	30	18	6694	7421	1.31645969660916
GO:0000187	activation of MAPK activity	 96	0.981154125525079	1	36	60	6688	7379	0.789875817965497
GO:0000188	inactivation of MAPK activity	 24	0.194475510371151	0.972714597800941	14	10	6710	7429	1.22869571683522
GO:0000212	meiotic spindle organization	  6	0.865182793759413	1	2	4	6722	7435	0.702111838191553
GO:0000226	microtubule cytoskeleton organization	 74	0.0253663131521931	0.495149842313607	44	30	6680	7409	1.25241571136872
GO:0000228	nuclear chromosome	 28	0.323270654016595	1	15	13	6709	7426	1.128394025665
GO:0000242	pericentriolar material	 18	0.0811513291101853	0.807895728316903	12	6	6712	7433	1.40422367638311
GO:0000243	commitment complex	  7	0.187210848839696	0.949543953868825	5	2	6719	7437	1.50452536755333
GO:0000244	spliceosomal tri-snRNP complex assembly	 12	0.75380380293781	1	5	7	6719	7432	0.877639797739441
GO:0000245	spliceosomal complex assembly	 25	0.14581109956432	0.919686434773344	15	10	6709	7429	1.26380130874479
GO:0000266	mitochondrial fission	 15	0.109100626262719	0.88413902838582	10	5	6714	7434	1.40422367638311
GO:0000276	mitochondrial proton-transporting ATP synthase complex, coupling factor F(o)	  8	0.025392299605826	0.495149842313607	7	1	6717	7438	1.84304357525283
GO:0000278	mitotic cell cycle	 91	0.391832121159204	1	45	46	6679	7393	1.04159448522923
GO:0000281	mitotic cytokinesis	 28	0.1122080698828	0.88413902838582	17	11	6707	7428	1.27884656242033
GO:0000288	nuclear-transcribed mRNA catabolic process, deadenylation-dependent decay	 11	0.220387996626296	1	7	4	6717	7435	1.3403953274566
GO:0000289	nuclear-transcribed mRNA poly(A) tail shortening	 26	0.324205758709722	1	14	12	6710	7427	1.13418066169405
GO:0000290	deadenylation-dependent decapping of nuclear-transcribed mRNA	  8	0.309544448231027	1	5	3	6719	7436	1.31645969660916
GO:0000302	response to reactive oxygen species	 12	0.971055765853963	1	3	9	6721	7430	0.526583878643665
GO:0000303	response to superoxide	  5	0.77940058892516	1	2	3	6722	7436	0.842534205829863
GO:0000307	cyclin-dependent protein kinase holoenzyme complex	 14	0.875453509540804	1	5	9	6719	7430	0.752262683776664
GO:0000338	protein deneddylation	 10	0.0390070262266277	0.625040317669623	8	2	6716	7437	1.68506841165973
GO:0000339	RNA cap binding	  8	0.819878207576373	1	3	5	6721	7434	0.789875817965497
GO:0000340	RNA 7-methylguanosine cap binding	  8	0.819878207576373	1	3	5	6721	7434	0.789875817965497
GO:0000346	transcription export complex	  9	0.438074670071218	1	5	4	6719	7435	1.17018639698592
GO:0000347	THO complex	  5	0.452745275304033	1	3	2	6721	7437	1.26380130874479
GO:0000375	RNA splicing, via transesterification reactions	 24	0.194475510371151	0.972714597800941	14	10	6710	7429	1.22869571683522
GO:0000380	alternative mRNA splicing, via spliceosome	 15	0.0393086686268318	0.625040317669623	11	4	6713	7435	1.54464604402142
GO:0000381	regulation of alternative mRNA splicing, via spliceosome	 35	0.0940410178590895	0.843214701401555	21	14	6703	7425	1.26380130874479
GO:0000387	spliceosomal snRNP assembly	 22	0.796326194402031	1	9	13	6715	7426	0.861682710507815
GO:0000389	mRNA 3	  6	0.607836179256654	1	3	3	6721	7436	1.05316775728733
GO:0000395	mRNA 5	  5	0.0241003244622537	0.495149842313607	5	0	6719	7439	2.10633551457466
GO:0000400	four-way junction DNA binding	 14	0.323388997222084	1	8	6	6716	7433	1.20362029404266
GO:0000403	Y-form DNA binding	  6	0.607836179256654	1	3	3	6721	7436	1.05316775728733
GO:0000407	pre-autophagosomal structure	 21	0.407325414326014	1	11	10	6713	7429	1.10331860287244
GO:0000408	EKC/KEOPS complex	  6	0.607836179256654	1	3	3	6721	7436	1.05316775728733
GO:0000413	protein peptidyl-prolyl isomerization	 33	0.384864355454507	1	17	16	6707	7423	1.08508193175058
GO:0000421	autophagosome membrane	 23	0.40318807961294	1	12	11	6712	7428	1.09895765977808
GO:0000422	autophagy of mitochondrion	 35	0.0487722473343487	0.662384497914966	22	13	6702	7426	1.32398232344693
GO:0000423	mitophagy	  6	0.607836179256654	1	3	3	6721	7436	1.05316775728733
GO:0000439	core TFIIH complex	  6	0.0874151689581943	0.807895728316903	5	1	6719	7438	1.75527959547888
GO:0000445	THO complex part of transcription export complex	  5	0.452745275304033	1	3	2	6721	7437	1.26380130874479
GO:0000447	endonucleolytic cleavage in ITS1 to separate SSU-rRNA from 5.8S rRNA and LSU-rRNA from tricistronic rRNA transcript (SSU-rRNA, 5.8S rRNA, LSU-rRNA)	  7	0.919244306193629	1	2	5	6722	7434	0.601810147021331
GO:0000460	maturation of 5.8S rRNA	 11	0.431935112460319	1	6	5	6718	7434	1.14891028067709
GO:0000462	maturation of SSU-rRNA from tricistronic rRNA transcript (SSU-rRNA, 5.8S rRNA, LSU-rRNA)	 26	0.198303125650341	0.983668097955673	15	11	6709	7428	1.21519356610076
GO:0000463	maturation of LSU-rRNA from tricistronic rRNA transcript (SSU-rRNA, 5.8S rRNA, LSU-rRNA)	  7	0.919244306193629	1	2	5	6722	7434	0.601810147021331
GO:0000467	exonucleolytic trimming to generate mature 3	  5	0.157494903089267	0.919686434773344	4	1	6720	7438	1.68506841165973
GO:0000470	maturation of LSU-rRNA	 11	0.431935112460319	1	6	5	6718	7434	1.14891028067709
GO:0000480	endonucleolytic cleavage in 5	  6	0.607836179256654	1	3	3	6721	7436	1.05316775728733
GO:0000492	box C/D snoRNP assembly	  6	0.297654371351411	1	4	2	6720	7437	1.40422367638311
GO:0000502	proteasome complex	 55	0.117607086013058	0.899006189270582	31	24	6693	7415	1.18720729003299
GO:0000506	glycosylphosphatidylinositol-N-acetylglucosaminyltransferase (GPI-GnT) complex	  7	0.919244306193629	1	2	5	6722	7434	0.601810147021331
GO:0000578	embryonic axis specification	  7	0.730029012673872	1	3	4	6721	7435	0.902715220531996
GO:0000707	meiotic DNA recombinase assembly	  5	0.157494903089267	0.919686434773344	4	1	6720	7438	1.68506841165973
GO:0000712	resolution of meiotic recombination intermediates	 11	0.850917330440019	1	4	7	6720	7432	0.765940187118057
GO:0000715	nucleotide-excision repair, DNA damage recognition	 22	0.0147211815904588	0.464573006924516	16	6	6708	7433	1.53188037423611
GO:0000717	nucleotide-excision repair, DNA duplex unwinding	 19	0.0189134059954864	0.495149842313607	14	5	6710	7434	1.55203669494975
GO:0000722	telomere maintenance via recombination	  6	0.297654371351411	1	4	2	6720	7437	1.40422367638311
GO:0000723	telomere maintenance	 34	0.319759023672891	1	18	16	6706	7423	1.11511880183364
GO:0000724	double-strand break repair via homologous recombination	 60	0.0969946938787426	0.843214701401555	34	26	6690	7413	1.19359012492564
GO:0000729	DNA double-strand break processing	 13	0.0975861781940815	0.843214701401555	9	4	6715	7435	1.45823227932092
GO:0000731	DNA synthesis involved in DNA repair	 25	0.0725535511024713	0.807895728316903	16	9	6708	7430	1.34805472932778
GO:0000732	strand displacement	 18	0.178063825749389	0.949543953868825	11	7	6713	7432	1.28720503668451
GO:0000733	DNA strand renaturation	  8	0.952366339066048	1	2	6	6722	7433	0.526583878643665
GO:0000774	adenyl-nucleotide exchange factor activity	  9	0.206720270758876	0.983668097955673	6	3	6718	7436	1.40422367638311
GO:0000776	kinetochore	100	0.0349051097973087	0.599479186247127	57	43	6667	7396	1.20061124330755
GO:0000777	condensed chromosome kinetochore	 78	0.154800958584024	0.919686434773344	42	36	6682	7403	1.13418066169405
GO:0000779	condensed chromosome, centromeric region	  6	0.607836179256654	1	3	3	6721	7436	1.05316775728733
GO:0000780	condensed nuclear chromosome, centromeric region	 11	0.431935112460319	1	6	5	6718	7434	1.14891028067709
GO:0000781	chromosome, telomeric region	 50	0.41366085413375	1	25	25	6699	7414	1.05316775728733
GO:0000783	nuclear telomere cap complex	  9	0.69404490204849	1	4	5	6720	7434	0.936149117588737
GO:0000784	nuclear chromosome, telomeric region	 97	0.0942149079033372	0.843214701401555	53	44	6671	7395	1.1508843533243
GO:0000785	chromatin	 98	0.112700099663698	0.88413902838582	53	45	6671	7394	1.13914063543323
GO:0000786	nucleosome	 41	0.997950757742608	1	11	30	6713	7409	0.565114406349299
GO:0000788	nuclear nucleosome	 12	0.971055765853963	1	3	9	6721	7430	0.526583878643665
GO:0000791	euchromatin	  5	0.452745275304033	1	3	2	6721	7437	1.26380130874479
GO:0000792	heterochromatin	 23	0.254283570903419	1	13	10	6711	7429	1.19053746475959
GO:0000793	condensed chromosome	 24	0.481410334966146	1	12	12	6712	7427	1.05316775728733
GO:0000794	condensed nuclear chromosome	 28	0.201547233869993	0.983668097955673	16	12	6708	7427	1.20362029404266
GO:0000795	synaptonemal complex	 17	0.895242422289557	1	6	11	6718	7428	0.743412534555762
GO:0000800	lateral element	  9	0.882794860340315	1	3	6	6721	7433	0.702111838191553
GO:0000808	origin recognition complex	  5	0.157494903089267	0.919686434773344	4	1	6720	7438	1.68506841165973
GO:0000812	Swr1 complex	  9	0.438074670071218	1	5	4	6719	7435	1.17018639698592
GO:0000813	ESCRT I complex	 10	0.78367246101976	1	4	6	6720	7433	0.842534205829863
GO:0000815	ESCRT III complex	  9	0.438074670071218	1	5	4	6719	7435	1.17018639698592
GO:0000827	inositol-1,3,4,5,6-pentakisphosphate kinase activity	  5	0.452745275304033	1	3	2	6721	7437	1.26380130874479
GO:0000828	inositol hexakisphosphate kinase activity	  5	0.452745275304033	1	3	2	6721	7437	1.26380130874479
GO:0000829	inositol heptakisphosphate kinase activity	  5	0.452745275304033	1	3	2	6721	7437	1.26380130874479
GO:0000832	inositol hexakisphosphate 5-kinase activity	  5	0.452745275304033	1	3	2	6721	7437	1.26380130874479
GO:0000900	translation repressor activity, nucleic acid binding	 12	0.320810094151237	1	7	5	6717	7434	1.22869571683522
GO:0000902	cell morphogenesis	 56	0.0318022272075832	0.561353074746697	34	22	6690	7417	1.27884656242033
GO:0000904	cell morphogenesis involved in differentiation	  6	0.865182793759413	1	2	4	6722	7435	0.702111838191553
GO:0000910	cytokinesis	 39	0.261740251185182	1	21	18	6703	7421	1.13418066169405
GO:0000920	cell separation after cytokinesis	 12	0.320810094151237	1	7	5	6717	7434	1.22869571683522
GO:0000923	equatorial microtubule organizing center	  6	0.0874151689581943	0.807895728316903	5	1	6719	7438	1.75527959547888
GO:0000930	gamma-tubulin complex	 12	0.0514533113817507	0.679607581911819	9	3	6715	7436	1.57975163593099
GO:0000932	P-body	 92	0.0765724167920165	0.807895728316903	51	41	6673	7398	1.16764251351421
GO:0000956	nuclear-transcribed mRNA catabolic process	 16	0.324860333233664	1	9	7	6715	7432	1.18481372694825
GO:0000974	Prp19 complex	 12	0.320810094151237	1	7	5	6717	7434	1.22869571683522
GO:0000975	regulatory region DNA binding	 13	0.997057742126947	1	2	11	6722	7428	0.32405161762687
GO:0000976	transcription regulatory region sequence-specific DNA binding	 43	0.884807792585161	1	17	26	6707	7413	0.832737296459748
GO:0000979	RNA polymerase II core promoter sequence-specific DNA binding	 50	0.0883671818938791	0.807895728316903	29	21	6695	7418	1.2216745984533
GO:0000980	RNA polymerase II distal enhancer sequence-specific DNA binding	 60	0.981506012696284	1	21	39	6703	7400	0.73721743010113
GO:0000982	transcription factor activity, RNA polymerase II core promoter proximal region sequence-specific binding	 16	0.853260719975205	1	6	10	6718	7429	0.789875817965497
GO:0000983	transcription factor activity, RNA polymerase II core promoter sequence-specific	 13	0.822979434145659	1	5	8	6719	7431	0.810129044067176
GO:0000987	core promoter proximal region sequence-specific DNA binding	 16	0.706693964264422	1	7	9	6717	7430	0.921521787626413
GO:0000988	transcription factor activity, protein binding	  5	0.452745275304033	1	3	2	6721	7437	1.26380130874479
GO:0000989	transcription factor activity, transcription factor binding	 14	0.956679005412873	1	4	10	6720	7429	0.601810147021331
GO:0000993	RNA polymerase II core binding	 22	0.189941610858229	0.956669265160296	13	9	6711	7430	1.24465280406684
GO:0001012	RNA polymerase II regulatory region DNA binding	  5	0.960049771736903	1	1	4	6723	7435	0.421267102914932
GO:0001042	RNA polymerase I core binding	  5	0.77940058892516	1	2	3	6722	7436	0.842534205829863
GO:0001046	core promoter sequence-specific DNA binding	 41	0.103180061828763	0.873532642568676	24	17	6700	7422	1.23297688658029
GO:0001047	core promoter binding	 59	0.348094871604032	1	30	29	6694	7410	1.0710180582583
GO:0001054	RNA polymerase I activity	 11	0.0838548499097086	0.807895728316903	8	3	6716	7436	1.53188037423611
GO:0001055	RNA polymerase II activity	  8	0.025392299605826	0.495149842313607	7	1	6717	7438	1.84304357525283
GO:0001056	RNA polymerase III activity	 15	0.0393086686268318	0.625040317669623	11	4	6713	7435	1.54464604402142
GO:0001075	transcription factor activity, RNA polymerase II core promoter sequence-specific binding involved in preinitiation complex assembly	  9	0.438074670071218	1	5	4	6719	7435	1.17018639698592
GO:0001076	transcription factor activity, RNA polymerase II transcription factor binding	 11	0.665993939534306	1	5	6	6719	7433	0.957425233897572
GO:0001085	RNA polymerase II transcription factor binding	 39	0.740461448131339	1	17	22	6707	7417	0.9181462499428
GO:0001094	TFIID-class transcription factor binding	  8	0.113810689204897	0.88413902838582	6	2	6718	7437	1.57975163593099
GO:0001102	RNA polymerase II activating transcription factor binding	 33	0.774610796030802	1	14	19	6710	7420	0.893596884971067
GO:0001103	RNA polymerase II repressing transcription factor binding	 25	0.031210609259391	0.552600112408603	17	8	6707	7431	1.43230814991077
GO:0001104	RNA polymerase II transcription cofactor activity	 32	0.063268776163272	0.772066334068511	20	12	6704	7427	1.31645969660916
GO:0001105	RNA polymerase II transcription coactivator activity	 29	0.259321724550117	1	16	13	6708	7426	1.16211614597223
GO:0001106	RNA polymerase II transcription corepressor activity	 23	0.843995637843635	1	9	14	6715	7425	0.824218244833562
GO:0001135	transcription factor activity, RNA polymerase II transcription factor recruiting	  7	0.444912401367032	1	4	3	6720	7436	1.20362029404266
GO:0001158	enhancer sequence-specific DNA binding	 15	0.421118865258844	1	8	7	6716	7432	1.12337894110648
GO:0001162	RNA polymerase II intronic transcription regulatory region sequence-specific DNA binding	  6	0.0874151689581943	0.807895728316903	5	1	6719	7438	1.75527959547888
GO:0001164	RNA polymerase I CORE element sequence-specific DNA binding	  8	0.113810689204897	0.88413902838582	6	2	6718	7437	1.57975163593099
GO:0001190	transcriptional activator activity, RNA polymerase II transcription factor binding	 16	0.94165410331218	1	5	11	6719	7428	0.658229848304581
GO:0001191	transcriptional repressor activity, RNA polymerase II transcription factor binding	 12	0.320810094151237	1	7	5	6717	7434	1.22869571683522
GO:0001205	transcriptional activator activity, RNA polymerase II distal enhancer sequence-specific binding	 23	0.92480513956827	1	8	15	6716	7424	0.732638439852055
GO:0001206	transcriptional repressor activity, RNA polymerase II distal enhancer sequence-specific binding	  9	0.972243904416257	1	2	7	6722	7432	0.468074558794368
GO:0001221	transcription cofactor binding	  7	0.919244306193629	1	2	5	6722	7434	0.601810147021331
GO:0001222	transcription corepressor binding	  9	0.69404490204849	1	4	5	6720	7434	0.936149117588737
GO:0001223	transcription coactivator binding	 16	0.0724287706601472	0.807895728316903	11	5	6713	7434	1.44810566627008
GO:0001227	transcriptional repressor activity, RNA polymerase II transcription regulatory region sequence-specific binding	 72	0.736657909599211	1	32	40	6692	7399	0.936149117588737
GO:0001302	replicative cell aging	  5	0.77940058892516	1	2	3	6722	7436	0.842534205829863
GO:0001502	cartilage condensation	 18	0.926471989195673	1	6	12	6718	7427	0.702111838191553
GO:0001503	ossification	 91	0.98006928994203	1	34	57	6690	7382	0.786982499950971
GO:0001504	neurotransmitter uptake	  5	0.157494903089267	0.919686434773344	4	1	6720	7438	1.68506841165973
GO:0001505	regulation of neurotransmitter levels	  6	0.979023167332401	1	1	5	6723	7434	0.351055919095776
GO:0001508	action potential	 15	0.623867966210499	1	7	8	6717	7431	0.982956573468174
GO:0001510	RNA methylation	 11	0.665993939534306	1	5	6	6719	7433	0.957425233897572
GO:0001514	selenocysteine incorporation	  8	0.113810689204897	0.88413902838582	6	2	6718	7437	1.57975163593099
GO:0001516	prostaglandin biosynthetic process	 13	0.999769586887007	1	1	12	6723	7427	0.162025808813435
GO:0001517	N-acetylglucosamine 6-O-sulfotransferase activity	  6	0.979023167332401	1	1	5	6723	7434	0.351055919095776
GO:0001518	voltage-gated sodium channel complex	 12	0.5430601307694	1	6	6	6718	7433	1.05316775728733
GO:0001522	pseudouridine synthesis	 16	0.706693964264422	1	7	9	6717	7430	0.921521787626413
GO:0001523	retinoid metabolic process	 48	0.998832295836902	1	13	35	6711	7404	0.570465868530637
GO:0001527	microfibril	  7	0.919244306193629	1	2	5	6722	7434	0.601810147021331
GO:0001530	lipopolysaccharide binding	 21	0.86019883501541	1	8	13	6716	7426	0.802413529361774
GO:0001533	cornified envelope	 31	0.999992157348797	1	4	27	6720	7412	0.271785227687053
GO:0001540	amyloid-beta binding	 45	0.600851177122254	1	21	24	6703	7415	0.982956573468174
GO:0001541	ovarian follicle development	 38	0.795309127754501	1	16	22	6708	7417	0.886878111399856
GO:0001542	ovulation from ovarian follicle	  6	0.865182793759413	1	2	4	6722	7435	0.702111838191553
GO:0001553	luteinization	  6	0.607836179256654	1	3	3	6721	7436	1.05316775728733
GO:0001556	oocyte maturation	 12	0.148657926965624	0.919686434773344	8	4	6716	7435	1.40422367638311
GO:0001558	regulation of cell growth	 62	0.935512187918153	1	24	38	6700	7401	0.815355683061158
GO:0001561	fatty acid alpha-oxidation	  7	0.444912401367032	1	4	3	6720	7436	1.20362029404266
GO:0001568	blood vessel development	 54	0.920270385250928	1	21	33	6703	7406	0.819130477890145
GO:0001569	branching involved in blood vessel morphogenesis	 26	0.997238836294189	1	6	20	6718	7419	0.486077426440306
GO:0001570	vasculogenesis	 53	0.967745654673194	1	19	34	6705	7405	0.755101410885255
GO:0001574	ganglioside biosynthetic process	  8	0.580280354503036	1	4	4	6720	7435	1.05316775728733
GO:0001578	microtubule bundle formation	 22	0.489152057931013	1	11	11	6713	7428	1.05316775728733
GO:0001580	detection of chemical stimulus involved in sensory perception of bitter taste	 16	0.982365044000861	1	4	12	6720	7427	0.526583878643665
GO:0001614	purinergic nucleotide receptor activity	  7	0.730029012673872	1	3	4	6721	7435	0.902715220531996
GO:0001618	virus receptor activity	 61	0.99303095897884	1	20	41	6704	7398	0.690601808057265
GO:0001649	osteoblast differentiation	 86	0.915227050262183	1	35	51	6689	7388	0.857229569885035
GO:0001654	eye development	 29	0.391787364159249	1	15	14	6709	7425	1.08948388684896
GO:0001655	urogenital system development	 14	0.728526098434397	1	6	8	6718	7431	0.902715220531996
GO:0001656	metanephros development	 31	0.988626183659881	1	9	22	6715	7417	0.611516762295868
GO:0001657	ureteric bud development	 40	0.99208079342912	1	12	28	6712	7411	0.631900654372397
GO:0001658	branching involved in ureteric bud morphogenesis	 39	0.988847849492937	1	12	27	6712	7412	0.648103235253741
GO:0001659	temperature homeostasis	 16	0.706693964264422	1	7	9	6717	7430	0.921521787626413
GO:0001661	conditioned taste aversion	  5	0.452745275304033	1	3	2	6721	7437	1.26380130874479
GO:0001662	behavioral fear response	 27	0.0776311536569698	0.807895728316903	17	10	6707	7429	1.32621124991738
GO:0001664	G-protein coupled receptor binding	 49	0.951618735895902	1	18	31	6706	7408	0.77375590331314
GO:0001665	alpha-N-acetylgalactosaminide alpha-2,6-sialyltransferase activity	  5	0.77940058892516	1	2	3	6722	7436	0.842534205829863
GO:0001667	ameboidal-type cell migration	  5	0.452745275304033	1	3	2	6721	7437	1.26380130874479
GO:0001669	acrosomal vesicle	 57	0.887653172691005	1	23	34	6701	7405	0.849924856758195
GO:0001671	ATPase activator activity	 21	0.25155850170495	1	12	9	6712	7430	1.20362029404266
GO:0001673	male germ cell nucleus	 11	0.431935112460319	1	6	5	6718	7434	1.14891028067709
GO:0001675	acrosome assembly	  9	0.438074670071218	1	5	4	6719	7435	1.17018639698592
GO:0001676	long-chain fatty acid metabolic process	 17	0.416253886790052	1	9	8	6715	7431	1.11511880183364
GO:0001678	cellular glucose homeostasis	 15	0.421118865258844	1	8	7	6716	7432	1.12337894110648
GO:0001682	tRNA 5	 10	0.78367246101976	1	4	6	6720	7433	0.842534205829863
GO:0001696	gastric acid secretion	  6	0.865182793759413	1	2	4	6722	7435	0.702111838191553
GO:0001702	gastrulation with mouth forming second	 15	0.798298186583662	1	6	9	6718	7430	0.842534205829863
GO:0001706	endoderm formation	 11	0.665993939534306	1	5	6	6719	7433	0.957425233897572
GO:0001707	mesoderm formation	 30	0.605736885713723	1	14	16	6710	7423	0.982956573468174
GO:0001708	cell fate specification	 13	0.933471720877997	1	4	9	6720	7430	0.648103235253741
GO:0001709	cell fate determination	 14	0.160610520833599	0.919686434773344	9	5	6715	7434	1.35407283079799
GO:0001711	endodermal cell fate commitment	  6	0.979023167332401	1	1	5	6723	7434	0.351055919095776
GO:0001725	stress fiber	 46	0.754808097501554	1	20	26	6704	7413	0.915798049815069
GO:0001726	ruffle	 89	0.562994443224601	1	42	47	6682	7392	0.994001029349838
GO:0001731	formation of translation preinitiation complex	 11	0.220387996626296	1	7	4	6717	7435	1.3403953274566
GO:0001736	establishment of planar polarity	 14	0.529251719099727	1	7	7	6717	7432	1.05316775728733
GO:0001741	XY body	 10	0.133503266897558	0.919686434773344	7	3	6717	7436	1.47443486020226
GO:0001750	photoreceptor outer segment	 48	0.966673047625761	1	17	31	6707	7408	0.745993828078525
GO:0001755	neural crest cell migration	 27	0.981441708246529	1	8	19	6716	7420	0.624099411725825
GO:0001756	somitogenesis	 44	0.312693872692444	1	23	21	6701	7418	1.10103901898221
GO:0001758	retinal dehydrogenase activity	  6	0.865182793759413	1	2	4	6722	7435	0.702111838191553
GO:0001759	organ induction	  8	0.952366339066048	1	2	6	6722	7433	0.526583878643665
GO:0001763	morphogenesis of a branching structure	  8	0.952366339066048	1	2	6	6722	7433	0.526583878643665
GO:0001764	neuron migration	 94	0.42764284270703	1	46	48	6678	7391	1.03075993266419
GO:0001765	membrane raft assembly	  6	0.297654371351411	1	4	2	6720	7437	1.40422367638311
GO:0001766	membrane raft polarization	  7	0.730029012673872	1	3	4	6721	7435	0.902715220531996
GO:0001768	establishment of T cell polarity	  6	0.865182793759413	1	2	4	6722	7435	0.702111838191553
GO:0001771	immunological synapse formation	 10	0.983985908365184	1	2	8	6722	7431	0.421267102914932
GO:0001772	immunological synapse	 31	0.787110627725678	1	13	18	6711	7421	0.883301989982921
GO:0001774	microglial cell activation	 14	0.956679005412873	1	4	10	6720	7429	0.601810147021331
GO:0001775	cell activation	 11	0.999163575349816	1	1	10	6723	7429	0.191485046779514
GO:0001776	leukocyte homeostasis	  5	0.77940058892516	1	2	3	6722	7436	0.842534205829863
GO:0001778	plasma membrane repair	  6	0.607836179256654	1	3	3	6721	7436	1.05316775728733
GO:0001779	natural killer cell differentiation	 11	0.665993939534306	1	5	6	6719	7433	0.957425233897572
GO:0001780	neutrophil homeostasis	  5	0.157494903089267	0.919686434773344	4	1	6720	7438	1.68506841165973
GO:0001782	B cell homeostasis	 21	0.738560418161868	1	9	12	6715	7427	0.902715220531996
GO:0001783	B cell apoptotic process	  7	0.444912401367032	1	4	3	6720	7436	1.20362029404266
GO:0001784	phosphotyrosine residue binding	 33	0.865742308063324	1	13	20	6711	7419	0.829768536044562
GO:0001786	phosphatidylserine binding	 35	0.514569683557429	1	17	18	6707	7421	1.02307724993626
GO:0001816	cytokine production	 23	0.92480513956827	1	8	15	6716	7424	0.732638439852055
GO:0001817	regulation of cytokine production	 12	0.75380380293781	1	5	7	6719	7432	0.877639797739441
GO:0001818	negative regulation of cytokine production	 11	0.953160347938253	1	3	8	6721	7431	0.574455140338543
GO:0001819	positive regulation of cytokine production	 25	0.912607021347774	1	9	16	6715	7423	0.758280785246877
GO:0001822	kidney development	 95	0.999745256436325	1	29	66	6695	7373	0.642986630764896
GO:0001823	mesonephros development	 10	1	1	0	10	6724	7429	0
GO:0001824	blastocyst development	 14	0.323388997222084	1	8	6	6716	7433	1.20362029404266
GO:0001825	blastocyst formation	  8	0.580280354503036	1	4	4	6720	7435	1.05316775728733
GO:0001829	trophectodermal cell differentiation	 13	0.426320358160906	1	7	6	6717	7433	1.13418066169405
GO:0001833	inner cell mass cell proliferation	  7	0.730029012673872	1	3	4	6721	7435	0.902715220531996
GO:0001836	release of cytochrome c from mitochondria	 22	0.796326194402031	1	9	13	6715	7426	0.861682710507815
GO:0001837	epithelial to mesenchymal transition	 32	0.905424112434511	1	12	20	6712	7419	0.789875817965497
GO:0001841	neural tube formation	 11	0.431935112460319	1	6	5	6718	7434	1.14891028067709
GO:0001843	neural tube closure	 74	0.729955210689271	1	33	41	6691	7398	0.939311783526537
GO:0001844	protein insertion into mitochondrial membrane involved in apoptotic signaling pathway	  7	0.919244306193629	1	2	5	6722	7434	0.601810147021331
GO:0001849	complement component C1q binding	  5	0.452745275304033	1	3	2	6721	7437	1.26380130874479
GO:0001867	complement activation, lectin pathway	  6	1	1	0	6	6724	7433	0
GO:0001875	lipopolysaccharide receptor activity	  5	0.77940058892516	1	2	3	6722	7436	0.842534205829863
GO:0001878	response to yeast	  6	0.979023167332401	1	1	5	6723	7434	0.351055919095776
GO:0001881	receptor recycling	  8	0.309544448231027	1	5	3	6719	7436	1.31645969660916
GO:0001886	endothelial cell morphogenesis	 10	0.559603563591584	1	5	5	6719	7434	1.05316775728733
GO:0001887	selenium compound metabolic process	  5	1	1	0	5	6724	7434	0
GO:0001889	liver development	 76	0.371421128367111	1	38	38	6686	7401	1.05316775728733
GO:0001890	placenta development	 32	0.455512481379508	1	16	16	6708	7423	1.05316775728733
GO:0001891	phagocytic cup	 16	0.853260719975205	1	6	10	6718	7429	0.789875817965497
GO:0001892	embryonic placenta development	 19	0.756503853067433	1	8	11	6716	7428	0.886878111399856
GO:0001893	maternal placenta development	 11	0.220387996626296	1	7	4	6717	7435	1.3403953274566
GO:0001894	tissue homeostasis	 16	0.517377397284026	1	8	8	6716	7431	1.05316775728733
GO:0001895	retina homeostasis	 24	0.946019062510409	1	8	16	6716	7423	0.702111838191553
GO:0001913	T cell mediated cytotoxicity	  5	0.960049771736903	1	1	4	6723	7435	0.421267102914932
GO:0001916	positive regulation of T cell mediated cytotoxicity	  7	0.730029012673872	1	3	4	6721	7435	0.902715220531996
GO:0001917	photoreceptor inner segment	 27	0.814070309852114	1	11	16	6713	7423	0.858136691123009
GO:0001919	regulation of receptor recycling	  5	0.452745275304033	1	3	2	6721	7437	1.26380130874479
GO:0001921	positive regulation of receptor recycling	 14	0.529251719099727	1	7	7	6717	7432	1.05316775728733
GO:0001931	uropod	 12	0.899474094191123	1	4	8	6720	7431	0.702111838191553
GO:0001932	regulation of protein phosphorylation	 46	0.139488824993462	0.919686434773344	26	20	6698	7419	1.19053746475959
GO:0001933	negative regulation of protein phosphorylation	 65	0.435910159801246	1	32	33	6692	7406	1.03696517640599
GO:0001935	endothelial cell proliferation	 15	0.972187308828691	1	4	11	6720	7428	0.561689470553242
GO:0001937	negative regulation of endothelial cell proliferation	 23	0.722173726826204	1	10	13	6714	7426	0.915798049815069
GO:0001938	positive regulation of endothelial cell proliferation	 58	0.983671152493529	1	20	38	6704	7401	0.726322591232641
GO:0001939	female pronucleus	  6	0.607836179256654	1	3	3	6721	7436	1.05316775728733
GO:0001940	male pronucleus	  5	0.77940058892516	1	2	3	6722	7436	0.842534205829863
GO:0001942	hair follicle development	 34	0.989884574190229	1	10	24	6714	7415	0.619510445463135
GO:0001944	vasculature development	 23	0.843995637843635	1	9	14	6715	7425	0.824218244833562
GO:0001945	lymph vessel development	 11	0.431935112460319	1	6	5	6718	7434	1.14891028067709
GO:0001946	lymphangiogenesis	 10	0.316545776550851	1	6	4	6718	7435	1.26380130874479
GO:0001947	heart looping	 50	0.736571156986416	1	22	28	6702	7411	0.926787626412849
GO:0001952	regulation of cell-matrix adhesion	 13	0.643122793005253	1	6	7	6718	7432	0.972154852880611
GO:0001953	negative regulation of cell-matrix adhesion	 13	0.822979434145659	1	5	8	6719	7431	0.810129044067176
GO:0001954	positive regulation of cell-matrix adhesion	 21	0.86019883501541	1	8	13	6716	7426	0.802413529361774
GO:0001955	blood vessel maturation	  7	0.730029012673872	1	3	4	6721	7435	0.902715220531996
GO:0001956	positive regulation of neurotransmitter secretion	  6	0.0114373555630656	0.427208830906354	6	0	6718	7439	2.10633551457466
GO:0001957	intramembranous ossification	  6	0.979023167332401	1	1	5	6723	7434	0.351055919095776
GO:0001958	endochondral ossification	 23	0.92480513956827	1	8	15	6716	7424	0.732638439852055
GO:0001959	regulation of cytokine-mediated signaling pathway	  6	0.607836179256654	1	3	3	6721	7436	1.05316775728733
GO:0001960	negative regulation of cytokine-mediated signaling pathway	  6	0.865182793759413	1	2	4	6722	7435	0.702111838191553
GO:0001961	positive regulation of cytokine-mediated signaling pathway	  6	0.607836179256654	1	3	3	6721	7436	1.05316775728733
GO:0001963	synaptic transmission, dopaminergic	  9	0.067355898427907	0.780679208284898	7	2	6717	7437	1.63826095578029
GO:0001964	startle response	 12	0.320810094151237	1	7	5	6717	7434	1.22869571683522
GO:0001965	G-protein alpha-subunit binding	 18	0.832783288477324	1	7	11	6717	7428	0.819130477890145
GO:0001967	suckling behavior	 11	0.0838548499097086	0.807895728316903	8	3	6716	7436	1.53188037423611
GO:0001968	fibronectin binding	 21	0.999745254573712	1	3	18	6721	7421	0.300905073510665
GO:0001972	retinoic acid binding	 11	0.665993939534306	1	5	6	6719	7433	0.957425233897572
GO:0001973	adenosine receptor signaling pathway	  7	0.98898631085553	1	1	6	6723	7433	0.300905073510665
GO:0001974	blood vessel remodeling	 29	0.800246571563356	1	12	17	6712	7422	0.871587109479169
GO:0001975	response to amphetamine	 23	0.843995637843635	1	9	14	6715	7425	0.824218244833562
GO:0002003	angiotensin maturation	  8	0.952366339066048	1	2	6	6722	7433	0.526583878643665
GO:0002009	morphogenesis of an epithelium	 16	0.982365044000861	1	4	12	6720	7427	0.526583878643665
GO:0002011	morphogenesis of an epithelial sheet	  7	0.730029012673872	1	3	4	6721	7435	0.902715220531996
GO:0002020	protease binding	 93	0.996106125364924	1	32	61	6692	7378	0.724760607165474
GO:0002021	response to dietary excess	  9	0.438074670071218	1	5	4	6719	7435	1.17018639698592
GO:0002024	diet induced thermogenesis	  7	0.98898631085553	1	1	6	6723	7433	0.300905073510665
GO:0002026	regulation of the force of heart contraction	 16	0.517377397284026	1	8	8	6716	7431	1.05316775728733
GO:0002027	regulation of heart rate	 24	0.979115970268494	1	7	17	6717	7422	0.614347858417609
GO:0002028	regulation of sodium ion transport	 17	0.607264962167558	1	8	9	6716	7430	0.991216712741015
GO:0002031	G-protein coupled receptor internalization	  7	0.730029012673872	1	3	4	6721	7435	0.902715220531996
GO:0002039	p53 binding	 65	0.1823246819491	0.949543953868825	35	30	6689	7409	1.13418066169405
GO:0002040	sprouting angiogenesis	 20	0.911428444807446	1	7	13	6717	7426	0.73721743010113
GO:0002042	cell migration involved in sprouting angiogenesis	 13	0.933471720877997	1	4	9	6720	7430	0.648103235253741
GO:0002043	blood vessel endothelial cell proliferation involved in sprouting angiogenesis	  6	0.865182793759413	1	2	4	6722	7435	0.702111838191553
GO:0002052	positive regulation of neuroblast proliferation	 17	0.960992303738273	1	5	12	6719	7427	0.619510445463135
GO:0002053	positive regulation of mesenchymal cell proliferation	 26	0.868518735159201	1	10	16	6714	7423	0.810129044067176
GO:0002062	chondrocyte differentiation	 33	0.865742308063324	1	13	20	6711	7419	0.829768536044562
GO:0002063	chondrocyte development	 15	0.421118865258844	1	8	7	6716	7432	1.12337894110648
GO:0002064	epithelial cell development	  9	0.882794860340315	1	3	6	6721	7433	0.702111838191553
GO:0002070	epithelial cell maturation	  5	0.77940058892516	1	2	3	6722	7436	0.842534205829863
GO:0002076	osteoblast development	 13	0.426320358160906	1	7	6	6717	7433	1.13418066169405
GO:0002080	acrosomal membrane	 14	0.956679005412873	1	4	10	6720	7429	0.601810147021331
GO:0002087	regulation of respiratory gaseous exchange by neurological system process	 12	0.320810094151237	1	7	5	6717	7434	1.22869571683522
GO:0002088	lens development in camera-type eye	 24	0.641180248362636	1	11	13	6713	7426	0.965403777513385
GO:0002089	lens morphogenesis in camera-type eye	 13	0.643122793005253	1	6	7	6718	7432	0.972154852880611
GO:0002091	negative regulation of receptor internalization	  7	0.730029012673872	1	3	4	6721	7435	0.902715220531996
GO:0002092	positive regulation of receptor internalization	 19	0.756503853067433	1	8	11	6716	7428	0.886878111399856
GO:0002098	tRNA wobble uridine modification	  7	0.0474968970055936	0.646585116783694	6	1	6718	7438	1.80543044106399
GO:0002102	podosome	 25	0.828635555615045	1	10	15	6714	7424	0.842534205829863
GO:0002115	store-operated calcium entry	  6	0.979023167332401	1	1	5	6723	7434	0.351055919095776
GO:0002116	semaphorin receptor complex	  7	0.444912401367032	1	4	3	6720	7436	1.20362029404266
GO:0002138	retinoic acid biosynthetic process	  6	0.865182793759413	1	2	4	6722	7435	0.702111838191553
GO:0002151	G-quadruplex RNA binding	  6	0.297654371351411	1	4	2	6720	7437	1.40422367638311
GO:0002161	aminoacyl-tRNA editing activity	 10	0.0390070262266277	0.625040317669623	8	2	6716	7437	1.68506841165973
GO:0002162	dystroglycan binding	  8	0.309544448231027	1	5	3	6719	7436	1.31645969660916
GO:0002181	cytoplasmic translation	 13	0.426320358160906	1	7	6	6717	7433	1.13418066169405
GO:0002199	zona pellucida receptor complex	  7	0.187210848839696	0.949543953868825	5	2	6719	7437	1.50452536755333
GO:0002218	activation of innate immune response	 12	0.5430601307694	1	6	6	6718	7433	1.05316775728733
GO:0002221	pattern recognition receptor signaling pathway	  8	1	1	0	8	6724	7431	0
GO:0002223	stimulatory C-type lectin receptor signaling pathway	 99	0.759895411083353	1	44	55	6680	7384	0.936149117588737
GO:0002224	toll-like receptor signaling pathway	 40	0.999704921948891	1	9	31	6715	7408	0.473925490779298
GO:0002227	innate immune response in mucosa	 10	1	1	0	10	6724	7429	0
GO:0002230	positive regulation of defense response to virus by host	 14	0.875453509540804	1	5	9	6719	7430	0.752262683776664
GO:0002237	response to molecule of bacterial origin	  8	0.819878207576373	1	3	5	6721	7434	0.789875817965497
GO:0002244	hematopoietic progenitor cell differentiation	 54	0.620920803681269	1	25	29	6699	7410	0.975155330821601
GO:0002260	lymphocyte homeostasis	  6	0.0114373555630656	0.427208830906354	6	0	6718	7439	2.10633551457466
GO:0002262	myeloid cell homeostasis	 10	0.559603563591584	1	5	5	6719	7434	1.05316775728733
GO:0002281	macrophage activation involved in immune response	 10	0.983985908365184	1	2	8	6722	7431	0.421267102914932
GO:0002286	T cell activation involved in immune response	  9	0.882794860340315	1	3	6	6721	7433	0.702111838191553
GO:0002315	marginal zone B cell differentiation	  8	0.580280354503036	1	4	4	6720	7435	1.05316775728733
GO:0002318	myeloid progenitor cell differentiation	  6	0.607836179256654	1	3	3	6721	7436	1.05316775728733
GO:0002320	lymphoid progenitor cell differentiation	  6	0.979023167332401	1	1	5	6723	7434	0.351055919095776
GO:0002322	B cell proliferation involved in immune response	  5	0.960049771736903	1	1	4	6723	7435	0.421267102914932
GO:0002377	immunoglobulin production	 15	0.914031171019375	1	5	10	6719	7429	0.702111838191553
GO:0002407	dendritic cell chemotaxis	 14	0.956679005412873	1	4	10	6720	7429	0.601810147021331
GO:0002430	complement receptor mediated signaling pathway	  7	0.919244306193629	1	2	5	6722	7434	0.601810147021331
GO:0002437	inflammatory response to antigenic stimulus	 12	0.971055765853963	1	3	9	6721	7430	0.526583878643665
GO:0002446	neutrophil mediated immunity	  8	0.952366339066048	1	2	6	6722	7433	0.526583878643665
GO:0002456	T cell mediated immunity	  9	0.69404490204849	1	4	5	6720	7434	0.936149117588737
GO:0002467	germinal center formation	  7	0.98898631085553	1	1	6	6723	7433	0.300905073510665
GO:0002474	antigen processing and presentation of peptide antigen via MHC class I	 24	0.780026211443039	1	10	14	6714	7425	0.877639797739441
GO:0002479	antigen processing and presentation of exogenous peptide antigen via MHC class I, TAP-dependent	 59	0.820326104375612	1	25	34	6699	7405	0.892515048548584
GO:0002480	antigen processing and presentation of exogenous peptide antigen via MHC class I, TAP-independent	  5	0.960049771736903	1	1	4	6723	7435	0.421267102914932
GO:0002504	antigen processing and presentation of peptide or polysaccharide antigen via MHC class II	  8	0.952366339066048	1	2	6	6722	7433	0.526583878643665
GO:0002523	leukocyte migration involved in inflammatory response	 10	0.925275888620553	1	3	7	6721	7432	0.631900654372397
GO:0002526	acute inflammatory response	 12	0.994792086314609	1	2	10	6722	7429	0.351055919095776
GO:0002544	chronic inflammatory response	  7	0.98898631085553	1	1	6	6723	7433	0.300905073510665
GO:0002548	monocyte chemotaxis	 25	0.99980131257979	1	4	21	6720	7418	0.337013682331945
GO:0002551	mast cell chemotaxis	  5	0.77940058892516	1	2	3	6722	7436	0.842534205829863
GO:0002606	positive regulation of dendritic cell antigen processing and presentation	  7	0.98898631085553	1	1	6	6723	7433	0.300905073510665
GO:0002634	regulation of germinal center formation	  5	1	1	0	5	6724	7434	0
GO:0002674	negative regulation of acute inflammatory response	  6	0.865182793759413	1	2	4	6722	7435	0.702111838191553
GO:0002675	positive regulation of acute inflammatory response	  9	0.882794860340315	1	3	6	6721	7433	0.702111838191553
GO:0002687	positive regulation of leukocyte migration	  9	0.996964464269463	1	1	8	6723	7431	0.234037279397184
GO:0002690	positive regulation of leukocyte chemotaxis	 10	0.78367246101976	1	4	6	6720	7433	0.842534205829863
GO:0002693	positive regulation of cellular extravasation	  6	0.865182793759413	1	2	4	6722	7435	0.702111838191553
GO:0002726	positive regulation of T cell cytokine production	  7	0.919244306193629	1	2	5	6722	7434	0.601810147021331
GO:0002741	positive regulation of cytokine secretion involved in immune response	  6	0.865182793759413	1	2	4	6722	7435	0.702111838191553
GO:0002755	MyD88-dependent toll-like receptor signaling pathway	 29	0.945287796141565	1	10	19	6714	7420	0.726322591232641
GO:0002756	MyD88-independent toll-like receptor signaling pathway	 10	0.78367246101976	1	4	6	6720	7433	0.842534205829863
GO:0002819	regulation of adaptive immune response	  7	1	1	0	7	6724	7432	0
GO:0002821	positive regulation of adaptive immune response	  5	0.452745275304033	1	3	2	6721	7437	1.26380130874479
GO:0002827	positive regulation of T-helper 1 type immune response	  5	1	1	0	5	6724	7434	0
GO:0002829	negative regulation of type 2 immune response	  5	0.960049771736903	1	1	4	6723	7435	0.421267102914932
GO:0002830	positive regulation of type 2 immune response	  5	1	1	0	5	6724	7434	0
GO:0002903	negative regulation of B cell apoptotic process	  6	0.607836179256654	1	3	3	6721	7436	1.05316775728733
GO:0002931	response to ischemia	 33	0.774610796030802	1	14	19	6710	7420	0.893596884971067
GO:0002934	desmosome organization	  5	0.77940058892516	1	2	3	6722	7436	0.842534205829863
GO:0003006	developmental process involved in reproduction	  5	0.960049771736903	1	1	4	6723	7435	0.421267102914932
GO:0003007	heart morphogenesis	 44	0.847317175248966	1	18	26	6706	7413	0.861682710507815
GO:0003009	skeletal muscle contraction	 21	0.999973487093348	1	2	19	6722	7420	0.200603382340444
GO:0003014	renal system process	 10	0.983985908365184	1	2	8	6722	7431	0.421267102914932
GO:0003016	respiratory system process	  9	0.438074670071218	1	5	4	6719	7435	1.17018639698592
GO:0003073	regulation of systemic arterial blood pressure	 10	0.78367246101976	1	4	6	6720	7433	0.842534205829863
GO:0003081	regulation of systemic arterial blood pressure by renin-angiotensin	  5	1	1	0	5	6724	7434	0
GO:0003084	positive regulation of systemic arterial blood pressure	  6	0.865182793759413	1	2	4	6722	7435	0.702111838191553
GO:0003085	negative regulation of systemic arterial blood pressure	  8	0.952366339066048	1	2	6	6722	7433	0.526583878643665
GO:0003091	renal water homeostasis	 30	0.99418639308094	1	8	22	6716	7417	0.561689470553242
GO:0003094	glomerular filtration	  7	0.444912401367032	1	4	3	6720	7436	1.20362029404266
GO:0003139	secondary heart field specification	  7	0.919244306193629	1	2	5	6722	7434	0.601810147021331
GO:0003143	embryonic heart tube morphogenesis	  6	0.0874151689581943	0.807895728316903	5	1	6719	7438	1.75527959547888
GO:0003148	outflow tract septum morphogenesis	 17	0.895242422289557	1	6	11	6718	7428	0.743412534555762
GO:0003149	membranous septum morphogenesis	  9	0.69404490204849	1	4	5	6720	7434	0.936149117588737
GO:0003150	muscular septum morphogenesis	  5	0.157494903089267	0.919686434773344	4	1	6720	7438	1.68506841165973
GO:0003151	outflow tract morphogenesis	 44	0.988172250282583	1	14	30	6710	7409	0.6701976637283
GO:0003158	endothelium development	  6	0.607836179256654	1	3	3	6721	7436	1.05316775728733
GO:0003170	heart valve development	  5	0.157494903089267	0.919686434773344	4	1	6720	7438	1.68506841165973
GO:0003179	heart valve morphogenesis	  5	0.77940058892516	1	2	3	6722	7436	0.842534205829863
GO:0003181	atrioventricular valve morphogenesis	  9	0.996964464269463	1	1	8	6723	7431	0.234037279397184
GO:0003183	mitral valve morphogenesis	  8	0.819878207576373	1	3	5	6721	7434	0.789875817965497
GO:0003184	pulmonary valve morphogenesis	 10	0.78367246101976	1	4	6	6720	7433	0.842534205829863
GO:0003197	endocardial cushion development	 10	0.78367246101976	1	4	6	6720	7433	0.842534205829863
GO:0003198	epithelial to mesenchymal transition involved in endocardial cushion formation	 12	0.994792086314609	1	2	10	6722	7429	0.351055919095776
GO:0003203	endocardial cushion morphogenesis	 14	0.98932697223781	1	3	11	6721	7428	0.451357610265998
GO:0003208	cardiac ventricle morphogenesis	  7	0.98898631085553	1	1	6	6723	7433	0.300905073510665
GO:0003209	cardiac atrium morphogenesis	  6	0.865182793759413	1	2	4	6722	7435	0.702111838191553
GO:0003214	cardiac left ventricle morphogenesis	 10	0.316545776550851	1	6	4	6718	7435	1.26380130874479
GO:0003215	cardiac right ventricle morphogenesis	  8	0.580280354503036	1	4	4	6720	7435	1.05316775728733
GO:0003222	ventricular trabecula myocardium morphogenesis	 14	0.529251719099727	1	7	7	6717	7432	1.05316775728733
GO:0003231	cardiac ventricle development	  5	0.452745275304033	1	3	2	6721	7437	1.26380130874479
GO:0003254	regulation of membrane depolarization	  7	0.444912401367032	1	4	3	6720	7436	1.20362029404266
GO:0003279	cardiac septum development	 12	0.320810094151237	1	7	5	6717	7434	1.22869571683522
GO:0003281	ventricular septum development	 22	0.325498770721016	1	12	10	6712	7429	1.14891028067709
GO:0003283	atrial septum development	  5	0.452745275304033	1	3	2	6721	7437	1.26380130874479
GO:0003300	cardiac muscle hypertrophy	  8	0.580280354503036	1	4	4	6720	7435	1.05316775728733
GO:0003309	type B pancreatic cell differentiation	  5	0.157494903089267	0.919686434773344	4	1	6720	7438	1.68506841165973
GO:0003323	type B pancreatic cell development	 12	0.971055765853963	1	3	9	6721	7430	0.526583878643665
GO:0003333	amino acid transmembrane transport	 35	0.959812256750141	1	12	23	6712	7416	0.722172176425597
GO:0003334	keratinocyte development	 10	0.559603563591584	1	5	5	6719	7434	1.05316775728733
GO:0003337	mesenchymal to epithelial transition involved in metanephros morphogenesis	  7	0.98898631085553	1	1	6	6723	7433	0.300905073510665
GO:0003341	cilium movement	 26	0.935947878741725	1	9	17	6715	7422	0.729116139660459
GO:0003344	pericardium morphogenesis	  7	0.919244306193629	1	2	5	6722	7434	0.601810147021331
GO:0003351	epithelial cilium movement	 12	0.75380380293781	1	5	7	6719	7432	0.877639797739441
GO:0003357	noradrenergic neuron differentiation	  5	1	1	0	5	6724	7434	0
GO:0003360	brainstem development	  7	0.730029012673872	1	3	4	6721	7435	0.902715220531996
GO:0003374	dynamin family protein polymerization involved in mitochondrial fission	  6	0.297654371351411	1	4	2	6720	7437	1.40422367638311
GO:0003376	sphingosine-1-phosphate signaling pathway	 11	0.953160347938253	1	3	8	6721	7431	0.574455140338543
GO:0003382	epithelial cell morphogenesis	 12	0.320810094151237	1	7	5	6717	7434	1.22869571683522
GO:0003406	retinal pigment epithelium development	  6	0.865182793759413	1	2	4	6722	7435	0.702111838191553
GO:0003407	neural retina development	 13	0.822979434145659	1	5	8	6719	7431	0.810129044067176
GO:0003416	endochondral bone growth	  6	0.297654371351411	1	4	2	6720	7437	1.40422367638311
GO:0003417	growth plate cartilage development	  7	1	1	0	7	6724	7432	0
GO:0003678	DNA helicase activity	 22	0.325498770721016	1	12	10	6712	7429	1.14891028067709
GO:0003680	AT DNA binding	  7	0.919244306193629	1	2	5	6722	7434	0.601810147021331
GO:0003684	damaged DNA binding	 55	0.00236650299920452	0.239639566866816	37	18	6687	7421	1.41698934616841
GO:0003688	DNA replication origin binding	 12	0.5430601307694	1	6	6	6718	7433	1.05316775728733
GO:0003689	DNA clamp loader activity	  9	0.067355898427907	0.780679208284898	7	2	6717	7437	1.63826095578029
GO:0003690	double-stranded DNA binding	 95	0.13293801429738	0.919686434773344	51	44	6673	7395	1.13076959203482
GO:0003691	double-stranded telomeric DNA binding	  8	0.309544448231027	1	5	3	6719	7436	1.31645969660916
GO:0003697	single-stranded DNA binding	 70	0.0067903420186341	0.354502993326374	44	26	6680	7413	1.32398232344693
GO:0003705	transcription factor activity, RNA polymerase II distal enhancer sequence-specific binding	 58	0.983671152493529	1	20	38	6704	7401	0.726322591232641
GO:0003707	steroid hormone receptor activity	 53	0.983487534802406	1	18	35	6706	7404	0.715359231364978
GO:0003708	retinoic acid receptor activity	  5	0.960049771736903	1	1	4	6723	7435	0.421267102914932
GO:0003712	transcription cofactor activity	 59	0.180956013344525	0.949543953868825	32	27	6692	7412	1.14241926214219
GO:0003720	telomerase activity	  7	0.919244306193629	1	2	5	6722	7434	0.601810147021331
GO:0003724	RNA helicase activity	 10	0.0390070262266277	0.625040317669623	8	2	6716	7437	1.68506841165973
GO:0003725	double-stranded RNA binding	 57	0.0239101749377105	0.495149842313607	35	22	6689	7417	1.29336391245812
GO:0003727	single-stranded RNA binding	 41	0.61763521493367	1	19	22	6705	7417	0.976106701876061
GO:0003730	mRNA 3	 47	0.0645428120974132	0.780679208284898	28	19	6696	7420	1.25483817889554
GO:0003743	translation initiation factor activity	 45	0.261282040573043	1	24	21	6700	7418	1.12337894110648
GO:0003746	translation elongation factor activity	 19	0.0543219716836929	0.703764658430297	13	6	6711	7433	1.44117693102477
GO:0003747	translation release factor activity	  6	0.297654371351411	1	4	2	6720	7437	1.40422367638311
GO:0003755	peptidyl-prolyl cis-trans isomerase activity	 33	0.384864355454507	1	17	16	6707	7423	1.08508193175058
GO:0003756	protein disulfide isomerase activity	 18	0.325568860476231	1	10	8	6714	7431	1.17018639698592
GO:0003774	motor activity	 81	0.668022173986215	1	37	44	6687	7395	0.96215325974398
GO:0003777	microtubule motor activity	 54	0.217071591623781	1	29	25	6695	7414	1.13118018375306
GO:0003785	actin monomer binding	 19	0.877279625799761	1	7	12	6717	7427	0.776018347474874
GO:0003796	lysozyme activity	  7	1	1	0	7	6724	7432	0
GO:0003810	protein-glutamine gamma-glutamyltransferase activity	  7	0.98898631085553	1	1	6	6723	7433	0.300905073510665
GO:0003823	antigen binding	 32	0.999995479488294	1	4	28	6720	7411	0.263291939321832
GO:0003828	alpha-N-acetylneuraminate alpha-2,8-sialyltransferase activity	  5	0.77940058892516	1	2	3	6722	7436	0.842534205829863
GO:0003831	beta-N-acetylglucosaminylglycopeptide beta-1,4-galactosyltransferase activity	  8	0.580280354503036	1	4	4	6720	7435	1.05316775728733
GO:0003836	beta-galactoside (CMP) alpha-2,3-sialyltransferase activity	  6	0.297654371351411	1	4	2	6720	7437	1.40422367638311
GO:0003841	1-acylglycerol-3-phosphate O-acyltransferase activity	 17	0.0471138152487804	0.646585116783694	12	5	6712	7434	1.48682506911152
GO:0003847	1-alkyl-2-acetylglycerophosphocholine esterase activity	  5	1	1	0	5	6724	7434	0
GO:0003857	3-hydroxyacyl-CoA dehydrogenase activity	  6	0.607836179256654	1	3	3	6721	7436	1.05316775728733
GO:0003887	DNA-directed DNA polymerase activity	 22	0.655120963592744	1	10	12	6714	7427	0.957425233897572
GO:0003899	DNA-directed 5	 31	0.0182747917455592	0.495149842313607	21	10	6703	7429	1.42687244535703
GO:0003906	DNA-(apurinic or apyrimidinic site) lyase activity	 11	0.220387996626296	1	7	4	6717	7435	1.3403953274566
GO:0003910	DNA ligase (ATP) activity	  6	0.0874151689581943	0.807895728316903	5	1	6719	7438	1.75527959547888
GO:0003923	GPI-anchor transamidase activity	  5	0.0241003244622537	0.495149842313607	5	0	6719	7439	2.10633551457466
GO:0003950	NAD+ ADP-ribosyltransferase activity	 21	0.57968055192832	1	10	11	6714	7428	1.00301691170222
GO:0003951	NAD+ kinase activity	 15	0.0393086686268318	0.625040317669623	11	4	6713	7435	1.54464604402142
GO:0003954	NADH dehydrogenase activity	 11	0.0838548499097086	0.807895728316903	8	3	6716	7436	1.53188037423611
GO:0003958	NADPH-hemoprotein reductase activity	  6	0.865182793759413	1	2	4	6722	7435	0.702111838191553
GO:0003993	acid phosphatase activity	  8	0.025392299605826	0.495149842313607	7	1	6717	7438	1.84304357525283
GO:0003995	acyl-CoA dehydrogenase activity	 12	0.320810094151237	1	7	5	6717	7434	1.22869571683522
GO:0004000	adenosine deaminase activity	  8	0.952366339066048	1	2	6	6722	7433	0.526583878643665
GO:0004003	ATP-dependent DNA helicase activity	 25	0.0725535511024713	0.807895728316903	16	9	6708	7430	1.34805472932778
GO:0004004	ATP-dependent RNA helicase activity	 53	0.259455447035684	1	28	25	6696	7414	1.11278102656774
GO:0004012	phospholipid-translocating ATPase activity	 12	0.148657926965624	0.919686434773344	8	4	6716	7435	1.40422367638311
GO:0004016	adenylate cyclase activity	 11	0.990836032904502	1	2	9	6722	7430	0.382970093559029
GO:0004017	adenylate kinase activity	  5	0.452745275304033	1	3	2	6721	7437	1.26380130874479
GO:0004022	alcohol dehydrogenase (NAD) activity	  7	0.444912401367032	1	4	3	6720	7436	1.20362029404266
GO:0004029	aldehyde dehydrogenase (NAD) activity	 12	0.971055765853963	1	3	9	6721	7430	0.526583878643665
GO:0004030	aldehyde dehydrogenase [NAD(P)+] activity	  5	0.960049771736903	1	1	4	6723	7435	0.421267102914932
GO:0004032	alditol:NADP+ 1-oxidoreductase activity	  7	0.919244306193629	1	2	5	6722	7434	0.601810147021331
GO:0004033	aldo-keto reductase (NADP) activity	 12	0.899474094191123	1	4	8	6720	7431	0.702111838191553
GO:0004045	aminoacyl-tRNA hydrolase activity	  5	0.960049771736903	1	1	4	6723	7435	0.421267102914932
GO:0004062	aryl sulfotransferase activity	  5	0.77940058892516	1	2	3	6722	7436	0.842534205829863
GO:0004064	arylesterase activity	  5	0.77940058892516	1	2	3	6722	7436	0.842534205829863
GO:0004065	arylsulfatase activity	 10	0.983985908365184	1	2	8	6722	7431	0.421267102914932
GO:0004075	biotin carboxylase activity	  5	0.452745275304033	1	3	2	6721	7437	1.26380130874479
GO:0004089	carbonate dehydratase activity	 11	0.953160347938253	1	3	8	6721	7431	0.574455140338543
GO:0004112	cyclic-nucleotide phosphodiesterase activity	  5	0.77940058892516	1	2	3	6722	7436	0.842534205829863
GO:0004114	3	 22	0.325498770721016	1	12	10	6712	7429	1.14891028067709
GO:0004115	3	 15	0.237875362689918	1	9	6	6715	7433	1.26380130874479
GO:0004128	cytochrome-b5 reductase activity, acting on NAD(P)H	  7	0.730029012673872	1	3	4	6721	7435	0.902715220531996
GO:0004129	cytochrome-c oxidase activity	 21	0.134279084429805	0.919686434773344	13	8	6711	7431	1.30392198521288
GO:0004143	diacylglycerol kinase activity	 10	0.0390070262266277	0.625040317669623	8	2	6716	7437	1.68506841165973
GO:0004175	endopeptidase activity	 70	0.66047416827854	1	32	38	6692	7401	0.962896235234129
GO:0004177	aminopeptidase activity	 30	0.915575929257217	1	11	19	6713	7420	0.772323022010708
GO:0004180	carboxypeptidase activity	 26	0.868518735159201	1	10	16	6714	7423	0.810129044067176
GO:0004181	metallocarboxypeptidase activity	 17	0.776294265732228	1	7	10	6717	7429	0.867314623648389
GO:0004185	serine-type carboxypeptidase activity	  8	0.580280354503036	1	4	4	6720	7435	1.05316775728733
GO:0004190	aspartic-type endopeptidase activity	 16	0.517377397284026	1	8	8	6716	7431	1.05316775728733
GO:0004197	cysteine-type endopeptidase activity	 54	0.620920803681269	1	25	29	6699	7410	0.975155330821601
GO:0004198	calcium-dependent cysteine-type endopeptidase activity	 14	0.160610520833599	0.919686434773344	9	5	6715	7434	1.35407283079799
GO:0004222	metalloendopeptidase activity	 87	0.929080817508547	1	35	52	6689	7387	0.847376356438081
GO:0004298	threonine-type endopeptidase activity	 15	0.421118865258844	1	8	7	6716	7432	1.12337894110648
GO:0004300	enoyl-CoA hydratase activity	  8	0.309544448231027	1	5	3	6719	7436	1.31645969660916
GO:0004303	estradiol 17-beta-dehydrogenase activity	  7	0.98898631085553	1	1	6	6723	7433	0.300905073510665
GO:0004308	exo-alpha-sialidase activity	  6	0.865182793759413	1	2	4	6722	7435	0.702111838191553
GO:0004331	fructose-2,6-bisphosphate 2-phosphatase activity	  5	0.452745275304033	1	3	2	6721	7437	1.26380130874479
GO:0004340	glucokinase activity	  5	0.960049771736903	1	1	4	6723	7435	0.421267102914932
GO:0004364	glutathione transferase activity	 17	0.895242422289557	1	6	11	6718	7428	0.743412534555762
GO:0004383	guanylate cyclase activity	 15	0.972187308828691	1	4	11	6720	7428	0.561689470553242
GO:0004385	guanylate kinase activity	 13	0.426320358160906	1	7	6	6717	7433	1.13418066169405
GO:0004396	hexokinase activity	  5	0.960049771736903	1	1	4	6723	7435	0.421267102914932
GO:0004402	histone acetyltransferase activity	 39	0.375269854778375	1	20	19	6704	7420	1.08017205875623
GO:0004407	histone deacetylase activity	 39	0.375269854778375	1	20	19	6704	7420	1.08017205875623
GO:0004415	hyalurononglucosaminidase activity	  7	0.98898631085553	1	1	6	6723	7433	0.300905073510665
GO:0004435	phosphatidylinositol phospholipase C activity	 23	0.989780830505069	1	6	17	6718	7422	0.549478829889041
GO:0004438	phosphatidylinositol-3-phosphatase activity	 13	0.0309498150207146	0.552600112408603	10	3	6714	7436	1.62025808813435
GO:0004439	phosphatidylinositol-4,5-bisphosphate 5-phosphatase activity	  8	0.309544448231027	1	5	3	6719	7436	1.31645969660916
GO:0004445	inositol-polyphosphate 5-phosphatase activity	  5	0.452745275304033	1	3	2	6721	7437	1.26380130874479
GO:0004465	lipoprotein lipase activity	  5	0.960049771736903	1	1	4	6723	7435	0.421267102914932
GO:0004467	long-chain fatty acid-CoA ligase activity	 11	0.220387996626296	1	7	4	6717	7435	1.3403953274566
GO:0004497	monooxygenase activity	 54	0.406147859027563	1	27	27	6697	7412	1.05316775728733
GO:0004518	nuclease activity	 97	0.18199940948942	0.949543953868825	51	46	6673	7393	1.10745475508564
GO:0004519	endonuclease activity	 64	0.389178966322207	1	32	32	6692	7407	1.05316775728733
GO:0004520	endodeoxyribonuclease activity	 16	0.170220385600338	0.949543953868825	10	6	6714	7433	1.31645969660916
GO:0004521	endoribonuclease activity	 16	0.94165410331218	1	5	11	6719	7428	0.658229848304581
GO:0004523	RNA-DNA hybrid ribonuclease activity	  7	0.444912401367032	1	4	3	6720	7436	1.20362029404266
GO:0004526	ribonuclease P activity	  9	0.882794860340315	1	3	6	6721	7433	0.702111838191553
GO:0004527	exonuclease activity	 42	0.0425188051553136	0.646585116783694	26	16	6698	7423	1.30392198521288
GO:0004532	exoribonuclease activity	  5	0.77940058892516	1	2	3	6722	7436	0.842534205829863
GO:0004535	poly(A)-specific ribonuclease activity	 13	0.643122793005253	1	6	7	6718	7432	0.972154852880611
GO:0004536	deoxyribonuclease activity	  7	0.919244306193629	1	2	5	6722	7434	0.601810147021331
GO:0004540	ribonuclease activity	 21	0.937043249703464	1	7	14	6717	7425	0.702111838191553
GO:0004550	nucleoside diphosphate kinase activity	 10	0.559603563591584	1	5	5	6719	7434	1.05316775728733
GO:0004553	hydrolase activity, hydrolyzing O-glycosyl compounds	 25	0.828635555615045	1	10	15	6714	7424	0.842534205829863
GO:0004559	alpha-mannosidase activity	  5	0.157494903089267	0.919686434773344	4	1	6720	7438	1.68506841165973
GO:0004565	beta-galactosidase activity	  5	0.960049771736903	1	1	4	6723	7435	0.421267102914932
GO:0004568	chitinase activity	  5	0.452745275304033	1	3	2	6721	7437	1.26380130874479
GO:0004571	mannosyl-oligosaccharide 1,2-alpha-mannosidase activity	  7	0.0474968970055936	0.646585116783694	6	1	6718	7438	1.80543044106399
GO:0004576	oligosaccharyl transferase activity	  5	0.452745275304033	1	3	2	6721	7437	1.26380130874479
GO:0004579	dolichyl-diphosphooligosaccharide-protein glycotransferase activity	  9	0.69404490204849	1	4	5	6720	7434	0.936149117588737
GO:0004596	peptide alpha-N-acetyltransferase activity	 10	0.559603563591584	1	5	5	6719	7434	1.05316775728733
GO:0004601	peroxidase activity	 26	0.973206597001812	1	8	18	6716	7421	0.648103235253741
GO:0004602	glutathione peroxidase activity	 15	0.972187308828691	1	4	11	6720	7428	0.561689470553242
GO:0004620	phospholipase activity	 10	0.133503266897558	0.919686434773344	7	3	6717	7436	1.47443486020226
GO:0004622	lysophospholipase activity	 16	0.517377397284026	1	8	8	6716	7431	1.05316775728733
GO:0004623	phospholipase A2 activity	 23	0.843995637843635	1	9	14	6715	7425	0.824218244833562
GO:0004629	phospholipase C activity	 14	0.956679005412873	1	4	10	6720	7429	0.601810147021331
GO:0004630	phospholipase D activity	  6	0.865182793759413	1	2	4	6722	7435	0.702111838191553
GO:0004652	polynucleotide adenylyltransferase activity	  7	0.444912401367032	1	4	3	6720	7436	1.20362029404266
GO:0004653	polypeptide N-acetylgalactosaminyltransferase activity	 18	0.506938913103874	1	9	9	6715	7430	1.05316775728733
GO:0004659	prenyltransferase activity	  7	0.444912401367032	1	4	3	6720	7436	1.20362029404266
GO:0004675	transmembrane receptor protein serine/threonine kinase activity	 11	0.220387996626296	1	7	4	6717	7435	1.3403953274566
GO:0004679	AMP-activated protein kinase activity	  7	0.187210848839696	0.949543953868825	5	2	6719	7437	1.50452536755333
GO:0004683	calmodulin-dependent protein kinase activity	 21	0.0609416617953418	0.764685373658072	14	7	6710	7432	1.40422367638311
GO:0004689	phosphorylase kinase activity	  5	0.77940058892516	1	2	3	6722	7436	0.842534205829863
GO:0004691	cAMP-dependent protein kinase activity	  6	0.0874151689581943	0.807895728316903	5	1	6719	7438	1.75527959547888
GO:0004693	cyclin-dependent protein serine/threonine kinase activity	 22	0.489152057931013	1	11	11	6713	7428	1.05316775728733
GO:0004697	protein kinase C activity	 15	0.421118865258844	1	8	7	6716	7432	1.12337894110648
GO:0004702	signal transducer, downstream of receptor, with serine/threonine kinase activity	 14	0.160610520833599	0.919686434773344	9	5	6715	7434	1.35407283079799
GO:0004703	G-protein coupled receptor kinase activity	  6	0.297654371351411	1	4	2	6720	7437	1.40422367638311
GO:0004707	MAP kinase activity	 14	0.529251719099727	1	7	7	6717	7432	1.05316775728733
GO:0004708	MAP kinase kinase activity	 16	0.324860333233664	1	9	7	6715	7432	1.18481372694825
GO:0004709	MAP kinase kinase kinase activity	 26	0.198303125650341	0.983668097955673	15	11	6709	7428	1.21519356610076
GO:0004712	protein serine/threonine/tyrosine kinase activity	 27	0.258061678938058	1	15	12	6709	7427	1.17018639698592
GO:0004714	transmembrane receptor protein tyrosine kinase activity	 43	0.813397092897171	1	18	25	6706	7414	0.881721843310322
GO:0004715	non-membrane spanning protein tyrosine kinase activity	 47	0.92121909396472	1	18	29	6706	7410	0.806681686432848
GO:0004716	signal transducer, downstream of receptor, with protein tyrosine kinase activity	  9	0.69404490204849	1	4	5	6720	7434	0.936149117588737
GO:0004722	protein serine/threonine phosphatase activity	 54	0.00761199824089264	0.366137115386936	35	19	6689	7420	1.36521746315024
GO:0004725	protein tyrosine phosphatase activity	 88	0.00317473084484755	0.258092203330423	55	33	6669	7406	1.31645969660916
GO:0004726	non-membrane spanning protein tyrosine phosphatase activity	  8	0.113810689204897	0.88413902838582	6	2	6718	7437	1.57975163593099
GO:0004745	retinol dehydrogenase activity	 13	0.982330979346752	1	3	10	6721	7429	0.486077426440306
GO:0004758	serine C-palmitoyltransferase activity	  5	0.77940058892516	1	2	3	6722	7436	0.842534205829863
GO:0004784	superoxide dismutase activity	  5	0.77940058892516	1	2	3	6722	7436	0.842534205829863
GO:0004791	thioredoxin-disulfide reductase activity	  7	0.444912401367032	1	4	3	6720	7436	1.20362029404266
GO:0004806	triglyceride lipase activity	 11	0.953160347938253	1	3	8	6721	7431	0.574455140338543
GO:0004812	aminoacyl-tRNA ligase activity	 37	0.0517779357449354	0.680779601639561	23	14	6701	7425	1.30934369824911
GO:0004843	thiol-dependent ubiquitin-specific protease activity	 71	0.00241123434968833	0.239959390800018	46	25	6678	7414	1.36466807986527
GO:0004849	uridine kinase activity	  5	0.77940058892516	1	2	3	6722	7436	0.842534205829863
GO:0004857	enzyme inhibitor activity	 36	0.8854267926537	1	14	22	6710	7417	0.819130477890145
GO:0004859	phospholipase inhibitor activity	  8	0.994217735396885	1	1	7	6723	7432	0.263291939321832
GO:0004860	protein kinase inhibitor activity	 57	0.827947977629334	1	24	33	6700	7406	0.886878111399856
GO:0004861	cyclin-dependent protein serine/threonine kinase inhibitor activity	 10	0.78367246101976	1	4	6	6720	7433	0.842534205829863
GO:0004862	cAMP-dependent protein kinase inhibitor activity	  9	0.69404490204849	1	4	5	6720	7434	0.936149117588737
GO:0004864	protein phosphatase inhibitor activity	 35	0.762698586915096	1	15	20	6709	7419	0.902715220531996
GO:0004865	protein serine/threonine phosphatase inhibitor activity	  8	0.819878207576373	1	3	5	6721	7434	0.789875817965497
GO:0004866	endopeptidase inhibitor activity	 30	0.999565797327219	1	6	24	6718	7415	0.421267102914932
GO:0004867	serine-type endopeptidase inhibitor activity	 62	0.999863514217824	1	16	46	6708	7393	0.543570455374105
GO:0004869	cysteine-type endopeptidase inhibitor activity	 24	0.99829541467783	1	5	19	6719	7420	0.43881989886972
GO:0004875	complement receptor activity	  6	0.865182793759413	1	2	4	6722	7435	0.702111838191553
GO:0004879	RNA polymerase II transcription factor activity, ligand-activated sequence-specific DNA binding	 37	0.843930287056752	1	15	22	6709	7417	0.853919803205942
GO:0004887	thyroid hormone receptor activity	  7	0.730029012673872	1	3	4	6721	7435	0.902715220531996
GO:0004890	GABA-A receptor activity	 13	0.230372725000093	1	8	5	6716	7434	1.29620647050748
GO:0004896	cytokine receptor activity	 34	0.999937790646077	1	6	28	6718	7411	0.371706267277881
GO:0004908	interleukin-1 receptor activity	  6	1	1	0	6	6724	7433	0
GO:0004920	interleukin-10 receptor activity	  5	0.77940058892516	1	2	3	6722	7436	0.842534205829863
GO:0004931	extracellular ATP-gated cation channel activity	  7	0.730029012673872	1	3	4	6721	7435	0.902715220531996
GO:0004935	adrenergic receptor activity	  9	1	1	0	9	6724	7430	0
GO:0004950	chemokine receptor activity	 14	0.998346203775137	1	2	12	6722	7427	0.300905073510665
GO:0004957	prostaglandin E receptor activity	  5	0.77940058892516	1	2	3	6722	7436	0.842534205829863
GO:0004969	histamine receptor activity	  5	0.960049771736903	1	1	4	6723	7435	0.421267102914932
GO:0004970	ionotropic glutamate receptor activity	 15	0.798298186583662	1	6	9	6718	7430	0.842534205829863
GO:0004972	NMDA glutamate receptor activity	  6	0.607836179256654	1	3	3	6721	7436	1.05316775728733
GO:0004983	neuropeptide Y receptor activity	  5	0.77940058892516	1	2	3	6722	7436	0.842534205829863
GO:0004984	olfactory receptor activity	 38	0.999991711893089	1	6	32	6718	7407	0.332579291774946
GO:0004985	opioid receptor activity	  5	0.77940058892516	1	2	3	6722	7436	0.842534205829863
GO:0004993	G-protein coupled serotonin receptor activity	 11	0.999163575349816	1	1	10	6723	7429	0.191485046779514
GO:0005001	transmembrane receptor protein tyrosine phosphatase activity	 14	0.323388997222084	1	8	6	6716	7433	1.20362029404266
GO:0005003	ephrin receptor activity	 12	0.75380380293781	1	5	7	6719	7432	0.877639797739441
GO:0005004	GPI-linked ephrin receptor activity	  6	0.297654371351411	1	4	2	6720	7437	1.40422367638311
GO:0005005	transmembrane-ephrin receptor activity	  8	0.580280354503036	1	4	4	6720	7435	1.05316775728733
GO:0005007	fibroblast growth factor-activated receptor activity	  5	0.452745275304033	1	3	2	6721	7437	1.26380130874479
GO:0005021	vascular endothelial growth factor-activated receptor activity	  5	0.960049771736903	1	1	4	6723	7435	0.421267102914932
GO:0005024	transforming growth factor beta-activated receptor activity	  5	0.77940058892516	1	2	3	6722	7436	0.842534205829863
GO:0005031	tumor necrosis factor-activated receptor activity	 20	0.999558208796652	1	3	17	6721	7422	0.315950327186199
GO:0005041	low-density lipoprotein receptor activity	 14	0.728526098434397	1	6	8	6718	7431	0.902715220531996
GO:0005044	scavenger receptor activity	 43	0.999996329620344	1	7	36	6717	7403	0.342891827954014
GO:0005049	nuclear export signal receptor activity	  7	0.0474968970055936	0.646585116783694	6	1	6718	7438	1.80543044106399
GO:0005057	signal transducer activity, downstream of receptor	 36	0.57707668735919	1	17	19	6707	7420	0.994658437438033
GO:0005068	transmembrane receptor protein tyrosine kinase adaptor activity	  9	0.69404490204849	1	4	5	6720	7434	0.936149117588737
GO:0005070	SH3/SH2 adaptor activity	 48	0.0862724562776354	0.807895728316903	28	20	6696	7419	1.22869571683522
GO:0005078	MAP-kinase scaffold activity	  7	0.0474968970055936	0.646585116783694	6	1	6718	7438	1.80543044106399
GO:0005080	protein kinase C binding	 40	0.680701626877675	1	18	22	6706	7417	0.947850981558596
GO:0005086	ARF guanyl-nucleotide exchange factor activity	 20	0.0888797275608513	0.807895728316903	13	7	6711	7432	1.36911808447353
GO:0005088	Ras guanyl-nucleotide exchange factor activity	 94	0.989899876007572	1	34	60	6690	7379	0.761866037186578
GO:0005089	Rho guanyl-nucleotide exchange factor activity	 68	0.382986083832559	1	34	34	6690	7405	1.05316775728733
GO:0005092	GDP-dissociation inhibitor activity	 12	0.320810094151237	1	7	5	6717	7434	1.22869571683522
GO:0005095	GTPase inhibitor activity	 14	0.160610520833599	0.919686434773344	9	5	6715	7434	1.35407283079799
GO:0005104	fibroblast growth factor receptor binding	 19	0.983231201677496	1	5	14	6719	7425	0.55429881962491
GO:0005109	frizzled binding	 31	0.996120378966526	1	8	23	6716	7416	0.543570455374105
GO:0005112	Notch binding	 20	0.9653537478209	1	6	14	6718	7425	0.631900654372397
GO:0005113	patched binding	  7	1	1	0	7	6724	7432	0
GO:0005114	type II transforming growth factor beta receptor binding	  5	0.960049771736903	1	1	4	6723	7435	0.421267102914932
GO:0005123	death receptor binding	 15	0.798298186583662	1	6	9	6718	7430	0.842534205829863
GO:0005126	cytokine receptor binding	  6	1	1	0	6	6724	7433	0
GO:0005131	growth hormone receptor binding	  5	0.157494903089267	0.919686434773344	4	1	6720	7438	1.68506841165973
GO:0005138	interleukin-6 receptor binding	  6	0.607836179256654	1	3	3	6721	7436	1.05316775728733
GO:0005149	interleukin-1 receptor binding	  8	0.994217735396885	1	1	7	6723	7432	0.263291939321832
GO:0005154	epidermal growth factor receptor binding	 27	0.693189244333171	1	12	15	6712	7424	0.936149117588737
GO:0005158	insulin receptor binding	 30	0.322199322975026	1	16	14	6708	7425	1.12337894110648
GO:0005159	insulin-like growth factor receptor binding	 15	0.237875362689918	1	9	6	6715	7433	1.26380130874479
GO:0005160	transforming growth factor beta receptor binding	 33	0.994679788825413	1	9	24	6715	7415	0.574455140338543
GO:0005161	platelet-derived growth factor receptor binding	 14	0.956679005412873	1	4	10	6720	7429	0.601810147021331
GO:0005164	tumor necrosis factor receptor binding	 25	0.912607021347774	1	9	16	6715	7423	0.758280785246877
GO:0005168	neurotrophin TRKA receptor binding	  6	0.297654371351411	1	4	2	6720	7437	1.40422367638311
GO:0005178	integrin binding	 90	0.601880523548969	1	42	48	6682	7391	0.982956573468174
GO:0005179	hormone activity	 66	0.99999752880282	1	14	52	6710	7387	0.446798442485534
GO:0005184	neuropeptide hormone activity	 19	0.877279625799761	1	7	12	6717	7427	0.776018347474874
GO:0005200	structural constituent of cytoskeleton	 85	0.131180515073415	0.919686434773344	46	39	6678	7400	1.13989921965217
GO:0005201	extracellular matrix structural constituent	 55	0.990780470632242	1	18	37	6706	7402	0.689346168406252
GO:0005212	structural constituent of eye lens	 14	0.999879077895612	1	1	13	6723	7426	0.150452536755333
GO:0005225	volume-sensitive anion channel activity	  5	0.157494903089267	0.919686434773344	4	1	6720	7438	1.68506841165973
GO:0005227	calcium activated cation channel activity	 10	0.78367246101976	1	4	6	6720	7433	0.842534205829863
GO:0005229	intracellular calcium activated chloride channel activity	 15	0.914031171019375	1	5	10	6719	7429	0.702111838191553
GO:0005230	extracellular ligand-gated ion channel activity	 29	0.945287796141565	1	10	19	6714	7420	0.726322591232641
GO:0005231	excitatory extracellular ligand-gated ion channel activity	  5	0.452745275304033	1	3	2	6721	7437	1.26380130874479
GO:0005234	extracellular-glutamate-gated ion channel activity	 15	0.798298186583662	1	6	9	6718	7430	0.842534205829863
GO:0005242	inward rectifier potassium channel activity	 17	0.607264962167558	1	8	9	6716	7430	0.991216712741015
GO:0005243	gap junction channel activity	 11	0.953160347938253	1	3	8	6721	7431	0.574455140338543
GO:0005245	voltage-gated calcium channel activity	 32	0.321021215389182	1	17	15	6707	7424	1.11899074211779
GO:0005246	calcium channel regulator activity	 23	0.254283570903419	1	13	10	6711	7429	1.19053746475959
GO:0005247	voltage-gated chloride channel activity	 11	0.220387996626296	1	7	4	6717	7435	1.3403953274566
GO:0005248	voltage-gated sodium channel activity	 21	0.407325414326014	1	11	10	6713	7429	1.10331860287244
GO:0005249	voltage-gated potassium channel activity	 56	0.985710057256569	1	19	37	6705	7402	0.71464954958783
GO:0005251	delayed rectifier potassium channel activity	 16	0.853260719975205	1	6	10	6718	7429	0.789875817965497
GO:0005253	anion channel activity	  6	0.607836179256654	1	3	3	6721	7436	1.05316775728733
GO:0005254	chloride channel activity	 52	0.409844864613595	1	26	26	6698	7413	1.05316775728733
GO:0005261	cation channel activity	 24	0.0460940683228998	0.646585116783694	16	8	6708	7431	1.40422367638311
GO:0005262	calcium channel activity	 74	0.215793435877693	1	39	35	6685	7404	1.11009574416773
GO:0005267	potassium channel activity	 70	0.947594491224263	1	27	43	6697	7396	0.812443698478797
GO:0005272	sodium channel activity	 30	0.605736885713723	1	14	16	6710	7423	0.982956573468174
GO:0005313	L-glutamate transmembrane transporter activity	 11	0.0221890923454724	0.495149842313607	9	2	6715	7437	1.72336542101563
GO:0005314	high-affinity glutamate transmembrane transporter activity	  7	0.187210848839696	0.949543953868825	5	2	6719	7437	1.50452536755333
GO:0005319	lipid transporter activity	 16	0.94165410331218	1	5	11	6719	7428	0.658229848304581
GO:0005324	long-chain fatty acid transporter activity	  5	0.452745275304033	1	3	2	6721	7437	1.26380130874479
GO:0005328	neurotransmitter:sodium symporter activity	 16	0.706693964264422	1	7	9	6717	7430	0.921521787626413
GO:0005337	nucleoside transmembrane transporter activity	  6	0.865182793759413	1	2	4	6722	7435	0.702111838191553
GO:0005344	oxygen transporter activity	  7	0.98898631085553	1	1	6	6723	7433	0.300905073510665
GO:0005347	ATP transmembrane transporter activity	  5	0.77940058892516	1	2	3	6722	7436	0.842534205829863
GO:0005351	sugar:proton symporter activity	 11	0.665993939534306	1	5	6	6719	7433	0.957425233897572
GO:0005355	glucose transmembrane transporter activity	 13	0.822979434145659	1	5	8	6719	7431	0.810129044067176
GO:0005372	water transmembrane transporter activity	  5	0.960049771736903	1	1	4	6723	7435	0.421267102914932
GO:0005375	copper ion transmembrane transporter activity	  6	0.297654371351411	1	4	2	6720	7437	1.40422367638311
GO:0005381	iron ion transmembrane transporter activity	  5	0.157494903089267	0.919686434773344	4	1	6720	7438	1.68506841165973
GO:0005385	zinc ion transmembrane transporter activity	 19	0.592680980401227	1	9	10	6715	7429	0.997737875324838
GO:0005388	calcium-transporting ATPase activity	 14	0.323388997222084	1	8	6	6716	7433	1.20362029404266
GO:0005391	sodium:potassium-exchanging ATPase activity	  9	0.69404490204849	1	4	5	6720	7434	0.936149117588737
GO:0005432	calcium:sodium antiporter activity	  6	0.979023167332401	1	1	5	6723	7434	0.351055919095776
GO:0005452	inorganic anion exchanger activity	 16	0.982365044000861	1	4	12	6720	7427	0.526583878643665
GO:0005484	SNAP receptor activity	 34	0.0668797555442451	0.780679208284898	21	13	6703	7426	1.30097193547258
GO:0005487	nucleocytoplasmic transporter activity	 21	0.738560418161868	1	9	12	6715	7427	0.902715220531996
GO:0005496	steroid binding	 21	0.86019883501541	1	8	13	6716	7426	0.802413529361774
GO:0005501	retinoid binding	  8	0.819878207576373	1	3	5	6721	7434	0.789875817965497
GO:0005504	fatty acid binding	 14	0.728526098434397	1	6	8	6718	7431	0.902715220531996
GO:0005506	iron ion binding	 98	0.948912324096155	1	39	59	6685	7380	0.838235561922568
GO:0005507	copper ion binding	 40	0.0401507445605401	0.629755700009341	25	15	6699	7424	1.31645969660916
GO:0005513	detection of calcium ion	  8	0.580280354503036	1	4	4	6720	7435	1.05316775728733
GO:0005518	collagen binding	 54	0.620920803681269	1	25	29	6699	7410	0.975155330821601
GO:0005520	insulin-like growth factor binding	 20	0.9653537478209	1	6	14	6718	7425	0.631900654372397
GO:0005521	lamin binding	 14	0.160610520833599	0.919686434773344	9	5	6715	7434	1.35407283079799
GO:0005522	profilin binding	  9	0.438074670071218	1	5	4	6719	7435	1.17018639698592
GO:0005523	tropomyosin binding	 13	0.426320358160906	1	7	6	6717	7433	1.13418066169405
GO:0005528	FK506 binding	 12	0.75380380293781	1	5	7	6719	7432	0.877639797739441
GO:0005534	galactose binding	  5	0.77940058892516	1	2	3	6722	7436	0.842534205829863
GO:0005536	glucose binding	 11	0.850917330440019	1	4	7	6720	7432	0.765940187118057
GO:0005537	mannose binding	 12	0.5430601307694	1	6	6	6718	7433	1.05316775728733
GO:0005539	glycosaminoglycan binding	 24	0.780026211443039	1	10	14	6714	7425	0.877639797739441
GO:0005540	hyaluronic acid binding	 16	0.94165410331218	1	5	11	6719	7428	0.658229848304581
GO:0005542	folic acid binding	  7	0.98898631085553	1	1	6	6723	7433	0.300905073510665
GO:0005543	phospholipid binding	 75	0.950962544460137	1	29	46	6695	7393	0.814449732302201
GO:0005544	calcium-dependent phospholipid binding	 39	0.261740251185182	1	21	18	6703	7421	1.13418066169405
GO:0005545	1-phosphatidylinositol binding	 14	0.0625726545054608	0.771729405567349	10	4	6714	7435	1.50452536755333
GO:0005546	phosphatidylinositol-4,5-bisphosphate binding	 49	0.692449613722238	1	22	27	6702	7412	0.945701659604948
GO:0005547	phosphatidylinositol-3,4,5-trisphosphate binding	 33	0.774610796030802	1	14	19	6710	7420	0.893596884971067
GO:0005548	phospholipid transporter activity	 10	0.78367246101976	1	4	6	6720	7433	0.842534205829863
GO:0005549	odorant binding	  8	0.952366339066048	1	2	6	6722	7433	0.526583878643665
GO:0005577	fibrinogen complex	  8	0.994217735396885	1	1	7	6723	7432	0.263291939321832
GO:0005579	membrane attack complex	  5	0.960049771736903	1	1	4	6723	7435	0.421267102914932
GO:0005581	collagen trimer	 72	0.966172961528117	1	27	45	6697	7394	0.789875817965497
GO:0005587	collagen type IV trimer	  5	0.77940058892516	1	2	3	6722	7436	0.842534205829863
GO:0005604	basement membrane	 77	0.994707047800234	1	26	51	6698	7388	0.711230173752482
GO:0005605	basal lamina	 14	0.0625726545054608	0.771729405567349	10	4	6714	7435	1.50452536755333
GO:0005614	interstitial matrix	 12	0.5430601307694	1	6	6	6718	7433	1.05316775728733
GO:0005623	cell	 69	0.784147766689211	1	30	39	6694	7400	0.915798049815069
GO:0005637	nuclear inner membrane	 41	0.494590306023443	1	20	21	6704	7418	1.02748073881691
GO:0005639	integral component of nuclear inner membrane	 12	0.899474094191123	1	4	8	6720	7431	0.702111838191553
GO:0005640	nuclear outer membrane	 23	0.722173726826204	1	10	13	6714	7426	0.915798049815069
GO:0005641	nuclear envelope lumen	  8	0.113810689204897	0.88413902838582	6	2	6718	7437	1.57975163593099
GO:0005642	annulate lamellae	  5	0.0241003244622537	0.495149842313607	5	0	6719	7439	2.10633551457466
GO:0005643	nuclear pore	 66	0.100966765562472	0.868413773784606	37	29	6687	7410	1.18082445514034
GO:0005652	nuclear lamina	  6	0.607836179256654	1	3	3	6721	7436	1.05316775728733
GO:0005655	nucleolar ribonuclease P complex	  7	0.730029012673872	1	3	4	6721	7435	0.902715220531996
GO:0005657	replication fork	 17	0.243621618961318	1	10	7	6714	7432	1.23902089092627
GO:0005662	DNA replication factor A complex	 13	0.230372725000093	1	8	5	6716	7434	1.29620647050748
GO:0005663	DNA replication factor C complex	  6	0.0874151689581943	0.807895728316903	5	1	6719	7438	1.75527959547888
GO:0005664	nuclear origin of replication recognition complex	  7	0.187210848839696	0.949543953868825	5	2	6719	7437	1.50452536755333
GO:0005665	DNA-directed RNA polymerase II, core complex	 14	0.323388997222084	1	8	6	6716	7433	1.20362029404266
GO:0005666	DNA-directed RNA polymerase III complex	 16	0.0242540767935066	0.495149842313607	12	4	6712	7435	1.57975163593099
GO:0005669	transcription factor TFIID complex	 31	0.388266848384344	1	16	15	6708	7424	1.08714091074821
GO:0005671	Ada2/Gcn5/Ada3 transcription activator complex	 16	0.706693964264422	1	7	9	6717	7430	0.921521787626413
GO:0005675	holo TFIIH complex	  8	0.025392299605826	0.495149842313607	7	1	6717	7438	1.84304357525283
GO:0005677	chromatin silencing complex	  7	0.730029012673872	1	3	4	6721	7435	0.902715220531996
GO:0005680	anaphase-promoting complex	 17	0.0471138152487804	0.646585116783694	12	5	6712	7434	1.48682506911152
GO:0005682	U5 snRNP	 18	0.506938913103874	1	9	9	6715	7430	1.05316775728733
GO:0005683	U7 snRNP	  6	0.865182793759413	1	2	4	6722	7435	0.702111838191553
GO:0005684	U2-type spliceosomal complex	  6	0.297654371351411	1	4	2	6720	7437	1.40422367638311
GO:0005685	U1 snRNP	 17	0.0471138152487804	0.646585116783694	12	5	6712	7434	1.48682506911152
GO:0005686	U2 snRNP	 18	0.506938913103874	1	9	9	6715	7430	1.05316775728733
GO:0005687	U4 snRNP	  9	0.69404490204849	1	4	5	6720	7434	0.936149117588737
GO:0005688	U6 snRNP	  8	0.819878207576373	1	3	5	6721	7434	0.789875817965497
GO:0005689	U12-type spliceosomal complex	 24	0.780026211443039	1	10	14	6714	7425	0.877639797739441
GO:0005697	telomerase holoenzyme complex	 21	0.25155850170495	1	12	9	6712	7430	1.20362029404266
GO:0005719	nuclear euchromatin	 22	0.655120963592744	1	10	12	6714	7427	0.957425233897572
GO:0005720	nuclear heterochromatin	 18	0.832783288477324	1	7	11	6717	7428	0.819130477890145
GO:0005721	pericentric heterochromatin	 10	0.316545776550851	1	6	4	6718	7435	1.26380130874479
GO:0005732	small nucleolar ribonucleoprotein complex	  8	0.113810689204897	0.88413902838582	6	2	6718	7437	1.57975163593099
GO:0005736	DNA-directed RNA polymerase I complex	 12	0.148657926965624	0.919686434773344	8	4	6716	7435	1.40422367638311
GO:0005740	mitochondrial envelope	 13	0.0975861781940815	0.843214701401555	9	4	6715	7435	1.45823227932092
GO:0005742	mitochondrial outer membrane translocase complex	  6	0.0874151689581943	0.807895728316903	5	1	6719	7438	1.75527959547888
GO:0005744	mitochondrial inner membrane presequence translocase complex	  8	0.309544448231027	1	5	3	6719	7436	1.31645969660916
GO:0005746	mitochondrial respiratory chain	 10	0.316545776550851	1	6	4	6718	7435	1.26380130874479
GO:0005747	mitochondrial respiratory chain complex I	 40	0.00115773986485427	0.167061862498471	29	11	6695	7428	1.52709324806663
GO:0005750	mitochondrial respiratory chain complex III	  9	0.067355898427907	0.780679208284898	7	2	6717	7437	1.63826095578029
GO:0005751	mitochondrial respiratory chain complex IV	 10	0.133503266897558	0.919686434773344	7	3	6717	7436	1.47443486020226
GO:0005753	mitochondrial proton-transporting ATP synthase complex	 16	0.00109699223009629	0.165233002219546	14	2	6710	7437	1.84304357525283
GO:0005758	mitochondrial intermembrane space	 64	0.217093769480669	1	34	30	6690	7409	1.11899074211779
GO:0005761	mitochondrial ribosome	 26	0.0208257637244103	0.495149842313607	18	8	6706	7431	1.45823227932092
GO:0005762	mitochondrial large ribosomal subunit	 46	0.046951732367642	0.646585116783694	28	18	6696	7421	1.2821172697411
GO:0005763	mitochondrial small ribosomal subunit	 21	0.134279084429805	0.919686434773344	13	8	6711	7431	1.30392198521288
GO:0005771	multivesicular body	 21	0.407325414326014	1	11	10	6713	7429	1.10331860287244
GO:0005773	vacuole	 21	0.25155850170495	1	12	9	6712	7430	1.20362029404266
GO:0005774	vacuolar membrane	 13	0.426320358160906	1	7	6	6717	7433	1.13418066169405
GO:0005776	autophagosome	 57	0.258196430280283	1	30	27	6694	7412	1.10859763924982
GO:0005778	peroxisomal membrane	 56	0.0563993704604746	0.721811898664877	33	23	6691	7416	1.24123342823149
GO:0005779	integral component of peroxisomal membrane	 16	0.706693964264422	1	7	9	6717	7430	0.921521787626413
GO:0005782	peroxisomal matrix	 37	0.636172287470772	1	17	20	6707	7419	0.967775776966735
GO:0005785	signal recognition particle receptor complex	  6	0.0874151689581943	0.807895728316903	5	1	6719	7438	1.75527959547888
GO:0005786	signal recognition particle, endoplasmic reticulum targeting	  5	0.452745275304033	1	3	2	6721	7437	1.26380130874479
GO:0005787	signal peptidase complex	  5	0.0241003244622537	0.495149842313607	5	0	6719	7439	2.10633551457466
GO:0005790	smooth endoplasmic reticulum	 22	0.655120963592744	1	10	12	6714	7427	0.957425233897572
GO:0005791	rough endoplasmic reticulum	 41	0.494590306023443	1	20	21	6704	7418	1.02748073881691
GO:0005793	endoplasmic reticulum-Golgi intermediate compartment	 61	0.00328190293253998	0.25949511954275	40	21	6684	7418	1.38120361611453
GO:0005795	Golgi stack	 31	0.26026101790379	1	17	14	6707	7425	1.15508721766997
GO:0005796	Golgi lumen	 77	0.999968109060963	1	20	57	6704	7382	0.547100133655755
GO:0005797	Golgi medial cisterna	  5	0.0241003244622537	0.495149842313607	5	0	6719	7439	2.10633551457466
GO:0005798	Golgi-associated vesicle	 11	0.00362662415483058	0.275076368503502	10	1	6714	7438	1.91485046779514
GO:0005801	cis-Golgi network	 40	5.13795907815824e-06	0.00988543326637645	33	7	6691	7432	1.73772679952409
GO:0005811	lipid droplet	 65	0.720887866119472	1	29	36	6695	7403	0.939749691117924
GO:0005827	polar microtubule	  5	0.157494903089267	0.919686434773344	4	1	6720	7438	1.68506841165973
GO:0005828	kinetochore microtubule	  5	0.157494903089267	0.919686434773344	4	1	6720	7438	1.68506841165973
GO:0005832	chaperonin-containing T-complex	 10	0.133503266897558	0.919686434773344	7	3	6717	7436	1.47443486020226
GO:0005833	hemoglobin complex	  5	1	1	0	5	6724	7434	0
GO:0005834	heterotrimeric G-protein complex	 30	0.461375405343472	1	15	15	6709	7424	1.05316775728733
GO:0005838	proteasome regulatory particle	 12	0.320810094151237	1	7	5	6717	7434	1.22869571683522
GO:0005839	proteasome core complex	 17	0.416253886790052	1	9	8	6715	7431	1.11511880183364
GO:0005844	polysome	 37	0.507552451933799	1	18	19	6706	7420	1.02470376384713
GO:0005845	mRNA cap binding complex	 10	0.559603563591584	1	5	5	6719	7434	1.05316775728733
GO:0005847	mRNA cleavage and polyadenylation specificity factor complex	 12	0.75380380293781	1	5	7	6719	7432	0.877639797739441
GO:0005849	mRNA cleavage factor complex	  5	0.157494903089267	0.919686434773344	4	1	6720	7438	1.68506841165973
GO:0005851	eukaryotic translation initiation factor 2B complex	  6	0.607836179256654	1	3	3	6721	7436	1.05316775728733
GO:0005852	eukaryotic translation initiation factor 3 complex	 14	0.160610520833599	0.919686434773344	9	5	6715	7434	1.35407283079799
GO:0005858	axonemal dynein complex	  5	0.157494903089267	0.919686434773344	4	1	6720	7438	1.68506841165973
GO:0005859	muscle myosin complex	 14	0.956679005412873	1	4	10	6720	7429	0.601810147021331
GO:0005861	troponin complex	  8	0.994217735396885	1	1	7	6723	7432	0.263291939321832
GO:0005865	striated muscle thin filament	  7	0.0474968970055936	0.646585116783694	6	1	6718	7438	1.80543044106399
GO:0005868	cytoplasmic dynein complex	 21	0.0609416617953418	0.764685373658072	14	7	6710	7432	1.40422367638311
GO:0005869	dynactin complex	  8	0.00257530804409448	0.243683246401858	8	0	6716	7439	2.10633551457466
GO:0005871	kinesin complex	 37	0.507552451933799	1	18	19	6706	7420	1.02470376384713
GO:0005875	microtubule associated complex	 30	0.1166008275708	0.893784829666214	18	12	6706	7427	1.26380130874479
GO:0005876	spindle microtubule	 29	0.0387440161098984	0.625040317669623	19	10	6705	7429	1.38001292334202
GO:0005879	axonemal microtubule	  5	0.452745275304033	1	3	2	6721	7437	1.26380130874479
GO:0005881	cytoplasmic microtubule	 41	0.372250359182329	1	21	20	6703	7419	1.07885477575775
GO:0005882	intermediate filament	 74	0.999988397912069	1	18	56	6706	7383	0.512351881923565
GO:0005883	neurofilament	  9	0.206720270758876	0.983668097955673	6	3	6718	7436	1.40422367638311
GO:0005884	actin filament	 62	0.896177633973622	1	25	37	6699	7402	0.849328836522039
GO:0005885	Arp2/3 protein complex	  8	0.025392299605826	0.495149842313607	7	1	6717	7438	1.84304357525283
GO:0005890	sodium:potassium-exchanging ATPase complex	  7	0.444912401367032	1	4	3	6720	7436	1.20362029404266
GO:0005891	voltage-gated calcium channel complex	 24	0.324965824259735	1	13	11	6711	7428	1.14093173706127
GO:0005892	acetylcholine-gated channel complex	 11	0.999163575349816	1	1	10	6723	7429	0.191485046779514
GO:0005901	caveola	 63	0.948216798447399	1	24	39	6700	7400	0.802413529361774
GO:0005902	microvillus	 51	0.946603021351693	1	19	32	6705	7407	0.784713230919971
GO:0005903	brush border	 48	0.9996034921251	1	12	36	6712	7403	0.526583878643665
GO:0005905	clathrin-coated pit	 60	0.00207371338487603	0.222937212333575	40	20	6684	7419	1.40422367638311
GO:0005912	adherens junction	 66	0.674014944396179	1	30	36	6694	7403	0.957425233897572
GO:0005913	cell-cell adherens junction	 72	0.736657909599211	1	32	40	6692	7399	0.936149117588737
GO:0005915	zonula adherens	  8	0.819878207576373	1	3	5	6721	7434	0.789875817965497
GO:0005916	fascia adherens	  9	0.972243904416257	1	2	7	6722	7432	0.468074558794368
GO:0005921	gap junction	 24	0.99829541467783	1	5	19	6719	7420	0.43881989886972
GO:0005922	connexin complex	 15	0.972187308828691	1	4	11	6720	7428	0.561689470553242
GO:0005923	bicellular tight junction	 95	0.241634316719251	1	49	46	6675	7393	1.08642568646482
GO:0005930	axoneme	 61	0.444084903560383	1	30	31	6694	7408	1.0359027120859
GO:0005942	phosphatidylinositol 3-kinase complex	 11	0.850917330440019	1	4	7	6720	7432	0.765940187118057
GO:0005952	cAMP-dependent protein kinase complex	  7	0.444912401367032	1	4	3	6720	7436	1.20362029404266
GO:0005964	phosphorylase kinase complex	  5	0.77940058892516	1	2	3	6722	7436	0.842534205829863
GO:0005977	glycogen metabolic process	 34	0.712778465907433	1	15	19	6709	7420	0.929265668194702
GO:0005978	glycogen biosynthetic process	 23	0.722173726826204	1	10	13	6714	7426	0.915798049815069
GO:0005979	regulation of glycogen biosynthetic process	  7	0.730029012673872	1	3	4	6721	7435	0.902715220531996
GO:0005980	glycogen catabolic process	 17	0.607264962167558	1	8	9	6716	7430	0.991216712741015
GO:0006000	fructose metabolic process	  9	0.69404490204849	1	4	5	6720	7434	0.936149117588737
GO:0006002	fructose 6-phosphate metabolic process	  7	0.730029012673872	1	3	4	6721	7435	0.902715220531996
GO:0006003	fructose 2,6-bisphosphate metabolic process	  5	0.452745275304033	1	3	2	6721	7437	1.26380130874479
GO:0006004	fucose metabolic process	  6	0.979023167332401	1	1	5	6723	7434	0.351055919095776
GO:0006006	glucose metabolic process	 51	0.358238602349744	1	26	25	6698	7414	1.07381810546943
GO:0006012	galactose metabolic process	  9	0.438074670071218	1	5	4	6719	7435	1.17018639698592
GO:0006013	mannose metabolic process	  5	0.0241003244622537	0.495149842313607	5	0	6719	7439	2.10633551457466
GO:0006020	inositol metabolic process	  7	0.187210848839696	0.949543953868825	5	2	6719	7437	1.50452536755333
GO:0006024	glycosaminoglycan biosynthetic process	 36	0.938597744199527	1	13	23	6711	7416	0.760621158040849
GO:0006027	glycosaminoglycan catabolic process	 25	0.912607021347774	1	9	16	6715	7423	0.758280785246877
GO:0006029	proteoglycan metabolic process	  6	0.979023167332401	1	1	5	6723	7434	0.351055919095776
GO:0006032	chitin catabolic process	  5	0.452745275304033	1	3	2	6721	7437	1.26380130874479
GO:0006044	N-acetylglucosamine metabolic process	 13	0.822979434145659	1	5	8	6719	7431	0.810129044067176
GO:0006047	UDP-N-acetylglucosamine metabolic process	  7	0.919244306193629	1	2	5	6722	7434	0.601810147021331
GO:0006048	UDP-N-acetylglucosamine biosynthetic process	  9	0.882794860340315	1	3	6	6721	7433	0.702111838191553
GO:0006068	ethanol catabolic process	  7	0.98898631085553	1	1	6	6723	7433	0.300905073510665
GO:0006069	ethanol oxidation	 10	0.78367246101976	1	4	6	6720	7433	0.842534205829863
GO:0006071	glycerol metabolic process	  7	0.187210848839696	0.949543953868825	5	2	6719	7437	1.50452536755333
GO:0006081	cellular aldehyde metabolic process	 10	0.925275888620553	1	3	7	6721	7432	0.631900654372397
GO:0006085	acetyl-CoA biosynthetic process	  5	0.452745275304033	1	3	2	6721	7437	1.26380130874479
GO:0006089	lactate metabolic process	  5	0.157494903089267	0.919686434773344	4	1	6720	7438	1.68506841165973
GO:0006090	pyruvate metabolic process	 18	0.0300950583180779	0.549711001936538	13	5	6711	7434	1.5212423160817
GO:0006091	generation of precursor metabolites and energy	 39	0.0546234523521783	0.703764658430297	24	15	6700	7424	1.29620647050748
GO:0006094	gluconeogenesis	 37	0.507552451933799	1	18	19	6706	7420	1.02470376384713
GO:0006096	glycolytic process	 29	0.154605460192393	0.919686434773344	17	12	6707	7427	1.23474840509549
GO:0006098	pentose-phosphate shunt	 13	0.230372725000093	1	8	5	6716	7434	1.29620647050748
GO:0006099	tricarboxylic acid cycle	 25	0.000893992515883898	0.165233002219546	20	5	6704	7434	1.68506841165973
GO:0006101	citrate metabolic process	  6	0.607836179256654	1	3	3	6721	7436	1.05316775728733
GO:0006102	isocitrate metabolic process	  5	0.157494903089267	0.919686434773344	4	1	6720	7438	1.68506841165973
GO:0006103	2-oxoglutarate metabolic process	 17	0.118839522247653	0.899006189270582	11	6	6713	7433	1.3629229800189
GO:0006105	succinate metabolic process	  8	0.580280354503036	1	4	4	6720	7435	1.05316775728733
GO:0006107	oxaloacetate metabolic process	 12	0.320810094151237	1	7	5	6717	7434	1.22869571683522
GO:0006108	malate metabolic process	  7	0.0474968970055936	0.646585116783694	6	1	6718	7438	1.80543044106399
GO:0006110	regulation of glycolytic process	 35	0.164233271678403	0.937640399730705	20	15	6704	7424	1.20362029404266
GO:0006111	regulation of gluconeogenesis	  9	0.206720270758876	0.983668097955673	6	3	6718	7436	1.40422367638311
GO:0006112	energy reserve metabolic process	 13	0.822979434145659	1	5	8	6719	7431	0.810129044067176
GO:0006119	oxidative phosphorylation	 11	0.0221890923454724	0.495149842313607	9	2	6715	7437	1.72336542101563
GO:0006120	mitochondrial electron transport, NADH to ubiquinone	 37	0.00421379735342215	0.304025479049408	26	11	6698	7428	1.4801276588903
GO:0006122	mitochondrial electron transport, ubiquinol to cytochrome c	  9	0.067355898427907	0.780679208284898	7	2	6717	7437	1.63826095578029
GO:0006123	mitochondrial electron transport, cytochrome c to oxygen	 14	0.0625726545054608	0.771729405567349	10	4	6714	7435	1.50452536755333
GO:0006139	nucleobase-containing compound metabolic process	 51	0.466951480849142	1	25	26	6699	7413	1.03251740910522
GO:0006164	purine nucleotide biosynthetic process	 15	0.421118865258844	1	8	7	6716	7432	1.12337894110648
GO:0006165	nucleoside diphosphate phosphorylation	  9	0.69404490204849	1	4	5	6720	7434	0.936149117588737
GO:0006166	purine ribonucleoside salvage	  5	0.77940058892516	1	2	3	6722	7436	0.842534205829863
GO:0006167	AMP biosynthetic process	  5	0.157494903089267	0.919686434773344	4	1	6720	7438	1.68506841165973
GO:0006171	cAMP biosynthetic process	 14	0.98932697223781	1	3	11	6721	7428	0.451357610265998
GO:0006182	cGMP biosynthetic process	 21	0.998435934134292	1	4	17	6720	7422	0.401206764680887
GO:0006183	GTP biosynthetic process	  6	0.865182793759413	1	2	4	6722	7435	0.702111838191553
GO:0006189	de novo	  5	0.77940058892516	1	2	3	6722	7436	0.842534205829863
GO:0006195	purine nucleotide catabolic process	 11	0.850917330440019	1	4	7	6720	7432	0.765940187118057
GO:0006198	cAMP catabolic process	 14	0.160610520833599	0.919686434773344	9	5	6715	7434	1.35407283079799
GO:0006206	pyrimidine nucleobase metabolic process	  5	0.452745275304033	1	3	2	6721	7437	1.26380130874479
GO:0006207	de novo	  6	0.865182793759413	1	2	4	6722	7435	0.702111838191553
GO:0006221	pyrimidine nucleotide biosynthetic process	  9	0.882794860340315	1	3	6	6721	7433	0.702111838191553
GO:0006241	CTP biosynthetic process	  6	0.607836179256654	1	3	3	6721	7436	1.05316775728733
GO:0006259	DNA metabolic process	 24	0.780026211443039	1	10	14	6714	7425	0.877639797739441
GO:0006261	DNA-dependent DNA replication	 16	0.170220385600338	0.949543953868825	10	6	6714	7433	1.31645969660916
GO:0006264	mitochondrial DNA replication	  7	0.444912401367032	1	4	3	6720	7436	1.20362029404266
GO:0006265	DNA topological change	  7	0.730029012673872	1	3	4	6721	7435	0.902715220531996
GO:0006266	DNA ligation	 10	0.78367246101976	1	4	6	6720	7433	0.842534205829863
GO:0006268	DNA unwinding involved in DNA replication	  7	0.444912401367032	1	4	3	6720	7436	1.20362029404266
GO:0006270	DNA replication initiation	 29	0.680253022221135	1	13	16	6711	7423	0.944219368602433
GO:0006271	DNA strand elongation involved in DNA replication	  7	0.730029012673872	1	3	4	6721	7435	0.902715220531996
GO:0006275	regulation of DNA replication	 16	0.324860333233664	1	9	7	6715	7432	1.18481372694825
GO:0006278	RNA-dependent DNA biosynthetic process	  5	0.452745275304033	1	3	2	6721	7437	1.26380130874479
GO:0006282	regulation of DNA repair	  5	0.0241003244622537	0.495149842313607	5	0	6719	7439	2.10633551457466
GO:0006283	transcription-coupled nucleotide-excision repair	 62	1.32943249098892e-06	0.00383674216899403	48	14	6676	7425	1.63071136612232
GO:0006284	base-excision repair	 32	0.0296522687950593	0.549711001936538	21	11	6703	7428	1.38228268143962
GO:0006289	nucleotide-excision repair	 35	0.0227695543172911	0.495149842313607	23	12	6701	7427	1.38416333814906
GO:0006293	nucleotide-excision repair, preincision complex stabilization	 18	0.00196064838978763	0.222937212333575	15	3	6709	7436	1.75527959547888
GO:0006294	nucleotide-excision repair, preincision complex assembly	 24	0.00574695252526987	0.335064747230886	18	6	6706	7433	1.57975163593099
GO:0006295	nucleotide-excision repair, DNA incision, 3	 18	0.00196064838978763	0.222937212333575	15	3	6709	7436	1.75527959547888
GO:0006296	nucleotide-excision repair, DNA incision, 5	 31	0.000648360583366261	0.133654903113931	24	7	6700	7432	1.63071136612232
GO:0006297	nucleotide-excision repair, DNA gap filling	 20	0.0888797275608513	0.807895728316903	13	7	6711	7432	1.36911808447353
GO:0006298	mismatch repair	 21	0.738560418161868	1	9	12	6715	7427	0.902715220531996
GO:0006301	postreplication repair	 11	0.0221890923454724	0.495149842313607	9	2	6715	7437	1.72336542101563
GO:0006302	double-strand break repair	 53	0.021440952266452	0.495149842313607	33	20	6691	7419	1.31149192416913
GO:0006303	double-strand break repair via nonhomologous end joining	 45	0.108144230217026	0.88413902838582	26	19	6698	7420	1.21699385286536
GO:0006306	DNA methylation	 21	0.407325414326014	1	11	10	6713	7429	1.10331860287244
GO:0006307	DNA dealkylation involved in DNA repair	 10	0.925275888620553	1	3	7	6721	7432	0.631900654372397
GO:0006308	DNA catabolic process	  7	0.730029012673872	1	3	4	6721	7435	0.902715220531996
GO:0006309	apoptotic DNA fragmentation	 15	0.623867966210499	1	7	8	6717	7431	0.982956573468174
GO:0006310	DNA recombination	 80	0.0716864945785477	0.807895728316903	45	35	6679	7404	1.18481372694825
GO:0006312	mitotic recombination	  6	0.0874151689581943	0.807895728316903	5	1	6719	7438	1.75527959547888
GO:0006323	DNA packaging	  5	0.157494903089267	0.919686434773344	4	1	6720	7438	1.68506841165973
GO:0006325	chromatin organization	 53	0.675679951334996	1	24	29	6700	7410	0.953812308486638
GO:0006333	chromatin assembly or disassembly	  6	0.607836179256654	1	3	3	6721	7436	1.05316775728733
GO:0006334	nucleosome assembly	 57	0.96026591584122	1	21	36	6703	7403	0.776018347474874
GO:0006335	DNA replication-dependent nucleosome assembly	 11	0.431935112460319	1	6	5	6718	7434	1.14891028067709
GO:0006336	DNA replication-independent nucleosome assembly	 12	0.148657926965624	0.919686434773344	8	4	6716	7435	1.40422367638311
GO:0006337	nucleosome disassembly	 17	0.607264962167558	1	8	9	6716	7430	0.991216712741015
GO:0006338	chromatin remodeling	 77	0.183367283241029	0.949543953868825	41	36	6683	7403	1.1215552739943
GO:0006342	chromatin silencing	 27	0.547450272919978	1	13	14	6711	7425	1.01416154405446
GO:0006346	methylation-dependent chromatin silencing	  7	0.919244306193629	1	2	5	6722	7434	0.601810147021331
GO:0006348	chromatin silencing at telomere	  5	0.157494903089267	0.919686434773344	4	1	6720	7438	1.68506841165973
GO:0006349	regulation of gene expression by genetic imprinting	 13	0.426320358160906	1	7	6	6717	7433	1.13418066169405
GO:0006352	DNA-templated transcription, initiation	 24	0.641180248362636	1	11	13	6713	7426	0.965403777513385
GO:0006353	DNA-templated transcription, termination	  7	0.444912401367032	1	4	3	6720	7436	1.20362029404266
GO:0006356	regulation of transcription from RNA polymerase I promoter	  7	0.187210848839696	0.949543953868825	5	2	6719	7437	1.50452536755333
GO:0006359	regulation of transcription from RNA polymerase III promoter	 14	0.00376490525152056	0.275076368503502	12	2	6712	7437	1.80543044106399
GO:0006360	transcription from RNA polymerase I promoter	  6	0.297654371351411	1	4	2	6720	7437	1.40422367638311
GO:0006361	transcription initiation from RNA polymerase I promoter	 29	0.00572559653094272	0.335064747230886	21	8	6703	7431	1.52527744158855
GO:0006362	transcription elongation from RNA polymerase I promoter	 26	0.00728690897119196	0.362586539497586	19	7	6705	7432	1.53924518372763
GO:0006363	termination of RNA polymerase I transcription	 27	0.00458279740207076	0.310716678649344	20	7	6704	7432	1.56024852931456
GO:0006368	transcription elongation from RNA polymerase II promoter	 82	0.108416423781917	0.88413902838582	45	37	6679	7402	1.15591583116902
GO:0006369	termination of RNA polymerase II transcription	 60	0.00963568227383389	0.427208830906354	38	22	6686	7417	1.33401249256395
GO:0006370	7-methylguanosine mRNA capping	 27	0.0350589432775214	0.599479186247127	18	9	6706	7430	1.40422367638311
GO:0006376	mRNA splice site selection	 16	0.000123673057472345	0.0713840887730377	15	1	6709	7438	1.97468954491374
GO:0006378	mRNA polyadenylation	 26	0.324205758709722	1	14	12	6710	7427	1.13418066169405
GO:0006379	mRNA cleavage	 10	0.316545776550851	1	6	4	6718	7435	1.26380130874479
GO:0006383	transcription from RNA polymerase III promoter	 32	0.00449374253934093	0.308784308774713	23	9	6701	7430	1.51392865110054
GO:0006384	transcription initiation from RNA polymerase III promoter	  5	0.77940058892516	1	2	3	6722	7436	0.842534205829863
GO:0006388	tRNA splicing, via endonucleolytic cleavage and ligation	 13	0.230372725000093	1	8	5	6716	7434	1.29620647050748
GO:0006390	transcription from mitochondrial promoter	  7	0.0474968970055936	0.646585116783694	6	1	6718	7438	1.80543044106399
GO:0006396	RNA processing	100	0.0133427504330197	0.442059337527911	59	41	6665	7398	1.24273795359905
GO:0006398	mRNA 3	  5	0.452745275304033	1	3	2	6721	7437	1.26380130874479
GO:0006400	tRNA modification	 29	0.015991699163769	0.485810987227761	20	9	6704	7430	1.45264518246528
GO:0006401	RNA catabolic process	 22	0.796326194402031	1	9	13	6715	7426	0.861682710507815
GO:0006402	mRNA catabolic process	 17	0.118839522247653	0.899006189270582	11	6	6713	7433	1.3629229800189
GO:0006405	RNA export from nucleus	 48	0.216081229449964	1	26	22	6698	7417	1.14093173706127
GO:0006406	mRNA export from nucleus	 89	0.0395696683377119	0.62746188364086	51	38	6673	7401	1.2070012499248
GO:0006409	tRNA export from nucleus	 32	0.063268776163272	0.772066334068511	20	12	6704	7427	1.31645969660916
GO:0006413	translational initiation	 87	0.397807697302072	1	43	44	6681	7395	1.04106238076678
GO:0006414	translational elongation	 20	0.0888797275608513	0.807895728316903	13	7	6711	7432	1.36911808447353
GO:0006415	translational termination	 10	0.316545776550851	1	6	4	6718	7435	1.26380130874479
GO:0006418	tRNA aminoacylation for protein translation	 41	0.0291653004249913	0.548345648381269	26	15	6698	7424	1.33572496046198
GO:0006446	regulation of translational initiation	 25	0.912607021347774	1	9	16	6715	7423	0.758280785246877
GO:0006449	regulation of translational termination	  5	0.157494903089267	0.919686434773344	4	1	6720	7438	1.68506841165973
GO:0006450	regulation of translational fidelity	 13	0.00687971396051248	0.354502993326374	11	2	6713	7437	1.78228389694779
GO:0006458	de novo	 14	0.0183006792268162	0.495149842313607	11	3	6713	7436	1.65497790430866
GO:0006465	signal peptide processing	 17	0.416253886790052	1	9	8	6715	7431	1.11511880183364
GO:0006471	protein ADP-ribosylation	 17	0.776294265732228	1	7	10	6717	7429	0.867314623648389
GO:0006473	protein acetylation	 11	0.431935112460319	1	6	5	6718	7434	1.14891028067709
GO:0006474	N-terminal protein amino acid acetylation	  8	0.309544448231027	1	5	3	6719	7436	1.31645969660916
GO:0006475	internal protein amino acid acetylation	  7	0.730029012673872	1	3	4	6721	7435	0.902715220531996
GO:0006476	protein deacetylation	 12	0.75380380293781	1	5	7	6719	7432	0.877639797739441
GO:0006479	protein methylation	 40	0.132916295180638	0.919686434773344	23	17	6701	7422	1.21114292088043
GO:0006487	protein N-linked glycosylation	 32	0.321021215389182	1	17	15	6707	7424	1.11899074211779
GO:0006488	dolichol-linked oligosaccharide biosynthetic process	 13	0.822979434145659	1	5	8	6719	7431	0.810129044067176
GO:0006489	dolichyl diphosphate biosynthetic process	  6	0.297654371351411	1	4	2	6720	7437	1.40422367638311
GO:0006491	N-glycan processing	 16	0.0242540767935066	0.495149842313607	12	4	6712	7435	1.57975163593099
GO:0006493	protein O-linked glycosylation	 32	0.321021215389182	1	17	15	6707	7424	1.11899074211779
GO:0006497	protein lipidation	 10	0.316545776550851	1	6	4	6718	7435	1.26380130874479
GO:0006501	C-terminal protein lipidation	 56	0.972170880380853	1	20	36	6704	7403	0.752262683776664
GO:0006506	GPI anchor biosynthetic process	 29	0.015991699163769	0.485810987227761	20	9	6704	7430	1.45264518246528
GO:0006509	membrane protein ectodomain proteolysis	 18	0.00881923479062879	0.410349233027118	14	4	6710	7435	1.63826095578029
GO:0006513	protein monoubiquitination	 30	0.1166008275708	0.893784829666214	18	12	6706	7427	1.26380130874479
GO:0006515	protein quality control for misfolded or incompletely synthesized proteins	  9	0.206720270758876	0.983668097955673	6	3	6718	7436	1.40422367638311
GO:0006516	glycoprotein catabolic process	  9	0.438074670071218	1	5	4	6719	7435	1.17018639698592
GO:0006517	protein deglycosylation	  9	0.0012218840568095	0.172017433558645	9	0	6715	7439	2.10633551457466
GO:0006518	peptide metabolic process	  9	0.438074670071218	1	5	4	6719	7435	1.17018639698592
GO:0006520	cellular amino acid metabolic process	 28	0.467605035218744	1	14	14	6710	7425	1.05316775728733
GO:0006521	regulation of cellular amino acid metabolic process	 44	0.66177296508537	1	20	24	6704	7415	0.957425233897572
GO:0006525	arginine metabolic process	  5	0.960049771736903	1	1	4	6723	7435	0.421267102914932
GO:0006527	arginine catabolic process	  7	0.919244306193629	1	2	5	6722	7434	0.601810147021331
GO:0006531	aspartate metabolic process	  6	0.607836179256654	1	3	3	6721	7436	1.05316775728733
GO:0006536	glutamate metabolic process	 12	0.012434352666713	0.427208830906354	10	2	6714	7437	1.75527959547888
GO:0006541	glutamine metabolic process	 19	0.592680980401227	1	9	10	6715	7429	0.997737875324838
GO:0006544	glycine metabolic process	  7	0.919244306193629	1	2	5	6722	7434	0.601810147021331
GO:0006552	leucine catabolic process	  5	0.0241003244622537	0.495149842313607	5	0	6719	7439	2.10633551457466
GO:0006554	lysine catabolic process	 11	0.0838548499097086	0.807895728316903	8	3	6716	7436	1.53188037423611
GO:0006555	methionine metabolic process	  5	0.452745275304033	1	3	2	6721	7437	1.26380130874479
GO:0006559	L-phenylalanine catabolic process	  9	0.882794860340315	1	3	6	6721	7433	0.702111838191553
GO:0006564	L-serine biosynthetic process	  5	0.77940058892516	1	2	3	6722	7436	0.842534205829863
GO:0006569	tryptophan catabolic process	  7	0.187210848839696	0.949543953868825	5	2	6719	7437	1.50452536755333
GO:0006573	valine metabolic process	  5	0.452745275304033	1	3	2	6721	7437	1.26380130874479
GO:0006584	catecholamine metabolic process	  7	0.919244306193629	1	2	5	6722	7434	0.601810147021331
GO:0006590	thyroid hormone generation	  8	0.580280354503036	1	4	4	6720	7435	1.05316775728733
GO:0006595	polyamine metabolic process	  7	0.730029012673872	1	3	4	6721	7435	0.902715220531996
GO:0006596	polyamine biosynthetic process	 11	0.850917330440019	1	4	7	6720	7432	0.765940187118057
GO:0006600	creatine metabolic process	  9	0.882794860340315	1	3	6	6721	7433	0.702111838191553
GO:0006605	protein targeting	 36	0.0351046370324894	0.599479186247127	23	13	6701	7426	1.34571435653381
GO:0006606	protein import into nucleus	 53	0.115997910195912	0.893784829666214	30	23	6694	7416	1.1922653856083
GO:0006607	NLS-bearing protein import into nucleus	 19	0.127144513269886	0.919686434773344	12	7	6712	7432	1.33031716709978
GO:0006610	ribosomal protein import into nucleus	  7	0.444912401367032	1	4	3	6720	7436	1.20362029404266
GO:0006611	protein export from nucleus	 20	0.325733222000695	1	11	9	6713	7430	1.15848453301606
GO:0006612	protein targeting to membrane	 21	0.134279084429805	0.919686434773344	13	8	6711	7431	1.30392198521288
GO:0006613	cotranslational protein targeting to membrane	  8	0.819878207576373	1	3	5	6721	7434	0.789875817965497
GO:0006614	SRP-dependent cotranslational protein targeting to membrane	 45	0.482822181889214	1	22	23	6702	7416	1.02976402934761
GO:0006616	SRP-dependent cotranslational protein targeting to membrane, translocation	  5	0.0241003244622537	0.495149842313607	5	0	6719	7439	2.10633551457466
GO:0006621	protein retention in ER lumen	  9	0.206720270758876	0.983668097955673	6	3	6718	7436	1.40422367638311
GO:0006622	protein targeting to lysosome	 13	0.643122793005253	1	6	7	6718	7432	0.972154852880611
GO:0006623	protein targeting to vacuole	  5	0.452745275304033	1	3	2	6721	7437	1.26380130874479
GO:0006625	protein targeting to peroxisome	  8	0.309544448231027	1	5	3	6719	7436	1.31645969660916
GO:0006626	protein targeting to mitochondrion	 28	0.00891162838250947	0.410349233027118	20	8	6704	7431	1.50452536755333
GO:0006627	protein processing involved in protein targeting to mitochondrion	  5	0.157494903089267	0.919686434773344	4	1	6720	7438	1.68506841165973
GO:0006633	fatty acid biosynthetic process	 55	0.0226886845579338	0.495149842313607	34	21	6690	7418	1.3020983181007
GO:0006635	fatty acid beta-oxidation	 41	0.170912593352478	0.949543953868825	23	18	6701	7421	1.18160284963944
GO:0006636	unsaturated fatty acid biosynthetic process	  9	0.206720270758876	0.983668097955673	6	3	6718	7436	1.40422367638311
GO:0006637	acyl-CoA metabolic process	 21	0.00715840520408133	0.359289694243108	16	5	6708	7434	1.60482705872355
GO:0006641	triglyceride metabolic process	 24	0.324965824259735	1	13	11	6711	7428	1.14093173706127
GO:0006644	phospholipid metabolic process	 54	0.620920803681269	1	25	29	6699	7410	0.975155330821601
GO:0006646	phosphatidylethanolamine biosynthetic process	 13	0.426320358160906	1	7	6	6717	7433	1.13418066169405
GO:0006650	glycerophospholipid metabolic process	  8	0.113810689204897	0.88413902838582	6	2	6718	7437	1.57975163593099
GO:0006654	phosphatidic acid biosynthetic process	 33	0.260933554151229	1	18	15	6706	7424	1.14891028067709
GO:0006655	phosphatidylglycerol biosynthetic process	  5	0.157494903089267	0.919686434773344	4	1	6720	7438	1.68506841165973
GO:0006656	phosphatidylcholine biosynthetic process	 27	0.547450272919978	1	13	14	6711	7425	1.01416154405446
GO:0006657	CDP-choline pathway	  6	0.607836179256654	1	3	3	6721	7436	1.05316775728733
GO:0006658	phosphatidylserine metabolic process	  5	0.77940058892516	1	2	3	6722	7436	0.842534205829863
GO:0006661	phosphatidylinositol biosynthetic process	 70	0.292913573792695	1	36	34	6688	7405	1.0832582646384
GO:0006664	glycolipid metabolic process	  5	0.77940058892516	1	2	3	6722	7436	0.842534205829863
GO:0006665	sphingolipid metabolic process	 33	0.384864355454507	1	17	16	6707	7423	1.08508193175058
GO:0006672	ceramide metabolic process	 17	0.416253886790052	1	9	8	6715	7431	1.11511880183364
GO:0006682	galactosylceramide biosynthetic process	  5	0.452745275304033	1	3	2	6721	7437	1.26380130874479
GO:0006686	sphingomyelin biosynthetic process	  5	0.157494903089267	0.919686434773344	4	1	6720	7438	1.68506841165973
GO:0006687	glycosphingolipid metabolic process	 42	0.671020490139043	1	19	23	6705	7416	0.952866066117107
GO:0006688	glycosphingolipid biosynthetic process	  8	0.309544448231027	1	5	3	6719	7436	1.31645969660916
GO:0006689	ganglioside catabolic process	  6	0.865182793759413	1	2	4	6722	7435	0.702111838191553
GO:0006690	icosanoid metabolic process	  7	1	1	0	7	6724	7432	0
GO:0006691	leukotriene metabolic process	 14	0.998346203775137	1	2	12	6722	7427	0.300905073510665
GO:0006693	prostaglandin metabolic process	 18	0.974269347793119	1	5	13	6719	7426	0.585093198492961
GO:0006694	steroid biosynthetic process	 50	0.41366085413375	1	25	25	6699	7414	1.05316775728733
GO:0006695	cholesterol biosynthetic process	 37	0.0973421652165049	0.843214701401555	22	15	6702	7424	1.25241571136872
GO:0006699	bile acid biosynthetic process	 23	0.567952371389245	1	11	12	6713	7427	1.00737785479658
GO:0006700	C21-steroid hormone biosynthetic process	 10	0.78367246101976	1	4	6	6720	7433	0.842534205829863
GO:0006702	androgen biosynthetic process	  9	0.69404490204849	1	4	5	6720	7434	0.936149117588737
GO:0006703	estrogen biosynthetic process	  8	0.952366339066048	1	2	6	6722	7433	0.526583878643665
GO:0006706	steroid catabolic process	  5	0.77940058892516	1	2	3	6722	7436	0.842534205829863
GO:0006707	cholesterol catabolic process	  7	0.919244306193629	1	2	5	6722	7434	0.601810147021331
GO:0006725	cellular aromatic compound metabolic process	  5	0.77940058892516	1	2	3	6722	7436	0.842534205829863
GO:0006729	tetrahydrobiopterin biosynthetic process	  6	0.297654371351411	1	4	2	6720	7437	1.40422367638311
GO:0006730	one-carbon metabolic process	 23	0.92480513956827	1	8	15	6716	7424	0.732638439852055
GO:0006734	NADH metabolic process	  9	0.438074670071218	1	5	4	6719	7435	1.17018639698592
GO:0006739	NADP metabolic process	  8	0.819878207576373	1	3	5	6721	7434	0.789875817965497
GO:0006744	ubiquinone biosynthetic process	 14	0.323388997222084	1	8	6	6716	7433	1.20362029404266
GO:0006749	glutathione metabolic process	 31	0.877080826063238	1	12	19	6712	7420	0.815355683061158
GO:0006750	glutathione biosynthetic process	 14	0.323388997222084	1	8	6	6716	7433	1.20362029404266
GO:0006751	glutathione catabolic process	  5	0.960049771736903	1	1	4	6723	7435	0.421267102914932
GO:0006754	ATP biosynthetic process	 25	0.0114527104337207	0.427208830906354	18	7	6706	7432	1.51656157049375
GO:0006766	vitamin metabolic process	  5	0.0241003244622537	0.495149842313607	5	0	6719	7439	2.10633551457466
GO:0006768	biotin metabolic process	 11	0.220387996626296	1	7	4	6717	7435	1.3403953274566
GO:0006771	riboflavin metabolic process	  7	0.444912401367032	1	4	3	6720	7436	1.20362029404266
GO:0006776	vitamin A metabolic process	  7	0.98898631085553	1	1	6	6723	7433	0.300905073510665
GO:0006779	porphyrin-containing compound biosynthetic process	  9	0.0134026999423743	0.442059337527911	8	1	6716	7438	1.87229823517747
GO:0006782	protoporphyrinogen IX biosynthetic process	  9	0.067355898427907	0.780679208284898	7	2	6717	7437	1.63826095578029
GO:0006783	heme biosynthetic process	 21	0.0609416617953418	0.764685373658072	14	7	6710	7432	1.40422367638311
GO:0006790	sulfur compound metabolic process	 13	0.982330979346752	1	3	10	6721	7429	0.486077426440306
GO:0006796	phosphate-containing compound metabolic process	 18	0.0811513291101853	0.807895728316903	12	6	6712	7433	1.40422367638311
GO:0006801	superoxide metabolic process	 17	0.960992303738273	1	5	12	6719	7427	0.619510445463135
GO:0006805	xenobiotic metabolic process	 66	0.974307531842255	1	24	42	6700	7397	0.765940187118057
GO:0006807	nitrogen compound metabolic process	 18	0.687525801418504	1	8	10	6716	7429	0.936149117588737
GO:0006809	nitric oxide biosynthetic process	 13	0.933471720877997	1	4	9	6720	7430	0.648103235253741
GO:0006812	cation transport	 65	0.63162480378596	1	30	35	6694	7404	0.972154852880611
GO:0006814	sodium ion transport	 98	0.923539914959829	1	40	58	6684	7381	0.859728781459044
GO:0006817	phosphate ion transport	  7	0.187210848839696	0.949543953868825	5	2	6719	7437	1.50452536755333
GO:0006820	anion transport	 18	0.832783288477324	1	7	11	6717	7428	0.819130477890145
GO:0006821	chloride transport	 69	0.618641578230414	1	32	37	6692	7402	0.976851253136073
GO:0006825	copper ion transport	 11	0.431935112460319	1	6	5	6718	7434	1.14891028067709
GO:0006826	iron ion transport	 12	0.899474094191123	1	4	8	6720	7431	0.702111838191553
GO:0006828	manganese ion transport	  7	0.730029012673872	1	3	4	6721	7435	0.902715220531996
GO:0006829	zinc II ion transport	 22	0.325498770721016	1	12	10	6712	7429	1.14891028067709
GO:0006833	water transport	 11	0.999163575349816	1	1	10	6723	7429	0.191485046779514
GO:0006836	neurotransmitter transport	 38	0.130268659230789	0.919686434773344	22	16	6702	7423	1.2194574031748
GO:0006839	mitochondrial transport	 43	0.261542728893093	1	23	20	6701	7419	1.12664457756319
GO:0006851	mitochondrial calcium ion transmembrane transport	 20	0.184541691833438	0.949543953868825	12	8	6712	7431	1.26380130874479
GO:0006853	carnitine shuttle	 10	0.925275888620553	1	3	7	6721	7432	0.631900654372397
GO:0006855	drug transmembrane transport	 17	0.776294265732228	1	7	10	6717	7429	0.867314623648389
GO:0006865	amino acid transport	 44	0.764401418389023	1	19	25	6705	7414	0.909553972202693
GO:0006868	glutamine transport	  5	0.452745275304033	1	3	2	6721	7437	1.26380130874479
GO:0006874	cellular calcium ion homeostasis	 81	0.865729705383824	1	34	47	6690	7392	0.884140833278252
GO:0006875	cellular metal ion homeostasis	  5	0.77940058892516	1	2	3	6722	7436	0.842534205829863
GO:0006878	cellular copper ion homeostasis	 11	0.431935112460319	1	6	5	6718	7434	1.14891028067709
GO:0006879	cellular iron ion homeostasis	 54	0.217071591623781	1	29	25	6695	7414	1.13118018375306
GO:0006882	cellular zinc ion homeostasis	 14	0.323388997222084	1	8	6	6716	7433	1.20362029404266
GO:0006883	cellular sodium ion homeostasis	 12	0.5430601307694	1	6	6	6718	7433	1.05316775728733
GO:0006884	cell volume homeostasis	 12	0.75380380293781	1	5	7	6719	7432	0.877639797739441
GO:0006885	regulation of pH	 18	0.687525801418504	1	8	10	6716	7429	0.936149117588737
GO:0006887	exocytosis	 97	0.00550501335486248	0.334473021939644	59	38	6665	7401	1.28117314804026
GO:0006890	retrograde vesicle-mediated transport, Golgi to ER	 62	0.0984060311289622	0.849027820144051	35	27	6689	7412	1.18906037113086
GO:0006891	intra-Golgi vesicle-mediated transport	 23	0.0272148481462567	0.518429384489088	16	7	6708	7432	1.46527687970411
GO:0006892	post-Golgi vesicle-mediated transport	 19	0.127144513269886	0.919686434773344	12	7	6712	7432	1.33031716709978
GO:0006893	Golgi to plasma membrane transport	 16	0.0724287706601472	0.807895728316903	11	5	6713	7434	1.44810566627008
GO:0006895	Golgi to endosome transport	 17	0.118839522247653	0.899006189270582	11	6	6713	7433	1.3629229800189
GO:0006896	Golgi to vacuole transport	  5	0.157494903089267	0.919686434773344	4	1	6720	7438	1.68506841165973
GO:0006900	vesicle budding from membrane	  5	0.452745275304033	1	3	2	6721	7437	1.26380130874479
GO:0006903	vesicle targeting	  9	0.438074670071218	1	5	4	6719	7435	1.17018639698592
GO:0006904	vesicle docking involved in exocytosis	 28	0.0552578549226092	0.708774085807334	18	10	6706	7429	1.35407283079799
GO:0006906	vesicle fusion	 44	0.0226130925630875	0.495149842313607	28	16	6696	7423	1.3403953274566
GO:0006909	phagocytosis	 55	0.964068791712138	1	20	35	6704	7404	0.765940187118057
GO:0006910	phagocytosis, recognition	 15	0.99361188809009	1	3	12	6721	7427	0.421267102914932
GO:0006911	phagocytosis, engulfment	 23	0.989780830505069	1	6	17	6718	7422	0.549478829889041
GO:0006913	nucleocytoplasmic transport	 24	0.324965824259735	1	13	11	6711	7428	1.14093173706127
GO:0006919	activation of cysteine-type endopeptidase activity involved in apoptotic process	 73	0.835656749456127	1	31	42	6693	7397	0.894471245915266
GO:0006928	movement of cell or subcellular component	 72	0.104231221417433	0.880853016136785	40	32	6684	7407	1.17018639698592
GO:0006930	substrate-dependent cell migration, cell extension	  7	0.919244306193629	1	2	5	6722	7434	0.601810147021331
GO:0006936	muscle contraction	 84	0.831362112473069	1	36	48	6688	7391	0.902715220531996
GO:0006937	regulation of muscle contraction	 18	0.974269347793119	1	5	13	6719	7426	0.585093198492961
GO:0006939	smooth muscle contraction	 17	0.895242422289557	1	6	11	6718	7428	0.743412534555762
GO:0006940	regulation of smooth muscle contraction	 15	0.999074560034374	1	2	13	6722	7426	0.280844735276621
GO:0006941	striated muscle contraction	 18	0.926471989195673	1	6	12	6718	7427	0.702111838191553
GO:0006942	regulation of striated muscle contraction	  7	0.730029012673872	1	3	4	6721	7435	0.902715220531996
GO:0006950	response to stress	 51	0.114258683446597	0.885236403830546	29	22	6695	7417	1.19772019456206
GO:0006952	defense response	 73	0.999862525217411	1	20	53	6704	7386	0.577078223171139
GO:0006953	acute-phase response	 25	0.985872368040077	1	7	18	6717	7421	0.589773944080904
GO:0006956	complement activation	 31	0.999999939379197	1	2	29	6722	7410	0.135892613843526
GO:0006957	complement activation, alternative pathway	 10	0.983985908365184	1	2	8	6722	7431	0.421267102914932
GO:0006958	complement activation, classical pathway	 36	0.999977109107058	1	6	30	6718	7409	0.351055919095776
GO:0006959	humoral immune response	 34	0.998898123344138	1	8	26	6716	7413	0.495608356370508
GO:0006968	cellular defense response	 36	0.999977109107058	1	6	30	6718	7409	0.351055919095776
GO:0006970	response to osmotic stress	 17	0.776294265732228	1	7	10	6717	7429	0.867314623648389
GO:0006972	hyperosmotic response	  8	0.580280354503036	1	4	4	6720	7435	1.05316775728733
GO:0006975	DNA damage induced protein phosphorylation	  7	0.919244306193629	1	2	5	6722	7434	0.601810147021331
GO:0006977	DNA damage response, signal transduction by p53 class mediator resulting in cell cycle arrest	 56	0.86356160275384	1	23	33	6701	7406	0.865102086343163
GO:0006978	DNA damage response, signal transduction by p53 class mediator resulting in transcription of p21 class mediator	 14	0.956679005412873	1	4	10	6720	7429	0.601810147021331
GO:0006983	ER overload response	 10	0.559603563591584	1	5	5	6719	7434	1.05316775728733
GO:0006986	response to unfolded protein	 51	0.683914232498544	1	23	28	6701	7411	0.949916016376807
GO:0006987	activation of signaling protein activity involved in unfolded protein response	  8	1	1	0	8	6724	7431	0
GO:0006995	cellular response to nitrogen starvation	  9	0.206720270758876	0.983668097955673	6	3	6718	7436	1.40422367638311
GO:0006996	organelle organization	 13	0.230372725000093	1	8	5	6716	7434	1.29620647050748
GO:0006997	nucleus organization	 19	0.756503853067433	1	8	11	6716	7428	0.886878111399856
GO:0006998	nuclear envelope organization	 17	0.416253886790052	1	9	8	6715	7431	1.11511880183364
GO:0006999	nuclear pore organization	  6	0.297654371351411	1	4	2	6720	7437	1.40422367638311
GO:0007004	telomere maintenance via telomerase	 17	0.607264962167558	1	8	9	6716	7430	0.991216712741015
GO:0007005	mitochondrion organization	 75	0.00284713425586595	0.244538441062453	48	27	6676	7412	1.34805472932778
GO:0007009	plasma membrane organization	 14	0.875453509540804	1	5	9	6719	7430	0.752262683776664
GO:0007015	actin filament organization	 78	0.368680947926712	1	39	39	6685	7400	1.05316775728733
GO:0007016	cytoskeletal anchoring at plasma membrane	 11	0.665993939534306	1	5	6	6719	7433	0.957425233897572
GO:0007017	microtubule-based process	 31	0.0422584590581389	0.646585116783694	20	11	6704	7428	1.35892613843526
GO:0007018	microtubule-based movement	 66	0.038294499623959	0.625040317669623	39	27	6685	7412	1.24465280406684
GO:0007019	microtubule depolymerization	  5	0.452745275304033	1	3	2	6721	7437	1.26380130874479
GO:0007020	microtubule nucleation	 17	0.000585323700598568	0.129194878970953	15	2	6709	7437	1.8585313363894
GO:0007021	tubulin complex assembly	  6	0.297654371351411	1	4	2	6720	7437	1.40422367638311
GO:0007026	negative regulation of microtubule depolymerization	 15	0.0393086686268318	0.625040317669623	11	4	6713	7435	1.54464604402142
GO:0007029	endoplasmic reticulum organization	 22	0.655120963592744	1	10	12	6714	7427	0.957425233897572
GO:0007030	Golgi organization	 69	0.00462952778306368	0.310716678649344	44	25	6680	7414	1.3431704730621
GO:0007031	peroxisome organization	 21	0.134279084429805	0.919686434773344	13	8	6711	7431	1.30392198521288
GO:0007032	endosome organization	 33	0.0904506730537659	0.820882523374743	20	13	6704	7426	1.2765669785301
GO:0007034	vacuolar transport	 13	0.230372725000093	1	8	5	6716	7434	1.29620647050748
GO:0007035	vacuolar acidification	 13	0.0309498150207146	0.552600112408603	10	3	6714	7436	1.62025808813435
GO:0007040	lysosome organization	 34	0.0324276974379125	0.568913889397054	22	12	6702	7427	1.3629229800189
GO:0007041	lysosomal transport	 12	0.75380380293781	1	5	7	6719	7432	0.877639797739441
GO:0007042	lysosomal lumen acidification	  5	0.77940058892516	1	2	3	6722	7436	0.842534205829863
GO:0007043	cell-cell junction assembly	 14	0.323388997222084	1	8	6	6716	7433	1.20362029404266
GO:0007044	cell-substrate junction assembly	  6	0.607836179256654	1	3	3	6721	7436	1.05316775728733
GO:0007051	spindle organization	 15	0.421118865258844	1	8	7	6716	7432	1.12337894110648
GO:0007052	mitotic spindle organization	 26	0.324205758709722	1	14	12	6710	7427	1.13418066169405
GO:0007059	chromosome segregation	 68	0.574774930522088	1	32	36	6692	7403	0.991216712741015
GO:0007062	sister chromatid cohesion	 85	0.732494357612128	1	38	47	6686	7392	0.941655877103965
GO:0007064	mitotic sister chromatid cohesion	 13	0.643122793005253	1	6	7	6718	7432	0.972154852880611
GO:0007076	mitotic chromosome condensation	 13	0.643122793005253	1	6	7	6718	7432	0.972154852880611
GO:0007077	mitotic nuclear envelope disassembly	 43	0.488572000794972	1	21	22	6703	7417	1.02867548386204
GO:0007080	mitotic metaphase plate congression	 26	0.764822468344396	1	11	15	6713	7424	0.891141948473894
GO:0007084	mitotic nuclear envelope reassembly	 10	0.559603563591584	1	5	5	6719	7434	1.05316775728733
GO:0007088	regulation of mitotic nuclear division	 17	0.960992303738273	1	5	12	6719	7427	0.619510445463135
GO:0007093	mitotic cell cycle checkpoint	 23	0.40318807961294	1	12	11	6712	7428	1.09895765977808
GO:0007094	mitotic spindle assembly checkpoint	 13	0.230372725000093	1	8	5	6716	7434	1.29620647050748
GO:0007095	mitotic G2 DNA damage checkpoint	 13	0.230372725000093	1	8	5	6716	7434	1.29620647050748
GO:0007096	regulation of exit from mitosis	 10	0.559603563591584	1	5	5	6719	7434	1.05316775728733
GO:0007097	nuclear migration	 10	0.133503266897558	0.919686434773344	7	3	6717	7436	1.47443486020226
GO:0007098	centrosome cycle	 36	0.210339168864363	0.998026267702333	20	16	6704	7423	1.17018639698592
GO:0007099	centriole replication	 13	0.822979434145659	1	5	8	6719	7431	0.810129044067176
GO:0007100	mitotic centrosome separation	  5	0.452745275304033	1	3	2	6721	7437	1.26380130874479
GO:0007129	synapsis	 14	0.728526098434397	1	6	8	6718	7431	0.902715220531996
GO:0007130	synaptonemal complex assembly	 11	0.850917330440019	1	4	7	6720	7432	0.765940187118057
GO:0007131	reciprocal meiotic recombination	 19	0.127144513269886	0.919686434773344	12	7	6712	7432	1.33031716709978
GO:0007140	male meiotic nuclear division	 15	0.421118865258844	1	8	7	6716	7432	1.12337894110648
GO:0007141	male meiosis I	  9	0.69404490204849	1	4	5	6720	7434	0.936149117588737
GO:0007143	female meiotic nuclear division	  6	0.0874151689581943	0.807895728316903	5	1	6719	7438	1.75527959547888
GO:0007154	cell communication	 39	0.947441359711541	1	14	25	6710	7414	0.756120441129364
GO:0007157	heterophilic cell-cell adhesion via plasma membrane cell adhesion molecules	 41	0.970273270415566	1	14	27	6710	7412	0.719236517171834
GO:0007158	neuron cell-cell adhesion	 15	0.237875362689918	1	9	6	6715	7433	1.26380130874479
GO:0007159	leukocyte cell-cell adhesion	 22	0.999058190015592	1	4	18	6720	7421	0.382970093559029
GO:0007160	cell-matrix adhesion	 75	0.600461171617625	1	35	40	6689	7399	0.982956573468174
GO:0007162	negative regulation of cell adhesion	 31	0.0422584590581389	0.646585116783694	20	11	6704	7428	1.35892613843526
GO:0007163	establishment or maintenance of cell polarity	 28	0.323270654016595	1	15	13	6709	7426	1.128394025665
GO:0007167	enzyme linked receptor protein signaling pathway	  7	0.444912401367032	1	4	3	6720	7436	1.20362029404266
GO:0007168	receptor guanylyl cyclase signaling pathway	  7	1	1	0	7	6724	7432	0
GO:0007169	transmembrane receptor protein tyrosine kinase signaling pathway	 99	0.999835351212875	1	30	69	6694	7370	0.638283489265048
GO:0007171	activation of transmembrane receptor protein tyrosine kinase activity	  9	0.438074670071218	1	5	4	6719	7435	1.17018639698592
GO:0007172	signal complex assembly	  8	0.309544448231027	1	5	3	6719	7436	1.31645969660916
GO:0007173	epidermal growth factor receptor signaling pathway	 53	0.355623729022647	1	27	26	6697	7413	1.07303884704747
GO:0007175	negative regulation of epidermal growth factor-activated receptor activity	 13	0.933471720877997	1	4	9	6720	7430	0.648103235253741
GO:0007178	transmembrane receptor protein serine/threonine kinase signaling pathway	 18	0.325568860476231	1	10	8	6714	7431	1.17018639698592
GO:0007179	transforming growth factor beta receptor signaling pathway	 84	0.618069186125637	1	39	45	6685	7394	0.977941488909663
GO:0007182	common-partner SMAD protein phosphorylation	  6	0.979023167332401	1	1	5	6723	7434	0.351055919095776
GO:0007183	SMAD protein complex assembly	  8	0.113810689204897	0.88413902838582	6	2	6718	7437	1.57975163593099
GO:0007184	SMAD protein import into nucleus	  8	0.819878207576373	1	3	5	6721	7434	0.789875817965497
GO:0007185	transmembrane receptor protein tyrosine phosphatase signaling pathway	  6	0.297654371351411	1	4	2	6720	7437	1.40422367638311
GO:0007187	G-protein coupled receptor signaling pathway, coupled to cyclic nucleotide second messenger	 34	0.975119969289908	1	11	23	6713	7416	0.681461490009448
GO:0007188	adenylate cyclase-modulating G-protein coupled receptor signaling pathway	 34	0.999713020664687	1	7	27	6717	7412	0.433657311824194
GO:0007189	adenylate cyclase-activating G-protein coupled receptor signaling pathway	 34	0.999713020664687	1	7	27	6717	7412	0.433657311824194
GO:0007190	activation of adenylate cyclase activity	 29	0.945287796141565	1	10	19	6714	7420	0.726322591232641
GO:0007191	adenylate cyclase-activating dopamine receptor signaling pathway	  8	0.580280354503036	1	4	4	6720	7435	1.05316775728733
GO:0007193	adenylate cyclase-inhibiting G-protein coupled receptor signaling pathway	 39	0.947441359711541	1	14	25	6710	7414	0.756120441129364
GO:0007194	negative regulation of adenylate cyclase activity	 18	0.687525801418504	1	8	10	6716	7429	0.936149117588737
GO:0007196	adenylate cyclase-inhibiting G-protein coupled glutamate receptor signaling pathway	  8	0.819878207576373	1	3	5	6721	7434	0.789875817965497
GO:0007200	phospholipase C-activating G-protein coupled receptor signaling pathway	 47	0.999816108173124	1	11	36	6713	7403	0.492972141708963
GO:0007202	activation of phospholipase C activity	 21	0.998435934134292	1	4	17	6720	7422	0.401206764680887
GO:0007205	protein kinase C-activating G-protein coupled receptor signaling pathway	 23	0.254283570903419	1	13	10	6711	7429	1.19053746475959
GO:0007207	phospholipase C-activating G-protein coupled acetylcholine receptor signaling pathway	  5	0.960049771736903	1	1	4	6723	7435	0.421267102914932
GO:0007212	dopamine receptor signaling pathway	 17	0.243621618961318	1	10	7	6714	7432	1.23902089092627
GO:0007213	G-protein coupled acetylcholine receptor signaling pathway	 14	0.728526098434397	1	6	8	6718	7431	0.902715220531996
GO:0007214	gamma-aminobutyric acid signaling pathway	 20	0.813860390499775	1	8	12	6716	7427	0.842534205829863
GO:0007215	glutamate receptor signaling pathway	 14	0.160610520833599	0.919686434773344	9	5	6715	7434	1.35407283079799
GO:0007216	G-protein coupled glutamate receptor signaling pathway	  9	0.69404490204849	1	4	5	6720	7434	0.936149117588737
GO:0007217	tachykinin receptor signaling pathway	  7	0.730029012673872	1	3	4	6721	7435	0.902715220531996
GO:0007218	neuropeptide signaling pathway	 62	0.962246662335837	1	23	39	6701	7400	0.781382529600276
GO:0007219	Notch signaling pathway	100	0.787607975491915	1	44	56	6680	7383	0.926787626412849
GO:0007220	Notch receptor processing	 15	0.109100626262719	0.88413902838582	10	5	6714	7434	1.40422367638311
GO:0007221	positive regulation of transcription of Notch receptor target	  7	0.444912401367032	1	4	3	6720	7436	1.20362029404266
GO:0007223	Wnt signaling pathway, calcium modulating pathway	 34	0.0668797555442451	0.780679208284898	21	13	6703	7426	1.30097193547258
GO:0007224	smoothened signaling pathway	 63	0.728231280398887	1	28	35	6696	7404	0.936149117588737
GO:0007229	integrin-mediated signaling pathway	 71	0.777287718979197	1	31	40	6693	7399	0.919667619039639
GO:0007249	I-kappaB kinase/NF-kappaB signaling	 55	0.936280072035094	1	21	34	6703	7405	0.80423719647396
GO:0007250	activation of NF-kappaB-inducing kinase activity	 16	0.853260719975205	1	6	10	6718	7429	0.789875817965497
GO:0007252	I-kappaB phosphorylation	 10	0.559603563591584	1	5	5	6719	7434	1.05316775728733
GO:0007253	cytoplasmic sequestering of NF-kappaB	  5	0.157494903089267	0.919686434773344	4	1	6720	7438	1.68506841165973
GO:0007254	JNK cascade	 47	0.477316041725348	1	23	24	6701	7415	1.03075993266419
GO:0007256	activation of JNKK activity	  6	0.607836179256654	1	3	3	6721	7436	1.05316775728733
GO:0007257	activation of JUN kinase activity	 32	0.953156110269778	1	11	21	6713	7418	0.724052833135039
GO:0007259	JAK-STAT cascade	 29	0.680253022221135	1	13	16	6711	7423	0.944219368602433
GO:0007260	tyrosine phosphorylation of STAT protein	  7	0.187210848839696	0.949543953868825	5	2	6719	7437	1.50452536755333
GO:0007263	nitric oxide mediated signal transduction	 15	0.798298186583662	1	6	9	6718	7430	0.842534205829863
GO:0007265	Ras protein signal transduction	 64	0.835065507502681	1	27	37	6697	7402	0.888610295211184
GO:0007266	Rho protein signal transduction	 53	0.571408483940383	1	25	28	6699	7411	0.993554488006914
GO:0007269	neurotransmitter secretion	 48	0.0258381186468233	0.500461814863973	30	18	6694	7421	1.31645969660916
GO:0007270	neuron-neuron synaptic transmission	  8	0.025392299605826	0.495149842313607	7	1	6717	7438	1.84304357525283
GO:0007271	synaptic transmission, cholinergic	 19	0.999912396476281	1	2	17	6722	7422	0.221719527849964
GO:0007274	neuromuscular synaptic transmission	 21	0.976677947067874	1	6	15	6718	7424	0.601810147021331
GO:0007276	gamete generation	 17	0.607264962167558	1	8	9	6716	7430	0.991216712741015
GO:0007281	germ cell development	 23	0.567952371389245	1	11	12	6713	7427	1.00737785479658
GO:0007286	spermatid development	 61	0.345681874632939	1	31	30	6693	7409	1.07043280248876
GO:0007288	sperm axoneme assembly	  8	0.819878207576373	1	3	5	6721	7434	0.789875817965497
GO:0007289	spermatid nucleus differentiation	  8	0.819878207576373	1	3	5	6721	7434	0.789875817965497
GO:0007292	female gamete generation	 11	0.220387996626296	1	7	4	6717	7435	1.3403953274566
GO:0007338	single fertilization	 42	0.774336043615827	1	18	24	6706	7415	0.902715220531996
GO:0007339	binding of sperm to zona pellucida	 20	0.497606676879603	1	10	10	6714	7429	1.05316775728733
GO:0007340	acrosome reaction	 12	0.75380380293781	1	5	7	6719	7432	0.877639797739441
GO:0007342	fusion of sperm to egg plasma membrane involved in single fertilization	  6	0.865182793759413	1	2	4	6722	7435	0.702111838191553
GO:0007346	regulation of mitotic cell cycle	 71	0.334246611114102	1	36	35	6688	7404	1.06800110598152
GO:0007368	determination of left/right symmetry	 62	0.772368819085306	1	27	35	6697	7404	0.917275143443803
GO:0007369	gastrulation	 30	0.1166008275708	0.893784829666214	18	12	6706	7427	1.26380130874479
GO:0007389	pattern specification process	 45	0.998720746660877	1	12	33	6712	7406	0.561689470553242
GO:0007398	ectoderm development	 12	0.899474094191123	1	4	8	6720	7431	0.702111838191553
GO:0007405	neuroblast proliferation	 18	0.506938913103874	1	9	9	6715	7430	1.05316775728733
GO:0007409	axonogenesis	 89	0.0244709855106715	0.495149842313607	52	37	6672	7402	1.2306679410998
GO:0007413	axonal fasciculation	 16	0.324860333233664	1	9	7	6715	7432	1.18481372694825
GO:0007416	synapse assembly	 51	0.260009903527587	1	27	24	6697	7415	1.11511880183364
GO:0007422	peripheral nervous system development	 23	0.254283570903419	1	13	10	6711	7429	1.19053746475959
GO:0007435	salivary gland morphogenesis	  8	0.309544448231027	1	5	3	6719	7436	1.31645969660916
GO:0007492	endoderm development	 25	0.961742375998708	1	8	17	6716	7422	0.67402736466389
GO:0007494	midgut development	  7	0.919244306193629	1	2	5	6722	7434	0.601810147021331
GO:0007498	mesoderm development	 34	0.996406066094079	1	9	25	6715	7414	0.557559400916821
GO:0007512	adult heart development	  7	0.919244306193629	1	2	5	6722	7434	0.601810147021331
GO:0007517	muscle organ development	 84	0.947687459868845	1	33	51	6691	7388	0.82748895215433
GO:0007519	skeletal muscle tissue development	 47	0.956514105234826	1	17	30	6707	7409	0.761866037186578
GO:0007520	myoblast fusion	 16	0.94165410331218	1	5	11	6719	7428	0.658229848304581
GO:0007528	neuromuscular junction development	 30	0.0267851253080875	0.513633698598941	20	10	6704	7429	1.40422367638311
GO:0007530	sex determination	  5	0.77940058892516	1	2	3	6722	7436	0.842534205829863
GO:0007548	sex differentiation	 15	0.623867966210499	1	7	8	6717	7431	0.982956573468174
GO:0007565	female pregnancy	 74	0.999750565755741	1	21	53	6703	7386	0.59774386224416
GO:0007566	embryo implantation	 34	0.989884574190229	1	10	24	6714	7415	0.619510445463135
GO:0007567	parturition	  6	0.297654371351411	1	4	2	6720	7437	1.40422367638311
GO:0007569	cell aging	 25	0.399232431223553	1	13	12	6711	7427	1.09529446757882
GO:0007584	response to nutrient	 68	0.478204643224675	1	33	35	6691	7404	1.02219223501417
GO:0007585	respiratory gaseous exchange	 29	0.000454475224297027	0.129194878970953	23	6	6701	7433	1.67054195983507
GO:0007586	digestion	 33	0.994679788825413	1	9	24	6715	7415	0.574455140338543
GO:0007588	excretion	 30	0.999912810999945	1	5	25	6719	7414	0.351055919095776
GO:0007589	body fluid secretion	  8	1	1	0	8	6724	7431	0
GO:0007595	lactation	 36	0.995173518285586	1	10	26	6714	7413	0.585093198492961
GO:0007597	blood coagulation, intrinsic pathway	 12	0.75380380293781	1	5	7	6719	7432	0.877639797739441
GO:0007599	hemostasis	 40	0.99208079342912	1	12	28	6712	7411	0.631900654372397
GO:0007600	sensory perception	 10	0.78367246101976	1	4	6	6720	7433	0.842534205829863
GO:0007602	phototransduction	 19	0.995773796287996	1	4	15	6720	7424	0.443439055699928
GO:0007603	phototransduction, visible light	  5	0.452745275304033	1	3	2	6721	7437	1.26380130874479
GO:0007606	sensory perception of chemical stimulus	  5	0.960049771736903	1	1	4	6723	7435	0.421267102914932
GO:0007608	sensory perception of smell	 59	0.997347788253553	1	18	41	6706	7398	0.64261083495498
GO:0007610	behavior	  8	0.580280354503036	1	4	4	6720	7435	1.05316775728733
GO:0007611	learning or memory	 43	0.172656161739525	0.949543953868825	24	19	6700	7420	1.17562912441376
GO:0007612	learning	 59	0.348094871604032	1	30	29	6694	7410	1.0710180582583
GO:0007613	memory	 59	0.180956013344525	0.949543953868825	32	27	6692	7412	1.14241926214219
GO:0007614	short-term memory	  7	0.98898631085553	1	1	6	6723	7433	0.300905073510665
GO:0007616	long-term memory	 30	0.915575929257217	1	11	19	6713	7420	0.772323022010708
GO:0007617	mating behavior	  7	0.730029012673872	1	3	4	6721	7435	0.902715220531996
GO:0007623	circadian rhythm	 67	0.903957332011887	1	27	40	6697	7399	0.848821774530086
GO:0007625	grooming behavior	  9	0.972243904416257	1	2	7	6722	7432	0.468074558794368
GO:0007626	locomotory behavior	 73	0.513946435802694	1	35	38	6689	7401	1.00988689054949
GO:0007628	adult walking behavior	 27	0.395437844617669	1	14	13	6710	7426	1.09217397052019
GO:0007631	feeding behavior	 27	0.900547220633958	1	10	17	6714	7422	0.780124264657281
GO:0008009	chemokine activity	 27	0.999931283542365	1	4	23	6720	7416	0.312049705862912
GO:0008013	beta-catenin binding	 79	0.751025705768999	1	35	44	6689	7395	0.933186620381178
GO:0008015	blood circulation	 35	0.854689987251871	1	14	21	6710	7418	0.842534205829863
GO:0008016	regulation of heart contraction	 30	0.960143729583739	1	10	20	6714	7419	0.702111838191553
GO:0008020	G-protein coupled photoreceptor activity	  5	0.452745275304033	1	3	2	6721	7437	1.26380130874479
GO:0008021	synaptic vesicle	 96	1.93058637808766e-05	0.0222866891486439	66	30	6658	7409	1.44810566627008
GO:0008023	transcription elongation factor complex	 20	0.0888797275608513	0.807895728316903	13	7	6711	7432	1.36911808447353
GO:0008024	cyclin/CDK positive transcription elongation factor complex	  8	0.309544448231027	1	5	3	6719	7436	1.31645969660916
GO:0008026	ATP-dependent helicase activity	 10	0.925275888620553	1	3	7	6721	7432	0.631900654372397
GO:0008028	monocarboxylic acid transmembrane transporter activity	 13	0.426320358160906	1	7	6	6717	7433	1.13418066169405
GO:0008033	tRNA processing	 82	0.0286612948321554	0.54418747951053	48	34	6676	7405	1.23297688658029
GO:0008035	high-density lipoprotein particle binding	  8	0.952366339066048	1	2	6	6722	7433	0.526583878643665
GO:0008037	cell recognition	 17	0.776294265732228	1	7	10	6717	7429	0.867314623648389
GO:0008045	motor neuron axon guidance	 16	0.324860333233664	1	9	7	6715	7432	1.18481372694825
GO:0008046	axon guidance receptor activity	  7	0.730029012673872	1	3	4	6721	7435	0.902715220531996
GO:0008047	enzyme activator activity	 42	0.671020490139043	1	19	23	6705	7416	0.952866066117107
GO:0008053	mitochondrial fusion	 14	0.160610520833599	0.919686434773344	9	5	6715	7434	1.35407283079799
GO:0008061	chitin binding	  8	0.819878207576373	1	3	5	6721	7434	0.789875817965497
GO:0008063	Toll signaling pathway	  6	0.607836179256654	1	3	3	6721	7436	1.05316775728733
GO:0008064	regulation of actin polymerization or depolymerization	 10	0.559603563591584	1	5	5	6719	7434	1.05316775728733
GO:0008066	glutamate receptor activity	 11	0.850917330440019	1	4	7	6720	7432	0.765940187118057
GO:0008074	guanylate cyclase complex, soluble	 15	0.972187308828691	1	4	11	6720	7428	0.561689470553242
GO:0008076	voltage-gated potassium channel complex	 76	0.552477460950537	1	36	40	6688	7399	0.997737875324838
GO:0008080	N-acetyltransferase activity	 22	0.655120963592744	1	10	12	6714	7427	0.957425233897572
GO:0008081	phosphoric diester hydrolase activity	 48	0.644440095440639	1	22	26	6702	7413	0.965403777513385
GO:0008089	anterograde axonal transport	 23	0.140447795438852	0.919686434773344	14	9	6710	7430	1.2821172697411
GO:0008090	retrograde axonal transport	  8	0.580280354503036	1	4	4	6720	7435	1.05316775728733
GO:0008091	spectrin	  7	0.919244306193629	1	2	5	6722	7434	0.601810147021331
GO:0008092	cytoskeletal protein binding	 61	0.0262698712722284	0.507122732385627	37	24	6687	7415	1.27761334490594
GO:0008093	cytoskeletal adaptor activity	 11	0.220387996626296	1	7	4	6717	7435	1.3403953274566
GO:0008094	DNA-dependent ATPase activity	 30	0.322199322975026	1	16	14	6708	7425	1.12337894110648
GO:0008097	5S rRNA binding	 10	0.133503266897558	0.919686434773344	7	3	6717	7436	1.47443486020226
GO:0008104	protein localization	 60	0.849142061872748	1	25	35	6699	7404	0.877639797739441
GO:0008131	primary amine oxidase activity	  5	1	1	0	5	6724	7434	0
GO:0008135	translation factor activity, RNA binding	 23	0.567952371389245	1	11	12	6713	7427	1.00737785479658
GO:0008137	NADH dehydrogenase (ubiquinone) activity	 32	0.00449374253934093	0.308784308774713	23	9	6701	7430	1.51392865110054
GO:0008138	protein tyrosine/serine/threonine phosphatase activity	 40	0.31562742638263	1	21	19	6703	7420	1.1058261451517
GO:0008139	nuclear localization sequence binding	 23	0.40318807961294	1	12	11	6712	7428	1.09895765977808
GO:0008140	cAMP response element binding protein binding	  6	0.297654371351411	1	4	2	6720	7437	1.40422367638311
GO:0008142	oxysterol binding	  5	0.77940058892516	1	2	3	6722	7436	0.842534205829863
GO:0008143	poly(A) binding	 12	0.012434352666713	0.427208830906354	10	2	6714	7437	1.75527959547888
GO:0008144	drug binding	 59	0.880985845351671	1	24	35	6700	7404	0.856814446606641
GO:0008146	sulfotransferase activity	 34	0.895363043887139	1	13	21	6711	7418	0.805363579102075
GO:0008154	actin polymerization or depolymerization	 12	0.320810094151237	1	7	5	6717	7434	1.22869571683522
GO:0008156	negative regulation of DNA replication	 15	0.798298186583662	1	6	9	6718	7430	0.842534205829863
GO:0008157	protein phosphatase 1 binding	 17	0.776294265732228	1	7	10	6717	7429	0.867314623648389
GO:0008171	O-methyltransferase activity	  8	0.819878207576373	1	3	5	6721	7434	0.789875817965497
GO:0008173	RNA methyltransferase activity	  9	0.438074670071218	1	5	4	6719	7435	1.17018639698592
GO:0008175	tRNA methyltransferase activity	  5	0.452745275304033	1	3	2	6721	7437	1.26380130874479
GO:0008179	adenylate cyclase binding	  9	0.438074670071218	1	5	4	6719	7435	1.17018639698592
GO:0008180	COP9 signalosome	 32	0.00449374253934093	0.308784308774713	23	9	6701	7430	1.51392865110054
GO:0008186	RNA-dependent ATPase activity	  5	0.77940058892516	1	2	3	6722	7436	0.842534205829863
GO:0008188	neuropeptide receptor activity	 11	0.953160347938253	1	3	8	6721	7431	0.574455140338543
GO:0008190	eukaryotic initiation factor 4E binding	  8	0.819878207576373	1	3	5	6721	7434	0.789875817965497
GO:0008191	metalloendopeptidase inhibitor activity	 14	0.728526098434397	1	6	8	6718	7431	0.902715220531996
GO:0008195	phosphatidate phosphatase activity	 12	0.899474094191123	1	4	8	6720	7431	0.702111838191553
GO:0008198	ferrous iron binding	 18	0.178063825749389	0.949543953868825	11	7	6713	7432	1.28720503668451
GO:0008199	ferric iron binding	  5	0.960049771736903	1	1	4	6723	7435	0.421267102914932
GO:0008202	steroid metabolic process	 91	0.474388033793991	1	44	47	6680	7392	1.01844794111302
GO:0008203	cholesterol metabolic process	 73	0.606360596291987	1	34	39	6690	7400	0.981032979390937
GO:0008206	bile acid metabolic process	  9	0.69404490204849	1	4	5	6720	7434	0.936149117588737
GO:0008209	androgen metabolic process	 13	0.822979434145659	1	5	8	6719	7431	0.810129044067176
GO:0008210	estrogen metabolic process	  8	0.819878207576373	1	3	5	6721	7434	0.789875817965497
GO:0008217	regulation of blood pressure	 57	0.989262087710742	1	19	38	6705	7401	0.702111838191553
GO:0008219	cell death	 33	0.865742308063324	1	13	20	6711	7419	0.829768536044562
GO:0008235	metalloexopeptidase activity	 10	0.78367246101976	1	4	6	6720	7433	0.842534205829863
GO:0008239	dipeptidyl-peptidase activity	 10	0.78367246101976	1	4	6	6720	7433	0.842534205829863
GO:0008250	oligosaccharyltransferase complex	 10	0.559603563591584	1	5	5	6719	7434	1.05316775728733
GO:0008253	5	  9	0.438074670071218	1	5	4	6719	7435	1.17018639698592
GO:0008266	poly(U) RNA binding	 16	0.170220385600338	0.949543953868825	10	6	6714	7433	1.31645969660916
GO:0008271	secondary active sulfate transmembrane transporter activity	  8	0.580280354503036	1	4	4	6720	7435	1.05316775728733
GO:0008272	sulfate transport	 11	0.850917330440019	1	4	7	6720	7432	0.765940187118057
GO:0008274	gamma-tubulin ring complex	  7	0.0474968970055936	0.646585116783694	6	1	6718	7438	1.80543044106399
GO:0008276	protein methyltransferase activity	 11	0.220387996626296	1	7	4	6717	7435	1.3403953274566
GO:0008277	regulation of G-protein coupled receptor protein signaling pathway	 40	0.434912283174119	1	20	20	6704	7419	1.05316775728733
GO:0008278	cohesin complex	  7	0.444912401367032	1	4	3	6720	7436	1.20362029404266
GO:0008286	insulin receptor signaling pathway	 71	0.00973708499053196	0.427208830906354	44	27	6680	7412	1.30533468508852
GO:0008290	F-actin capping protein complex	  6	0.607836179256654	1	3	3	6721	7436	1.05316775728733
GO:0008299	isoprenoid biosynthetic process	 14	0.875453509540804	1	5	9	6719	7430	0.752262683776664
GO:0008301	DNA binding, bending	 14	0.875453509540804	1	5	9	6719	7430	0.752262683776664
GO:0008305	integrin complex	 20	0.911428444807446	1	7	13	6717	7426	0.73721743010113
GO:0008306	associative learning	 23	0.40318807961294	1	12	11	6712	7428	1.09895765977808
GO:0008307	structural constituent of muscle	 37	0.843930287056752	1	15	22	6709	7417	0.853919803205942
GO:0008312	7S RNA binding	  6	0.297654371351411	1	4	2	6720	7437	1.40422367638311
GO:0008320	protein transmembrane transporter activity	  5	0.77940058892516	1	2	3	6722	7436	0.842534205829863
GO:0008324	cation transmembrane transporter activity	 16	0.517377397284026	1	8	8	6716	7431	1.05316775728733
GO:0008327	methyl-CpG binding	 14	0.323388997222084	1	8	6	6716	7433	1.20362029404266
GO:0008328	ionotropic glutamate receptor complex	 11	0.665993939534306	1	5	6	6719	7433	0.957425233897572
GO:0008329	signaling pattern recognition receptor activity	  7	0.98898631085553	1	1	6	6723	7433	0.300905073510665
GO:0008331	high voltage-gated calcium channel activity	 11	0.431935112460319	1	6	5	6718	7434	1.14891028067709
GO:0008333	endosome to lysosome transport	 36	0.0351046370324894	0.599479186247127	23	13	6701	7426	1.34571435653381
GO:0008334	histone mRNA metabolic process	 11	0.665993939534306	1	5	6	6719	7433	0.957425233897572
GO:0008340	determination of adult lifespan	 12	0.320810094151237	1	7	5	6717	7434	1.22869571683522
GO:0008344	adult locomotory behavior	 45	0.00299165831322282	0.250258721506118	31	14	6693	7425	1.45103113226254
GO:0008347	glial cell migration	 11	0.990836032904502	1	2	9	6722	7430	0.382970093559029
GO:0008349	MAP kinase kinase kinase kinase activity	  9	0.206720270758876	0.983668097955673	6	3	6718	7436	1.40422367638311
GO:0008353	RNA polymerase II carboxy-terminal domain kinase activity	 13	0.0309498150207146	0.552600112408603	10	3	6714	7436	1.62025808813435
GO:0008354	germ cell migration	  7	0.919244306193629	1	2	5	6722	7434	0.601810147021331
GO:0008361	regulation of cell size	 20	0.497606676879603	1	10	10	6714	7429	1.05316775728733
GO:0008366	axon ensheathment	  8	0.580280354503036	1	4	4	6720	7435	1.05316775728733
GO:0008373	sialyltransferase activity	 18	0.506938913103874	1	9	9	6715	7430	1.05316775728733
GO:0008374	O-acyltransferase activity	 11	0.431935112460319	1	6	5	6718	7434	1.14891028067709
GO:0008375	acetylglucosaminyltransferase activity	 20	0.911428444807446	1	7	13	6717	7426	0.73721743010113
GO:0008376	acetylgalactosaminyltransferase activity	 10	0.316545776550851	1	6	4	6718	7435	1.26380130874479
GO:0008378	galactosyltransferase activity	 23	0.92480513956827	1	8	15	6716	7424	0.732638439852055
GO:0008379	thioredoxin peroxidase activity	  5	0.77940058892516	1	2	3	6722	7436	0.842534205829863
GO:0008385	IkappaB kinase complex	  9	0.206720270758876	0.983668097955673	6	3	6718	7436	1.40422367638311
GO:0008392	arachidonic acid epoxygenase activity	 10	0.983985908365184	1	2	8	6722	7431	0.421267102914932
GO:0008395	steroid hydroxylase activity	 15	0.914031171019375	1	5	10	6719	7429	0.702111838191553
GO:0008406	gonad development	 10	0.925275888620553	1	3	7	6721	7432	0.631900654372397
GO:0008408	3	 15	0.421118865258844	1	8	7	6716	7432	1.12337894110648
GO:0008409	5	 10	0.559603563591584	1	5	5	6719	7434	1.05316775728733
GO:0008417	fucosyltransferase activity	  9	0.69404490204849	1	4	5	6720	7434	0.936149117588737
GO:0008420	CTD phosphatase activity	  6	0.979023167332401	1	1	5	6723	7434	0.351055919095776
GO:0008429	phosphatidylethanolamine binding	  8	0.309544448231027	1	5	3	6719	7436	1.31645969660916
GO:0008430	selenium binding	  6	0.607836179256654	1	3	3	6721	7436	1.05316775728733
GO:0008432	JUN kinase binding	  8	0.309544448231027	1	5	3	6719	7436	1.31645969660916
GO:0008440	inositol-1,4,5-trisphosphate 3-kinase activity	  6	0.607836179256654	1	3	3	6721	7436	1.05316775728733
GO:0008467	[heparan sulfate]-glucosamine 3-sulfotransferase 1 activity	  6	0.979023167332401	1	1	5	6723	7434	0.351055919095776
GO:0008469	histone-arginine N-methyltransferase activity	  7	0.444912401367032	1	4	3	6720	7436	1.20362029404266
GO:0008474	palmitoyl-(protein) hydrolase activity	  5	0.960049771736903	1	1	4	6723	7435	0.421267102914932
GO:0008483	transaminase activity	 19	0.248077880408704	1	11	8	6713	7431	1.2194574031748
GO:0008484	sulfuric ester hydrolase activity	 16	0.94165410331218	1	5	11	6719	7428	0.658229848304581
GO:0008499	UDP-galactose:beta-N-acetylglucosamine beta-1,3-galactosyltransferase activity	 14	0.875453509540804	1	5	9	6719	7430	0.752262683776664
GO:0008503	benzodiazepine receptor activity	  5	0.77940058892516	1	2	3	6722	7436	0.842534205829863
GO:0008509	anion transmembrane transporter activity	 12	0.320810094151237	1	7	5	6717	7434	1.22869571683522
GO:0008510	sodium:bicarbonate symporter activity	  6	0.607836179256654	1	3	3	6721	7436	1.05316775728733
GO:0008514	organic anion transmembrane transporter activity	 17	0.895242422289557	1	6	11	6718	7428	0.743412534555762
GO:0008519	ammonium transmembrane transporter activity	  5	0.960049771736903	1	1	4	6723	7435	0.421267102914932
GO:0008526	phosphatidylinositol transporter activity	  6	0.607836179256654	1	3	3	6721	7436	1.05316775728733
GO:0008527	taste receptor activity	  6	0.607836179256654	1	3	3	6721	7436	1.05316775728733
GO:0008528	G-protein coupled peptide receptor activity	 11	0.953160347938253	1	3	8	6721	7431	0.574455140338543
GO:0008532	N-acetyllactosaminide beta-1,3-N-acetylglucosaminyltransferase activity	  5	0.960049771736903	1	1	4	6723	7435	0.421267102914932
GO:0008535	respiratory chain complex IV assembly	  6	0.0874151689581943	0.807895728316903	5	1	6719	7438	1.75527959547888
GO:0008536	Ran GTPase binding	 28	0.0552578549226092	0.708774085807334	18	10	6706	7429	1.35407283079799
GO:0008540	proteasome regulatory particle, base subcomplex	 11	0.850917330440019	1	4	7	6720	7432	0.765940187118057
GO:0008541	proteasome regulatory particle, lid subcomplex	  7	0.444912401367032	1	4	3	6720	7436	1.20362029404266
GO:0008542	visual learning	 41	0.0291653004249913	0.548345648381269	26	15	6698	7424	1.33572496046198
GO:0008543	fibroblast growth factor receptor signaling pathway	 70	0.379997815827467	1	35	35	6689	7404	1.05316775728733
GO:0008544	epidermis development	 61	0.99303095897884	1	20	41	6704	7398	0.690601808057265
GO:0008553	hydrogen-exporting ATPase activity, phosphorylative mechanism	  6	0.297654371351411	1	4	2	6720	7437	1.40422367638311
GO:0008559	xenobiotic-transporting ATPase activity	  7	0.919244306193629	1	2	5	6722	7434	0.601810147021331
GO:0008565	protein transporter activity	 63	0.00754263964913917	0.365849714746482	40	23	6684	7416	1.33735588226962
GO:0008568	microtubule-severing ATPase activity	  5	0.452745275304033	1	3	2	6721	7437	1.26380130874479
GO:0008569	ATP-dependent microtubule motor activity, minus-end-directed	 13	0.0975861781940815	0.843214701401555	9	4	6715	7435	1.45823227932092
GO:0008574	ATP-dependent microtubule motor activity, plus-end-directed	 20	0.813860390499775	1	8	12	6716	7427	0.842534205829863
GO:0008584	male gonad development	 84	0.445276411848224	1	41	43	6683	7396	1.02809233449477
GO:0008585	female gonad development	 15	0.623867966210499	1	7	8	6717	7431	0.982956573468174
GO:0008589	regulation of smoothened signaling pathway	 18	0.0300950583180779	0.549711001936538	13	5	6711	7434	1.5212423160817
GO:0008593	regulation of Notch signaling pathway	 10	0.78367246101976	1	4	6	6720	7433	0.842534205829863
GO:0008595	anterior/posterior axis specification, embryo	  6	0.979023167332401	1	1	5	6723	7434	0.351055919095776
GO:0008603	cAMP-dependent protein kinase regulator activity	  7	0.730029012673872	1	3	4	6721	7435	0.902715220531996
GO:0008608	attachment of spindle microtubules to kinetochore	  8	0.309544448231027	1	5	3	6719	7436	1.31645969660916
GO:0008610	lipid biosynthetic process	 17	6.21196383888486e-05	0.0448193190975543	16	1	6708	7438	1.98243342548203
GO:0008622	epsilon DNA polymerase complex	  5	1	1	0	5	6724	7434	0
GO:0008625	extrinsic apoptotic signaling pathway via death domain receptors	 29	0.680253022221135	1	13	16	6711	7423	0.944219368602433
GO:0008626	granzyme-mediated apoptotic signaling pathway	  5	0.452745275304033	1	3	2	6721	7437	1.26380130874479
GO:0008630	intrinsic apoptotic signaling pathway in response to DNA damage	 45	0.366442606271816	1	23	22	6701	7417	1.07657148522705
GO:0008631	intrinsic apoptotic signaling pathway in response to oxidative stress	 13	0.426320358160906	1	7	6	6717	7433	1.13418066169405
GO:0008635	activation of cysteine-type endopeptidase activity involved in apoptotic process by cytochrome c	  6	0.979023167332401	1	1	5	6723	7434	0.351055919095776
GO:0008637	apoptotic mitochondrial changes	 22	0.0957434892101259	0.843214701401555	14	8	6710	7431	1.3403953274566
GO:0008641	ubiquitin-like modifier activating enzyme activity	  9	0.438074670071218	1	5	4	6719	7435	1.17018639698592
GO:0008643	carbohydrate transport	 32	0.724657061059778	1	14	18	6710	7421	0.921521787626413
GO:0008645	hexose transport	 11	0.990836032904502	1	2	9	6722	7430	0.382970093559029
GO:0008649	rRNA methyltransferase activity	  7	0.187210848839696	0.949543953868825	5	2	6719	7437	1.50452536755333
GO:0008652	cellular amino acid biosynthetic process	 35	0.0227695543172911	0.495149842313607	23	12	6701	7427	1.38416333814906
GO:0008654	phospholipid biosynthetic process	 47	0.0645428120974132	0.780679208284898	28	19	6696	7420	1.25483817889554
GO:0008656	cysteine-type endopeptidase activator activity involved in apoptotic process	 14	0.875453509540804	1	5	9	6719	7430	0.752262683776664
GO:0008757	S-adenosylmethionine-dependent methyltransferase activity	 14	0.728526098434397	1	6	8	6718	7431	0.902715220531996
GO:0008821	crossover junction endodeoxyribonuclease activity	  6	0.607836179256654	1	3	3	6721	7436	1.05316775728733
GO:0008889	glycerophosphodiester phosphodiesterase activity	  5	0.77940058892516	1	2	3	6722	7436	0.842534205829863
GO:0008970	phosphatidylcholine 1-acylhydrolase activity	  7	0.444912401367032	1	4	3	6720	7436	1.20362029404266
GO:0009048	dosage compensation by inactivation of X chromosome	  5	0.0241003244622537	0.495149842313607	5	0	6719	7439	2.10633551457466
GO:0009052	pentose-phosphate shunt, non-oxidative branch	  5	0.77940058892516	1	2	3	6722	7436	0.842534205829863
GO:0009055	electron carrier activity	 61	0.812834323211392	1	26	35	6698	7404	0.897782350474444
GO:0009056	catabolic process	  5	0.77940058892516	1	2	3	6722	7436	0.842534205829863
GO:0009058	biosynthetic process	 35	0.00352484854410346	0.27493818644007	25	10	6699	7429	1.50452536755333
GO:0009060	aerobic respiration	 23	0.254283570903419	1	13	10	6711	7429	1.19053746475959
GO:0009062	fatty acid catabolic process	 13	0.643122793005253	1	6	7	6718	7432	0.972154852880611
GO:0009072	aromatic amino acid family metabolic process	  5	0.960049771736903	1	1	4	6723	7435	0.421267102914932
GO:0009083	branched-chain amino acid catabolic process	 17	6.21196383888486e-05	0.0448193190975543	16	1	6708	7438	1.98243342548203
GO:0009086	methionine biosynthetic process	  9	0.067355898427907	0.780679208284898	7	2	6717	7437	1.63826095578029
GO:0009100	glycoprotein metabolic process	 11	0.665993939534306	1	5	6	6719	7433	0.957425233897572
GO:0009101	glycoprotein biosynthetic process	  6	1	1	0	6	6724	7433	0
GO:0009108	coenzyme biosynthetic process	  7	0.730029012673872	1	3	4	6721	7435	0.902715220531996
GO:0009113	purine nucleobase biosynthetic process	  6	0.865182793759413	1	2	4	6722	7435	0.702111838191553
GO:0009116	nucleoside metabolic process	 18	0.926471989195673	1	6	12	6718	7427	0.702111838191553
GO:0009117	nucleotide metabolic process	 26	0.107316947101236	0.88413902838582	16	10	6708	7429	1.29620647050748
GO:0009142	nucleoside triphosphate biosynthetic process	  5	0.77940058892516	1	2	3	6722	7436	0.842534205829863
GO:0009143	nucleoside triphosphate catabolic process	  5	0.0241003244622537	0.495149842313607	5	0	6719	7439	2.10633551457466
GO:0009156	ribonucleoside monophosphate biosynthetic process	  5	0.0241003244622537	0.495149842313607	5	0	6719	7439	2.10633551457466
GO:0009165	nucleotide biosynthetic process	 14	0.875453509540804	1	5	9	6719	7430	0.752262683776664
GO:0009168	purine ribonucleoside monophosphate biosynthetic process	 15	0.798298186583662	1	6	9	6718	7430	0.842534205829863
GO:0009190	cyclic nucleotide biosynthetic process	 17	0.960992303738273	1	5	12	6719	7427	0.619510445463135
GO:0009235	cobalamin metabolic process	 18	0.506938913103874	1	9	9	6715	7430	1.05316775728733
GO:0009247	glycolipid biosynthetic process	  6	0.607836179256654	1	3	3	6721	7436	1.05316775728733
GO:0009249	protein lipoylation	  6	0.865182793759413	1	2	4	6722	7435	0.702111838191553
GO:0009253	peptidoglycan catabolic process	  5	1	1	0	5	6724	7434	0
GO:0009266	response to temperature stimulus	  6	0.865182793759413	1	2	4	6722	7435	0.702111838191553
GO:0009267	cellular response to starvation	 52	0.216840980788415	1	28	24	6696	7415	1.13418066169405
GO:0009268	response to pH	 11	0.431935112460319	1	6	5	6718	7434	1.14891028067709
GO:0009303	rRNA transcription	 13	0.0309498150207146	0.552600112408603	10	3	6714	7436	1.62025808813435
GO:0009306	protein secretion	 30	0.0105949860916097	0.427208830906354	21	9	6703	7430	1.47443486020226
GO:0009308	amine metabolic process	  5	1	1	0	5	6724	7434	0
GO:0009311	oligosaccharide metabolic process	 23	0.843995637843635	1	9	14	6715	7425	0.824218244833562
GO:0009312	oligosaccharide biosynthetic process	 11	0.665993939534306	1	5	6	6719	7433	0.957425233897572
GO:0009313	oligosaccharide catabolic process	 10	0.316545776550851	1	6	4	6718	7435	1.26380130874479
GO:0009314	response to radiation	 34	0.945955639398543	1	12	22	6712	7417	0.743412534555762
GO:0009374	biotin binding	  5	0.452745275304033	1	3	2	6721	7437	1.26380130874479
GO:0009395	phospholipid catabolic process	  9	0.206720270758876	0.983668097955673	6	3	6718	7436	1.40422367638311
GO:0009404	toxin metabolic process	  5	0.157494903089267	0.919686434773344	4	1	6720	7438	1.68506841165973
GO:0009408	response to heat	 44	0.425925500476264	1	22	22	6702	7417	1.05316775728733
GO:0009409	response to cold	 36	0.938597744199527	1	13	23	6711	7416	0.760621158040849
GO:0009410	response to xenobiotic stimulus	  7	0.187210848839696	0.949543953868825	5	2	6719	7437	1.50452536755333
GO:0009411	response to UV	 39	0.0121821327825983	0.427208830906354	26	13	6698	7426	1.40422367638311
GO:0009414	response to water deprivation	  5	0.157494903089267	0.919686434773344	4	1	6720	7438	1.68506841165973
GO:0009416	response to light stimulus	 18	0.506938913103874	1	9	9	6715	7430	1.05316775728733
GO:0009435	NAD biosynthetic process	 13	0.230372725000093	1	8	5	6716	7434	1.29620647050748
GO:0009437	carnitine metabolic process	  7	0.730029012673872	1	3	4	6721	7435	0.902715220531996
GO:0009451	RNA modification	 15	0.623867966210499	1	7	8	6717	7431	0.982956573468174
GO:0009566	fertilization	 32	0.724657061059778	1	14	18	6710	7421	0.921521787626413
GO:0009597	detection of virus	  5	0.960049771736903	1	1	4	6723	7435	0.421267102914932
GO:0009607	response to biotic stimulus	  9	0.972243904416257	1	2	7	6722	7432	0.468074558794368
GO:0009611	response to wounding	 62	0.298971487762969	1	32	30	6692	7409	1.08714091074821
GO:0009612	response to mechanical stimulus	 57	0.931003517137986	1	22	35	6702	7404	0.812971602116535
GO:0009615	response to virus	 94	0.9943742946993	1	33	61	6691	7378	0.739458212563444
GO:0009617	response to bacterium	 29	0.997306136607231	1	7	22	6717	7417	0.508425813862848
GO:0009620	response to fungus	  7	0.730029012673872	1	3	4	6721	7435	0.902715220531996
GO:0009629	response to gravity	  6	0.865182793759413	1	2	4	6722	7435	0.702111838191553
GO:0009635	response to herbicide	  5	0.452745275304033	1	3	2	6721	7437	1.26380130874479
GO:0009636	response to toxic substance	 75	0.509098215018364	1	36	39	6688	7400	1.01104104699584
GO:0009642	response to light intensity	  5	0.77940058892516	1	2	3	6722	7436	0.842534205829863
GO:0009649	entrainment of circadian clock	  5	0.452745275304033	1	3	2	6721	7437	1.26380130874479
GO:0009650	UV protection	 11	0.431935112460319	1	6	5	6718	7434	1.14891028067709
GO:0009651	response to salt stress	  7	0.730029012673872	1	3	4	6721	7435	0.902715220531996
GO:0009725	response to hormone	 49	0.585519323004131	1	23	26	6701	7413	0.988688098677901
GO:0009743	response to carbohydrate	  8	0.952366339066048	1	2	6	6722	7433	0.526583878643665
GO:0009744	response to sucrose	  5	0.77940058892516	1	2	3	6722	7436	0.842534205829863
GO:0009749	response to glucose	 62	0.896177633973622	1	25	37	6699	7402	0.849328836522039
GO:0009750	response to fructose	  5	1	1	0	5	6724	7434	0
GO:0009755	hormone-mediated signaling pathway	 17	0.607264962167558	1	8	9	6716	7430	0.991216712741015
GO:0009790	embryo development	 31	0.877080826063238	1	12	19	6712	7420	0.815355683061158
GO:0009791	post-embryonic development	 74	0.0253663131521931	0.495149842313607	44	30	6680	7409	1.25241571136872
GO:0009880	embryonic pattern specification	 21	0.86019883501541	1	8	13	6716	7426	0.802413529361774
GO:0009881	photoreceptor activity	  6	0.607836179256654	1	3	3	6721	7436	1.05316775728733
GO:0009887	animal organ morphogenesis	100	0.997724292756677	1	34	66	6690	7373	0.716154074955384
GO:0009888	tissue development	 12	0.899474094191123	1	4	8	6720	7431	0.702111838191553
GO:0009898	cytoplasmic side of plasma membrane	 37	0.0973421652165049	0.843214701401555	22	15	6702	7424	1.25241571136872
GO:0009913	epidermal cell differentiation	  6	0.979023167332401	1	1	5	6723	7434	0.351055919095776
GO:0009922	fatty acid elongase activity	  5	0.452745275304033	1	3	2	6721	7437	1.26380130874479
GO:0009925	basal plasma membrane	 26	0.474259103737385	1	13	13	6711	7426	1.05316775728733
GO:0009931	calcium-dependent protein serine/threonine kinase activity	  7	0.730029012673872	1	3	4	6721	7435	0.902715220531996
GO:0009948	anterior/posterior axis specification	 16	0.94165410331218	1	5	11	6719	7428	0.658229848304581
GO:0009950	dorsal/ventral axis specification	  6	0.0874151689581943	0.807895728316903	5	1	6719	7438	1.75527959547888
GO:0009952	anterior/posterior pattern specification	 72	0.998843585310014	1	22	50	6702	7389	0.643602518342257
GO:0009953	dorsal/ventral pattern formation	 37	0.953716857412494	1	13	24	6711	7415	0.74006382944515
GO:0009954	proximal/distal pattern formation	 18	0.832783288477324	1	7	11	6717	7428	0.819130477890145
GO:0009966	regulation of signal transduction	 38	0.690856724535252	1	17	21	6707	7418	0.942307993362347
GO:0009967	positive regulation of signal transduction	 52	0.0528839788327705	0.693741649597162	31	21	6693	7418	1.25570001830412
GO:0009968	negative regulation of signal transduction	 60	0.497633769606333	1	29	31	6695	7408	1.01806216537775
GO:0009972	cytidine deamination	  5	0.960049771736903	1	1	4	6723	7435	0.421267102914932
GO:0009982	pseudouridine synthase activity	 13	0.822979434145659	1	5	8	6719	7431	0.810129044067176
GO:0009987	cellular process	 13	0.822979434145659	1	5	8	6719	7431	0.810129044067176
GO:0009988	cell-cell recognition	  5	1	1	0	5	6724	7434	0
GO:0010001	glial cell differentiation	 17	0.997764322622395	1	3	14	6721	7425	0.371706267277881
GO:0010033	response to organic substance	 79	0.993976461872687	1	27	52	6697	7387	0.719886821436909
GO:0010035	response to inorganic substance	 12	0.971055765853963	1	3	9	6721	7430	0.526583878643665
GO:0010038	response to metal ion	 15	0.237875362689918	1	9	6	6715	7433	1.26380130874479
GO:0010039	response to iron ion	 18	0.687525801418504	1	8	10	6716	7429	0.936149117588737
GO:0010042	response to manganese ion	  7	0.730029012673872	1	3	4	6721	7435	0.902715220531996
GO:0010043	response to zinc ion	 30	0.737235950138567	1	13	17	6711	7422	0.912745389649018
GO:0010107	potassium ion import	 21	0.407325414326014	1	11	10	6713	7429	1.10331860287244
GO:0010165	response to X-ray	 19	0.949176156916864	1	6	13	6718	7426	0.665158583549892
GO:0010181	FMN binding	 10	0.78367246101976	1	4	6	6720	7433	0.842534205829863
GO:0010212	response to ionizing radiation	 43	0.0598612228134263	0.764422517874108	26	17	6698	7422	1.27359821811491
GO:0010216	maintenance of DNA methylation	  5	0.157494903089267	0.919686434773344	4	1	6720	7438	1.68506841165973
GO:0010224	response to UV-B	  6	0.607836179256654	1	3	3	6721	7436	1.05316775728733
GO:0010225	response to UV-C	  7	0.444912401367032	1	4	3	6720	7436	1.20362029404266
GO:0010226	response to lithium ion	  8	0.952366339066048	1	2	6	6722	7433	0.526583878643665
GO:0010243	response to organonitrogen compound	 31	0.529914677492654	1	15	16	6709	7423	1.01919460382645
GO:0010248	establishment or maintenance of transmembrane electrochemical gradient	 12	0.899474094191123	1	4	8	6720	7431	0.702111838191553
GO:0010259	multicellular organism aging	 12	0.320810094151237	1	7	5	6717	7434	1.22869571683522
GO:0010265	SCF complex assembly	  6	0.0874151689581943	0.807895728316903	5	1	6719	7438	1.75527959547888
GO:0010269	response to selenium ion	  6	0.979023167332401	1	1	5	6723	7434	0.351055919095776
GO:0010288	response to lead ion	 15	0.421118865258844	1	8	7	6716	7432	1.12337894110648
GO:0010310	regulation of hydrogen peroxide metabolic process	  5	0.77940058892516	1	2	3	6722	7436	0.842534205829863
GO:0010314	phosphatidylinositol-5-phosphate binding	  9	0.206720270758876	0.983668097955673	6	3	6718	7436	1.40422367638311
GO:0010324	membrane invagination	  5	0.77940058892516	1	2	3	6722	7436	0.842534205829863
GO:0010332	response to gamma radiation	 28	0.616649478927714	1	13	15	6711	7424	0.977941488909663
GO:0010369	chromocenter	  9	0.882794860340315	1	3	6	6721	7433	0.702111838191553
GO:0010389	regulation of G2/M transition of mitotic cell cycle	 77	0.0113724879831795	0.427208830906354	47	30	6677	7409	1.28568531409102
GO:0010390	histone monoubiquitination	  9	0.996964464269463	1	1	8	6723	7431	0.234037279397184
GO:0010447	response to acidic pH	 11	0.665993939534306	1	5	6	6719	7433	0.957425233897572
GO:0010452	histone H3-K36 methylation	  5	0.157494903089267	0.919686434773344	4	1	6720	7438	1.68506841165973
GO:0010457	centriole-centriole cohesion	  8	0.580280354503036	1	4	4	6720	7435	1.05316775728733
GO:0010458	exit from mitosis	 10	0.559603563591584	1	5	5	6719	7434	1.05316775728733
GO:0010459	negative regulation of heart rate	  7	0.444912401367032	1	4	3	6720	7436	1.20362029404266
GO:0010460	positive regulation of heart rate	 15	0.623867966210499	1	7	8	6717	7431	0.982956573468174
GO:0010466	negative regulation of peptidase activity	 85	0.999999566399713	1	19	66	6705	7373	0.470827938551982
GO:0010467	gene expression	  6	0.297654371351411	1	4	2	6720	7437	1.40422367638311
GO:0010469	regulation of receptor activity	 11	0.953160347938253	1	3	8	6721	7431	0.574455140338543
GO:0010470	regulation of gastrulation	 10	0.559603563591584	1	5	5	6719	7434	1.05316775728733
GO:0010485	H4 histone acetyltransferase activity	  6	0.607836179256654	1	3	3	6721	7436	1.05316775728733
GO:0010494	cytoplasmic stress granule	 37	0.507552451933799	1	18	19	6706	7420	1.02470376384713
GO:0010498	proteasomal protein catabolic process	 13	0.0975861781940815	0.843214701401555	9	4	6715	7435	1.45823227932092
GO:0010501	RNA secondary structure unwinding	 38	0.130268659230789	0.919686434773344	22	16	6702	7423	1.2194574031748
GO:0010506	regulation of autophagy	 49	0.11237837888043	0.88413902838582	28	21	6696	7418	1.20362029404266
GO:0010507	negative regulation of autophagy	 27	0.814070309852114	1	11	16	6713	7423	0.858136691123009
GO:0010508	positive regulation of autophagy	 42	0.774336043615827	1	18	24	6706	7415	0.902715220531996
GO:0010510	regulation of acetyl-CoA biosynthetic process from pyruvate	 12	0.0514533113817507	0.679607581911819	9	3	6715	7436	1.57975163593099
GO:0010518	positive regulation of phospholipase activity	  7	0.444912401367032	1	4	3	6720	7436	1.20362029404266
GO:0010523	negative regulation of calcium ion transport into cytosol	  5	0.77940058892516	1	2	3	6722	7436	0.842534205829863
GO:0010524	positive regulation of calcium ion transport into cytosol	 11	0.953160347938253	1	3	8	6721	7431	0.574455140338543
GO:0010529	negative regulation of transposition	  6	0.865182793759413	1	2	4	6722	7435	0.702111838191553
GO:0010544	negative regulation of platelet activation	  8	0.994217735396885	1	1	7	6723	7432	0.263291939321832
GO:0010564	regulation of cell cycle process	  5	0.0241003244622537	0.495149842313607	5	0	6719	7439	2.10633551457466
GO:0010569	regulation of double-strand break repair via homologous recombination	 10	0.78367246101976	1	4	6	6720	7433	0.842534205829863
GO:0010571	positive regulation of nuclear cell cycle DNA replication	  5	0.0241003244622537	0.495149842313607	5	0	6719	7439	2.10633551457466
GO:0010575	positive regulation of vascular endothelial growth factor production	 21	0.937043249703464	1	7	14	6717	7425	0.702111838191553
GO:0010579	positive regulation of adenylate cyclase activity involved in G-protein coupled receptor signaling pathway	  6	0.607836179256654	1	3	3	6721	7436	1.05316775728733
GO:0010586	miRNA metabolic process	 15	0.109100626262719	0.88413902838582	10	5	6714	7434	1.40422367638311
GO:0010591	regulation of lamellipodium assembly	 11	0.220387996626296	1	7	4	6717	7435	1.3403953274566
GO:0010592	positive regulation of lamellipodium assembly	 15	0.623867966210499	1	7	8	6717	7431	0.982956573468174
GO:0010594	regulation of endothelial cell migration	  6	0.607836179256654	1	3	3	6721	7436	1.05316775728733
GO:0010595	positive regulation of endothelial cell migration	 42	0.774336043615827	1	18	24	6706	7415	0.902715220531996
GO:0010596	negative regulation of endothelial cell migration	 16	0.517377397284026	1	8	8	6716	7431	1.05316775728733
GO:0010606	positive regulation of cytoplasmic mRNA processing body assembly	  5	0.77940058892516	1	2	3	6722	7436	0.842534205829863
GO:0010608	posttranscriptional regulation of gene expression	 16	0.853260719975205	1	6	10	6718	7429	0.789875817965497
GO:0010613	positive regulation of cardiac muscle hypertrophy	 16	0.324860333233664	1	9	7	6715	7432	1.18481372694825
GO:0010614	negative regulation of cardiac muscle hypertrophy	  7	0.444912401367032	1	4	3	6720	7436	1.20362029404266
GO:0010631	epithelial cell migration	  5	0.960049771736903	1	1	4	6723	7435	0.421267102914932
GO:0010632	regulation of epithelial cell migration	  5	0.77940058892516	1	2	3	6722	7436	0.842534205829863
GO:0010633	negative regulation of epithelial cell migration	 14	0.728526098434397	1	6	8	6718	7431	0.902715220531996
GO:0010634	positive regulation of epithelial cell migration	 32	0.455512481379508	1	16	16	6708	7423	1.05316775728733
GO:0010637	negative regulation of mitochondrial fusion	  5	0.452745275304033	1	3	2	6721	7437	1.26380130874479
GO:0010642	negative regulation of platelet-derived growth factor receptor signaling pathway	  6	0.865182793759413	1	2	4	6722	7435	0.702111838191553
GO:0010644	cell communication by electrical coupling	  5	0.960049771736903	1	1	4	6723	7435	0.421267102914932
GO:0010656	negative regulation of muscle cell apoptotic process	  5	0.452745275304033	1	3	2	6721	7437	1.26380130874479
GO:0010664	negative regulation of striated muscle cell apoptotic process	  5	0.452745275304033	1	3	2	6721	7437	1.26380130874479
GO:0010666	positive regulation of cardiac muscle cell apoptotic process	 10	0.133503266897558	0.919686434773344	7	3	6717	7436	1.47443486020226
GO:0010667	negative regulation of cardiac muscle cell apoptotic process	 17	0.776294265732228	1	7	10	6717	7429	0.867314623648389
GO:0010669	epithelial structure maintenance	  7	0.444912401367032	1	4	3	6720	7436	1.20362029404266
GO:0010694	positive regulation of alkaline phosphatase activity	  6	0.865182793759413	1	2	4	6722	7435	0.702111838191553
GO:0010700	negative regulation of norepinephrine secretion	  6	0.979023167332401	1	1	5	6723	7434	0.351055919095776
GO:0010715	regulation of extracellular matrix disassembly	  5	0.77940058892516	1	2	3	6722	7436	0.842534205829863
GO:0010717	regulation of epithelial to mesenchymal transition	 11	0.431935112460319	1	6	5	6718	7434	1.14891028067709
GO:0010718	positive regulation of epithelial to mesenchymal transition	 35	0.854689987251871	1	14	21	6710	7418	0.842534205829863
GO:0010719	negative regulation of epithelial to mesenchymal transition	 19	0.949176156916864	1	6	13	6718	7426	0.665158583549892
GO:0010737	protein kinase A signaling	  6	0.979023167332401	1	1	5	6723	7434	0.351055919095776
GO:0010738	regulation of protein kinase A signaling	 12	0.75380380293781	1	5	7	6719	7432	0.877639797739441
GO:0010739	positive regulation of protein kinase A signaling	  7	0.919244306193629	1	2	5	6722	7434	0.601810147021331
GO:0010742	macrophage derived foam cell differentiation	  7	0.919244306193629	1	2	5	6722	7434	0.601810147021331
GO:0010744	positive regulation of macrophage derived foam cell differentiation	 13	0.999769586887007	1	1	12	6723	7427	0.162025808813435
GO:0010745	negative regulation of macrophage derived foam cell differentiation	 10	0.78367246101976	1	4	6	6720	7433	0.842534205829863
GO:0010757	negative regulation of plasminogen activation	  5	1	1	0	5	6724	7434	0
GO:0010759	positive regulation of macrophage chemotaxis	 14	0.998346203775137	1	2	12	6722	7427	0.300905073510665
GO:0010761	fibroblast migration	 10	0.133503266897558	0.919686434773344	7	3	6717	7436	1.47443486020226
GO:0010762	regulation of fibroblast migration	  8	0.819878207576373	1	3	5	6721	7434	0.789875817965497
GO:0010763	positive regulation of fibroblast migration	 11	0.850917330440019	1	4	7	6720	7432	0.765940187118057
GO:0010764	negative regulation of fibroblast migration	  7	0.730029012673872	1	3	4	6721	7435	0.902715220531996
GO:0010765	positive regulation of sodium ion transport	 15	0.421118865258844	1	8	7	6716	7432	1.12337894110648
GO:0010793	regulation of mRNA export from nucleus	  6	0.0874151689581943	0.807895728316903	5	1	6719	7438	1.75527959547888
GO:0010800	positive regulation of peptidyl-threonine phosphorylation	 20	0.997419657119239	1	4	16	6720	7423	0.421267102914932
GO:0010801	negative regulation of peptidyl-threonine phosphorylation	 11	0.850917330440019	1	4	7	6720	7432	0.765940187118057
GO:0010803	regulation of tumor necrosis factor-mediated signaling pathway	 28	0.750594068387264	1	12	16	6712	7423	0.902715220531996
GO:0010804	negative regulation of tumor necrosis factor-mediated signaling pathway	 15	0.421118865258844	1	8	7	6716	7432	1.12337894110648
GO:0010811	positive regulation of cell-substrate adhesion	 33	0.774610796030802	1	14	19	6710	7420	0.893596884971067
GO:0010812	negative regulation of cell-substrate adhesion	 14	0.529251719099727	1	7	7	6717	7432	1.05316775728733
GO:0010818	T cell chemotaxis	  8	1	1	0	8	6724	7431	0
GO:0010820	positive regulation of T cell chemotaxis	  5	0.77940058892516	1	2	3	6722	7436	0.842534205829863
GO:0010821	regulation of mitochondrion organization	 10	0.0390070262266277	0.625040317669623	8	2	6716	7437	1.68506841165973
GO:0010824	regulation of centrosome duplication	 16	0.517377397284026	1	8	8	6716	7431	1.05316775728733
GO:0010830	regulation of myotube differentiation	  5	0.452745275304033	1	3	2	6721	7437	1.26380130874479
GO:0010831	positive regulation of myotube differentiation	  8	0.309544448231027	1	5	3	6719	7436	1.31645969660916
GO:0010832	negative regulation of myotube differentiation	 11	0.665993939534306	1	5	6	6719	7433	0.957425233897572
GO:0010833	telomere maintenance via telomere lengthening	  5	0.452745275304033	1	3	2	6721	7437	1.26380130874479
GO:0010835	regulation of protein ADP-ribosylation	  5	0.77940058892516	1	2	3	6722	7436	0.842534205829863
GO:0010837	regulation of keratinocyte proliferation	  5	0.452745275304033	1	3	2	6721	7437	1.26380130874479
GO:0010838	positive regulation of keratinocyte proliferation	  5	1	1	0	5	6724	7434	0
GO:0010839	negative regulation of keratinocyte proliferation	 12	0.75380380293781	1	5	7	6719	7432	0.877639797739441
GO:0010842	retina layer formation	 17	0.243621618961318	1	10	7	6714	7432	1.23902089092627
GO:0010862	positive regulation of pathway-restricted SMAD protein phosphorylation	 37	0.953716857412494	1	13	24	6711	7415	0.74006382944515
GO:0010863	positive regulation of phospholipase C activity	  8	0.819878207576373	1	3	5	6721	7434	0.789875817965497
GO:0010867	positive regulation of triglyceride biosynthetic process	 10	0.983985908365184	1	2	8	6722	7431	0.421267102914932
GO:0010870	positive regulation of receptor biosynthetic process	  6	0.865182793759413	1	2	4	6722	7435	0.702111838191553
GO:0010873	positive regulation of cholesterol esterification	  7	0.98898631085553	1	1	6	6723	7433	0.300905073510665
GO:0010875	positive regulation of cholesterol efflux	 11	0.953160347938253	1	3	8	6721	7431	0.574455140338543
GO:0010880	regulation of release of sequestered calcium ion into cytosol by sarcoplasmic reticulum	 15	0.914031171019375	1	5	10	6719	7429	0.702111838191553
GO:0010881	regulation of cardiac muscle contraction by regulation of the release of sequestered calcium ion	 14	0.529251719099727	1	7	7	6717	7432	1.05316775728733
GO:0010882	regulation of cardiac muscle contraction by calcium ion signaling	  8	0.309544448231027	1	5	3	6719	7436	1.31645969660916
GO:0010884	positive regulation of lipid storage	  9	0.972243904416257	1	2	7	6722	7432	0.468074558794368
GO:0010886	positive regulation of cholesterol storage	  7	0.98898631085553	1	1	6	6723	7433	0.300905073510665
GO:0010887	negative regulation of cholesterol storage	  6	0.865182793759413	1	2	4	6722	7435	0.702111838191553
GO:0010888	negative regulation of lipid storage	  7	0.919244306193629	1	2	5	6722	7434	0.601810147021331
GO:0010890	positive regulation of sequestering of triglyceride	  5	0.452745275304033	1	3	2	6721	7437	1.26380130874479
GO:0010891	negative regulation of sequestering of triglyceride	  5	0.77940058892516	1	2	3	6722	7436	0.842534205829863
GO:0010894	negative regulation of steroid biosynthetic process	  5	0.77940058892516	1	2	3	6722	7436	0.842534205829863
GO:0010898	positive regulation of triglyceride catabolic process	  6	1	1	0	6	6724	7433	0
GO:0010906	regulation of glucose metabolic process	 20	0.497606676879603	1	10	10	6714	7429	1.05316775728733
GO:0010907	positive regulation of glucose metabolic process	  9	0.69404490204849	1	4	5	6720	7434	0.936149117588737
GO:0010917	negative regulation of mitochondrial membrane potential	  8	0.819878207576373	1	3	5	6721	7434	0.789875817965497
GO:0010918	positive regulation of mitochondrial membrane potential	  7	0.444912401367032	1	4	3	6720	7436	1.20362029404266
GO:0010923	negative regulation of phosphatase activity	 46	0.046951732367642	0.646585116783694	28	18	6696	7421	1.2821172697411
GO:0010940	positive regulation of necrotic cell death	  5	0.960049771736903	1	1	4	6723	7435	0.421267102914932
GO:0010941	regulation of cell death	  9	0.882794860340315	1	3	6	6721	7433	0.702111838191553
GO:0010942	positive regulation of cell death	 41	0.970273270415566	1	14	27	6710	7412	0.719236517171834
GO:0010944	negative regulation of transcription by competitive promoter binding	  8	0.952366339066048	1	2	6	6722	7433	0.526583878643665
GO:0010950	positive regulation of endopeptidase activity	  6	0.865182793759413	1	2	4	6722	7435	0.702111838191553
GO:0010951	negative regulation of endopeptidase activity	 87	0.99998296552435	1	23	64	6701	7375	0.556847319945024
GO:0010952	positive regulation of peptidase activity	 12	0.899474094191123	1	4	8	6720	7431	0.702111838191553
GO:0010954	positive regulation of protein processing	  8	0.994217735396885	1	1	7	6723	7432	0.263291939321832
GO:0010955	negative regulation of protein processing	 10	0.316545776550851	1	6	4	6718	7435	1.26380130874479
GO:0010960	magnesium ion homeostasis	  5	0.157494903089267	0.919686434773344	4	1	6720	7438	1.68506841165973
GO:0010961	cellular magnesium ion homeostasis	  5	0.77940058892516	1	2	3	6722	7436	0.842534205829863
GO:0010970	transport along microtubule	  5	0.452745275304033	1	3	2	6721	7437	1.26380130874479
GO:0010971	positive regulation of G2/M transition of mitotic cell cycle	 18	0.506938913103874	1	9	9	6715	7430	1.05316775728733
GO:0010972	negative regulation of G2/M transition of mitotic cell cycle	 51	0.358238602349744	1	26	25	6698	7414	1.07381810546943
GO:0010975	regulation of neuron projection development	 23	0.722173726826204	1	10	13	6714	7426	0.915798049815069
GO:0010976	positive regulation of neuron projection development	 91	0.182699658281465	0.949543953868825	48	43	6676	7396	1.11103411757784
GO:0010977	negative regulation of neuron projection development	 54	0.217071591623781	1	29	25	6695	7414	1.13118018375306
GO:0010996	response to auditory stimulus	  9	0.69404490204849	1	4	5	6720	7434	0.936149117588737
GO:0012501	programmed cell death	 21	0.25155850170495	1	12	9	6712	7430	1.20362029404266
GO:0012506	vesicle membrane	 24	0.481410334966146	1	12	12	6712	7427	1.05316775728733
GO:0012507	ER to Golgi transport vesicle membrane	 43	0.261542728893093	1	23	20	6701	7419	1.12664457756319
GO:0014002	astrocyte development	 13	0.426320358160906	1	7	6	6717	7433	1.13418066169405
GO:0014003	oligodendrocyte development	 25	0.912607021347774	1	9	16	6715	7423	0.758280785246877
GO:0014009	glial cell proliferation	  6	0.607836179256654	1	3	3	6721	7436	1.05316775728733
GO:0014029	neural crest formation	  7	0.187210848839696	0.949543953868825	5	2	6719	7437	1.50452536755333
GO:0014031	mesenchymal cell development	  6	0.607836179256654	1	3	3	6721	7436	1.05316775728733
GO:0014032	neural crest cell development	 21	0.407325414326014	1	11	10	6713	7429	1.10331860287244
GO:0014033	neural crest cell differentiation	  6	0.607836179256654	1	3	3	6721	7436	1.05316775728733
GO:0014037	Schwann cell differentiation	  7	0.444912401367032	1	4	3	6720	7436	1.20362029404266
GO:0014044	Schwann cell development	  9	0.206720270758876	0.983668097955673	6	3	6718	7436	1.40422367638311
GO:0014047	glutamate secretion	 28	0.000171149036525831	0.0869484492438879	23	5	6701	7434	1.73020417268633
GO:0014049	positive regulation of glutamate secretion	  6	0.607836179256654	1	3	3	6721	7436	1.05316775728733
GO:0014050	negative regulation of glutamate secretion	  5	0.77940058892516	1	2	3	6722	7436	0.842534205829863
GO:0014059	regulation of dopamine secretion	 10	0.133503266897558	0.919686434773344	7	3	6717	7436	1.47443486020226
GO:0014065	phosphatidylinositol 3-kinase signaling	 29	0.680253022221135	1	13	16	6711	7423	0.944219368602433
GO:0014066	regulation of phosphatidylinositol 3-kinase signaling	 67	0.939754067796892	1	26	41	6698	7398	0.817383931028972
GO:0014067	negative regulation of phosphatidylinositol 3-kinase signaling	 10	0.559603563591584	1	5	5	6719	7434	1.05316775728733
GO:0014068	positive regulation of phosphatidylinositol 3-kinase signaling	 62	0.935512187918153	1	24	38	6700	7401	0.815355683061158
GO:0014075	response to amine	  9	0.69404490204849	1	4	5	6720	7434	0.936149117588737
GO:0014701	junctional sarcoplasmic reticulum membrane	  8	0.580280354503036	1	4	4	6720	7435	1.05316775728733
GO:0014704	intercalated disc	 45	0.803783319763255	1	19	26	6705	7413	0.8893416617093
GO:0014731	spectrin-associated cytoskeleton	  7	0.730029012673872	1	3	4	6721	7435	0.902715220531996
GO:0014807	regulation of somitogenesis	  6	0.865182793759413	1	2	4	6722	7435	0.702111838191553
GO:0014808	release of sequestered calcium ion into cytosol by sarcoplasmic reticulum	  5	0.452745275304033	1	3	2	6721	7437	1.26380130874479
GO:0014823	response to activity	 34	0.586036077818074	1	16	18	6708	7421	0.991216712741015
GO:0014824	artery smooth muscle contraction	  7	0.919244306193629	1	2	5	6722	7434	0.601810147021331
GO:0014842	regulation of skeletal muscle satellite cell proliferation	  6	0.865182793759413	1	2	4	6722	7435	0.702111838191553
GO:0014850	response to muscle activity	 15	0.914031171019375	1	5	10	6719	7429	0.702111838191553
GO:0014883	transition between fast and slow fiber	  5	0.77940058892516	1	2	3	6722	7436	0.842534205829863
GO:0014894	response to denervation involved in regulation of muscle adaptation	 10	0.559603563591584	1	5	5	6719	7434	1.05316775728733
GO:0014898	cardiac muscle hypertrophy in response to stress	 10	0.559603563591584	1	5	5	6719	7434	1.05316775728733
GO:0014902	myotube differentiation	 11	0.953160347938253	1	3	8	6721	7431	0.574455140338543
GO:0014904	myotube cell development	  5	0.452745275304033	1	3	2	6721	7437	1.26380130874479
GO:0014909	smooth muscle cell migration	  9	0.69404490204849	1	4	5	6720	7434	0.936149117588737
GO:0014910	regulation of smooth muscle cell migration	  6	0.865182793759413	1	2	4	6722	7435	0.702111838191553
GO:0014911	positive regulation of smooth muscle cell migration	 17	0.776294265732228	1	7	10	6717	7429	0.867314623648389
GO:0014912	negative regulation of smooth muscle cell migration	 13	0.643122793005253	1	6	7	6718	7432	0.972154852880611
GO:0015012	heparan sulfate proteoglycan biosynthetic process	 14	0.875453509540804	1	5	9	6719	7430	0.752262683776664
GO:0015014	heparan sulfate proteoglycan biosynthetic process, polysaccharide chain biosynthetic process	  5	0.77940058892516	1	2	3	6722	7436	0.842534205829863
GO:0015020	glucuronosyltransferase activity	 10	0.925275888620553	1	3	7	6721	7432	0.631900654372397
GO:0015026	coreceptor activity	 25	0.99980131257979	1	4	21	6720	7418	0.337013682331945
GO:0015030	Cajal body	 47	0.0350149282652975	0.599479186247127	29	18	6695	7421	1.29965382814181
GO:0015035	protein disulfide oxidoreductase activity	 20	0.497606676879603	1	10	10	6714	7429	1.05316775728733
GO:0015036	disulfide oxidoreductase activity	  7	0.187210848839696	0.949543953868825	5	2	6719	7437	1.50452536755333
GO:0015037	peptide disulfide oxidoreductase activity	  8	0.819878207576373	1	3	5	6721	7434	0.789875817965497
GO:0015074	DNA integration	  9	0.438074670071218	1	5	4	6719	7435	1.17018639698592
GO:0015075	ion transmembrane transporter activity	 12	0.899474094191123	1	4	8	6720	7431	0.702111838191553
GO:0015078	hydrogen ion transmembrane transporter activity	 22	0.00018076600674405	0.0869484492438879	19	3	6705	7436	1.81910794440539
GO:0015095	magnesium ion transmembrane transporter activity	 16	0.170220385600338	0.949543953868825	10	6	6714	7433	1.31645969660916
GO:0015101	organic cation transmembrane transporter activity	  6	0.979023167332401	1	1	5	6723	7434	0.351055919095776
GO:0015106	bicarbonate transmembrane transporter activity	 11	0.665993939534306	1	5	6	6719	7433	0.957425233897572
GO:0015108	chloride transmembrane transporter activity	  7	0.730029012673872	1	3	4	6721	7435	0.902715220531996
GO:0015116	sulfate transmembrane transporter activity	  9	0.69404490204849	1	4	5	6720	7434	0.936149117588737
GO:0015125	bile acid transmembrane transporter activity	  5	0.77940058892516	1	2	3	6722	7436	0.842534205829863
GO:0015171	amino acid transmembrane transporter activity	 40	0.78463175079709	1	17	23	6707	7416	0.89519259369423
GO:0015174	basic amino acid transmembrane transporter activity	  6	0.979023167332401	1	1	5	6723	7434	0.351055919095776
GO:0015175	neutral amino acid transmembrane transporter activity	 11	0.953160347938253	1	3	8	6721	7431	0.574455140338543
GO:0015179	L-amino acid transmembrane transporter activity	  8	0.819878207576373	1	3	5	6721	7434	0.789875817965497
GO:0015180	L-alanine transmembrane transporter activity	  5	0.452745275304033	1	3	2	6721	7437	1.26380130874479
GO:0015186	L-glutamine transmembrane transporter activity	  5	0.452745275304033	1	3	2	6721	7437	1.26380130874479
GO:0015187	glycine transmembrane transporter activity	  6	0.607836179256654	1	3	3	6721	7436	1.05316775728733
GO:0015194	L-serine transmembrane transporter activity	  8	0.580280354503036	1	4	4	6720	7435	1.05316775728733
GO:0015217	ADP transmembrane transporter activity	  5	0.77940058892516	1	2	3	6722	7436	0.842534205829863
GO:0015232	heme transporter activity	  5	0.452745275304033	1	3	2	6721	7437	1.26380130874479
GO:0015238	drug transmembrane transporter activity	  5	0.77940058892516	1	2	3	6722	7436	0.842534205829863
GO:0015245	fatty acid transporter activity	  5	0.77940058892516	1	2	3	6722	7436	0.842534205829863
GO:0015248	sterol transporter activity	 12	0.148657926965624	0.919686434773344	8	4	6716	7435	1.40422367638311
GO:0015250	water channel activity	  8	1	1	0	8	6724	7431	0
GO:0015266	protein channel activity	 10	0.00700161837131091	0.354502993326374	9	1	6715	7438	1.89570196311719
GO:0015267	channel activity	 12	0.899474094191123	1	4	8	6720	7431	0.702111838191553
GO:0015269	calcium-activated potassium channel activity	 15	0.623867966210499	1	7	8	6717	7431	0.982956573468174
GO:0015271	outward rectifier potassium channel activity	  6	0.607836179256654	1	3	3	6721	7436	1.05316775728733
GO:0015276	ligand-gated ion channel activity	 28	0.987277242297062	1	8	20	6716	7419	0.601810147021331
GO:0015277	kainate selective glutamate receptor activity	  5	0.77940058892516	1	2	3	6722	7436	0.842534205829863
GO:0015278	calcium-release channel activity	 11	0.0838548499097086	0.807895728316903	8	3	6716	7436	1.53188037423611
GO:0015279	store-operated calcium channel activity	  6	0.865182793759413	1	2	4	6722	7435	0.702111838191553
GO:0015280	ligand-gated sodium channel activity	  7	0.730029012673872	1	3	4	6721	7435	0.902715220531996
GO:0015288	porin activity	  5	0.452745275304033	1	3	2	6721	7437	1.26380130874479
GO:0015293	symporter activity	 89	0.644886212562497	1	41	48	6683	7391	0.970334338174842
GO:0015297	antiporter activity	 43	0.983783642102038	1	14	29	6710	7410	0.685783655908028
GO:0015299	solute:proton antiporter activity	 10	0.78367246101976	1	4	6	6720	7433	0.842534205829863
GO:0015301	anion:anion antiporter activity	 16	0.94165410331218	1	5	11	6719	7428	0.658229848304581
GO:0015321	sodium-dependent phosphate transmembrane transporter activity	  5	0.452745275304033	1	3	2	6721	7437	1.26380130874479
GO:0015347	sodium-independent organic anion transmembrane transporter activity	 13	0.982330979346752	1	3	10	6721	7429	0.486077426440306
GO:0015377	cation:chloride symporter activity	  7	0.730029012673872	1	3	4	6721	7435	0.902715220531996
GO:0015379	potassium:chloride symporter activity	  6	0.865182793759413	1	2	4	6722	7435	0.702111838191553
GO:0015385	sodium:proton antiporter activity	  9	0.882794860340315	1	3	6	6721	7433	0.702111838191553
GO:0015386	potassium:proton antiporter activity	  8	0.819878207576373	1	3	5	6721	7434	0.789875817965497
GO:0015450	P-P-bond-hydrolysis-driven protein transmembrane transporter activity	  7	0.0474968970055936	0.646585116783694	6	1	6718	7438	1.80543044106399
GO:0015459	potassium channel regulator activity	 31	0.158221432536759	0.919686434773344	18	13	6706	7426	1.22303352459174
GO:0015464	acetylcholine receptor activity	  9	0.996964464269463	1	1	8	6723	7431	0.234037279397184
GO:0015467	G-protein activated inward rectifier potassium channel activity	 10	0.133503266897558	0.919686434773344	7	3	6717	7436	1.47443486020226
GO:0015485	cholesterol binding	 36	0.444708914602519	1	18	18	6706	7421	1.05316775728733
GO:0015631	tubulin binding	 45	0.00111643920418612	0.165233002219546	32	13	6692	7426	1.49783858814198
GO:0015643	toxic substance binding	  8	0.819878207576373	1	3	5	6721	7434	0.789875817965497
GO:0015671	oxygen transport	  8	0.994217735396885	1	1	7	6723	7432	0.263291939321832
GO:0015677	copper ion import	  6	0.607836179256654	1	3	3	6721	7436	1.05316775728733
GO:0015693	magnesium ion transport	 12	0.320810094151237	1	7	5	6717	7434	1.22869571683522
GO:0015695	organic cation transport	 12	0.994792086314609	1	2	10	6722	7429	0.351055919095776
GO:0015696	ammonium transport	  5	0.960049771736903	1	1	4	6723	7435	0.421267102914932
GO:0015698	inorganic anion transport	 16	0.94165410331218	1	5	11	6719	7428	0.658229848304581
GO:0015701	bicarbonate transport	 33	0.774610796030802	1	14	19	6710	7420	0.893596884971067
GO:0015711	organic anion transport	 16	0.853260719975205	1	6	10	6718	7429	0.789875817965497
GO:0015718	monocarboxylic acid transport	 13	0.426320358160906	1	7	6	6717	7433	1.13418066169405
GO:0015721	bile acid and bile salt transport	 17	0.776294265732228	1	7	10	6717	7429	0.867314623648389
GO:0015758	glucose transport	 22	0.984480450070456	1	6	16	6718	7423	0.574455140338543
GO:0015760	glucose-6-phosphate transport	  5	0.77940058892516	1	2	3	6722	7436	0.842534205829863
GO:0015804	neutral amino acid transport	 11	0.850917330440019	1	4	7	6720	7432	0.765940187118057
GO:0015807	L-amino acid transport	  7	0.919244306193629	1	2	5	6722	7434	0.601810147021331
GO:0015808	L-alanine transport	  5	0.452745275304033	1	3	2	6721	7437	1.26380130874479
GO:0015812	gamma-aminobutyric acid transport	  5	0.157494903089267	0.919686434773344	4	1	6720	7438	1.68506841165973
GO:0015813	L-glutamate transport	 10	0.00700161837131091	0.354502993326374	9	1	6715	7438	1.89570196311719
GO:0015816	glycine transport	  7	0.730029012673872	1	3	4	6721	7435	0.902715220531996
GO:0015824	proline transport	  7	0.187210848839696	0.949543953868825	5	2	6719	7437	1.50452536755333
GO:0015825	L-serine transport	  8	0.580280354503036	1	4	4	6720	7435	1.05316775728733
GO:0015833	peptide transport	  9	0.69404490204849	1	4	5	6720	7434	0.936149117588737
GO:0015844	monoamine transport	  5	0.77940058892516	1	2	3	6722	7436	0.842534205829863
GO:0015866	ADP transport	  8	0.580280354503036	1	4	4	6720	7435	1.05316775728733
GO:0015867	ATP transport	 10	0.559603563591584	1	5	5	6719	7434	1.05316775728733
GO:0015871	choline transport	  6	0.297654371351411	1	4	2	6720	7437	1.40422367638311
GO:0015872	dopamine transport	  5	0.77940058892516	1	2	3	6722	7436	0.842534205829863
GO:0015884	folic acid transport	  5	0.960049771736903	1	1	4	6723	7435	0.421267102914932
GO:0015886	heme transport	  5	0.452745275304033	1	3	2	6721	7437	1.26380130874479
GO:0015889	cobalamin transport	  6	0.865182793759413	1	2	4	6722	7435	0.702111838191553
GO:0015908	fatty acid transport	 14	0.323388997222084	1	8	6	6716	7433	1.20362029404266
GO:0015909	long-chain fatty acid transport	 10	0.78367246101976	1	4	6	6720	7433	0.842534205829863
GO:0015914	phospholipid transport	 37	0.261641792098177	1	20	17	6704	7422	1.13855973760792
GO:0015918	sterol transport	  9	0.206720270758876	0.983668097955673	6	3	6718	7436	1.40422367638311
GO:0015934	large ribosomal subunit	  8	0.952366339066048	1	2	6	6722	7433	0.526583878643665
GO:0015935	small ribosomal subunit	 15	0.237875362689918	1	9	6	6715	7433	1.26380130874479
GO:0015937	coenzyme A biosynthetic process	 10	0.316545776550851	1	6	4	6718	7435	1.26380130874479
GO:0015939	pantothenate metabolic process	  7	0.444912401367032	1	4	3	6720	7436	1.20362029404266
GO:0015949	nucleobase-containing small molecule interconversion	 25	0.70711219518503	1	11	14	6713	7425	0.926787626412849
GO:0015986	ATP synthesis coupled proton transport	 16	0.00109699223009629	0.165233002219546	14	2	6710	7437	1.84304357525283
GO:0015991	ATP hydrolysis coupled proton transport	 23	0.00925520247229722	0.417351786485153	17	6	6707	7433	1.55685668468562
GO:0015992	proton transport	 68	0.00140997316227469	0.193770597444035	45	23	6679	7416	1.39389850229205
GO:0016010	dystrophin-associated glycoprotein complex	 14	0.529251719099727	1	7	7	6717	7432	1.05316775728733
GO:0016015	morphogen activity	  7	0.919244306193629	1	2	5	6722	7434	0.601810147021331
GO:0016018	cyclosporin A binding	 10	0.00700161837131091	0.354502993326374	9	1	6715	7438	1.89570196311719
GO:0016024	CDP-diacylglycerol biosynthetic process	 11	0.0838548499097086	0.807895728316903	8	3	6716	7436	1.53188037423611
GO:0016042	lipid catabolic process	 86	0.993347642941571	1	30	56	6694	7383	0.734768202758602
GO:0016043	cellular component organization	  9	0.438074670071218	1	5	4	6719	7435	1.17018639698592
GO:0016045	detection of bacterium	  7	1	1	0	7	6724	7432	0
GO:0016049	cell growth	 49	0.914515497881174	1	19	30	6705	7409	0.816742342386092
GO:0016050	vesicle organization	 21	0.407325414326014	1	11	10	6713	7429	1.10331860287244
GO:0016051	carbohydrate biosynthetic process	  7	0.444912401367032	1	4	3	6720	7436	1.20362029404266
GO:0016056	rhodopsin mediated signaling pathway	 10	0.998406526036605	1	1	9	6723	7430	0.210633551457466
GO:0016064	immunoglobulin mediated immune response	 11	0.953160347938253	1	3	8	6721	7431	0.574455140338543
GO:0016070	RNA metabolic process	 43	0.0148844861525285	0.466919859089101	28	15	6696	7424	1.37156731181606
GO:0016075	rRNA catabolic process	  9	0.438074670071218	1	5	4	6719	7435	1.17018639698592
GO:0016079	synaptic vesicle exocytosis	 20	0.000604341949448324	0.129194878970953	17	3	6707	7436	1.79038518738846
GO:0016081	synaptic vesicle docking	  8	0.025392299605826	0.495149842313607	7	1	6717	7438	1.84304357525283
GO:0016082	synaptic vesicle priming	  9	0.206720270758876	0.983668097955673	6	3	6718	7436	1.40422367638311
GO:0016101	diterpenoid metabolic process	  5	0.157494903089267	0.919686434773344	4	1	6720	7438	1.68506841165973
GO:0016125	sterol metabolic process	 15	0.237875362689918	1	9	6	6715	7433	1.26380130874479
GO:0016126	sterol biosynthetic process	 29	0.0387440161098984	0.625040317669623	19	10	6705	7429	1.38001292334202
GO:0016139	glycoside catabolic process	  5	0.960049771736903	1	1	4	6723	7435	0.421267102914932
GO:0016175	superoxide-generating NADPH oxidase activity	  6	1	1	0	6	6724	7433	0
GO:0016176	superoxide-generating NADPH oxidase activator activity	  6	0.979023167332401	1	1	5	6723	7434	0.351055919095776
GO:0016180	snRNA processing	 12	0.148657926965624	0.919686434773344	8	4	6716	7435	1.40422367638311
GO:0016188	synaptic vesicle maturation	  8	0.309544448231027	1	5	3	6719	7436	1.31645969660916
GO:0016191	synaptic vesicle uncoating	  5	0.452745275304033	1	3	2	6721	7437	1.26380130874479
GO:0016197	endosomal transport	 57	0.012317207846393	0.427208830906354	36	21	6688	7418	1.33031716709978
GO:0016199	axon midline choice point recognition	  5	0.77940058892516	1	2	3	6722	7436	0.842534205829863
GO:0016208	AMP binding	 10	0.559603563591584	1	5	5	6719	7434	1.05316775728733
GO:0016209	antioxidant activity	 24	0.882377293683992	1	9	15	6715	7424	0.789875817965497
GO:0016226	iron-sulfur cluster assembly	 13	0.0975861781940815	0.843214701401555	9	4	6715	7435	1.45823227932092
GO:0016233	telomere capping	 14	0.728526098434397	1	6	8	6718	7431	0.902715220531996
GO:0016234	inclusion body	 19	0.127144513269886	0.919686434773344	12	7	6712	7432	1.33031716709978
GO:0016235	aggresome	 32	0.321021215389182	1	17	15	6707	7424	1.11899074211779
GO:0016236	macroautophagy	 86	0.010358649923496	0.427208830906354	52	34	6672	7405	1.27359821811491
GO:0016239	positive regulation of macroautophagy	 25	0.399232431223553	1	13	12	6711	7427	1.09529446757882
GO:0016241	regulation of macroautophagy	 66	0.00053177700734818	0.129194878970953	45	21	6679	7418	1.43613785084636
GO:0016242	negative regulation of macroautophagy	 12	0.320810094151237	1	7	5	6717	7434	1.22869571683522
GO:0016247	channel regulator activity	  7	0.730029012673872	1	3	4	6721	7435	0.902715220531996
GO:0016254	preassembly of GPI anchor in ER membrane	 15	0.623867966210499	1	7	8	6717	7431	0.982956573468174
GO:0016255	attachment of GPI anchor to protein	  7	0.0474968970055936	0.646585116783694	6	1	6718	7438	1.80543044106399
GO:0016264	gap junction assembly	  8	0.580280354503036	1	4	4	6720	7435	1.05316775728733
GO:0016266	O-glycan processing	 48	0.998832295836902	1	13	35	6711	7404	0.570465868530637
GO:0016272	prefoldin complex	  6	0.607836179256654	1	3	3	6721	7436	1.05316775728733
GO:0016274	protein-arginine N-methyltransferase activity	  9	0.206720270758876	0.983668097955673	6	3	6718	7436	1.40422367638311
GO:0016279	protein-lysine N-methyltransferase activity	 16	0.706693964264422	1	7	9	6717	7430	0.921521787626413
GO:0016282	eukaryotic 43S preinitiation complex	  7	0.187210848839696	0.949543953868825	5	2	6719	7437	1.50452536755333
GO:0016290	palmitoyl-CoA hydrolase activity	  7	0.187210848839696	0.949543953868825	5	2	6719	7437	1.50452536755333
GO:0016298	lipase activity	  7	0.444912401367032	1	4	3	6720	7436	1.20362029404266
GO:0016303	1-phosphatidylinositol-3-kinase activity	 33	0.774610796030802	1	14	19	6710	7420	0.893596884971067
GO:0016307	phosphatidylinositol phosphate kinase activity	  8	0.580280354503036	1	4	4	6720	7435	1.05316775728733
GO:0016308	1-phosphatidylinositol-4-phosphate 5-kinase activity	  7	0.730029012673872	1	3	4	6721	7435	0.902715220531996
GO:0016322	neuron remodeling	  9	0.438074670071218	1	5	4	6719	7435	1.17018639698592
GO:0016327	apicolateral plasma membrane	 14	0.98932697223781	1	3	11	6721	7428	0.451357610265998
GO:0016328	lateral plasma membrane	 46	0.754808097501554	1	20	26	6704	7413	0.915798049815069
GO:0016331	morphogenesis of embryonic epithelium	 11	0.953160347938253	1	3	8	6721	7431	0.574455140338543
GO:0016338	calcium-independent cell-cell adhesion via plasma membrane cell-adhesion molecules	 13	0.999769586887007	1	1	12	6723	7427	0.162025808813435
GO:0016339	calcium-dependent cell-cell adhesion via plasma membrane cell adhesion molecules	 20	0.9653537478209	1	6	14	6718	7425	0.631900654372397
GO:0016342	catenin complex	  9	0.882794860340315	1	3	6	6721	7433	0.702111838191553
GO:0016358	dendrite development	 29	0.800246571563356	1	12	17	6712	7422	0.871587109479169
GO:0016363	nuclear matrix	 88	0.00317473084484755	0.258092203330423	55	33	6669	7406	1.31645969660916
GO:0016407	acetyltransferase activity	 14	0.323388997222084	1	8	6	6716	7433	1.20362029404266
GO:0016409	palmitoyltransferase activity	 18	0.325568860476231	1	10	8	6714	7431	1.17018639698592
GO:0016442	RISC complex	 10	0.133503266897558	0.919686434773344	7	3	6717	7436	1.47443486020226
GO:0016446	somatic hypermutation of immunoglobulin genes	  8	0.580280354503036	1	4	4	6720	7435	1.05316775728733
GO:0016447	somatic recombination of immunoglobulin gene segments	  5	0.77940058892516	1	2	3	6722	7436	0.842534205829863
GO:0016458	gene silencing	  7	0.919244306193629	1	2	5	6722	7434	0.601810147021331
GO:0016459	myosin complex	 38	0.965462586721693	1	13	25	6711	7414	0.720588465512383
GO:0016460	myosin II complex	  6	0.607836179256654	1	3	3	6721	7436	1.05316775728733
GO:0016461	unconventional myosin complex	  6	0.607836179256654	1	3	3	6721	7436	1.05316775728733
GO:0016462	pyrophosphatase activity	  8	0.580280354503036	1	4	4	6720	7435	1.05316775728733
GO:0016469	proton-transporting two-sector ATPase complex	  5	0.0241003244622537	0.495149842313607	5	0	6719	7439	2.10633551457466
GO:0016471	vacuolar proton-transporting V-type ATPase complex	 11	0.0838548499097086	0.807895728316903	8	3	6716	7436	1.53188037423611
GO:0016485	protein processing	 48	0.141294868930829	0.919686434773344	27	21	6697	7418	1.18481372694825
GO:0016486	peptide hormone processing	 15	0.914031171019375	1	5	10	6719	7429	0.702111838191553
GO:0016493	C-C chemokine receptor activity	  8	0.819878207576373	1	3	5	6721	7434	0.789875817965497
GO:0016494	C-X-C chemokine receptor activity	  7	1	1	0	7	6724	7432	0
GO:0016504	peptidase activator activity	 10	0.78367246101976	1	4	6	6720	7433	0.842534205829863
GO:0016514	SWI/SNF complex	 14	0.529251719099727	1	7	7	6717	7432	1.05316775728733
GO:0016525	negative regulation of angiogenesis	 56	0.99318224538914	1	18	38	6706	7401	0.677036415398997
GO:0016528	sarcoplasm	  8	0.309544448231027	1	5	3	6719	7436	1.31645969660916
GO:0016529	sarcoplasmic reticulum	 48	0.141294868930829	0.919686434773344	27	21	6697	7418	1.18481372694825
GO:0016538	cyclin-dependent protein serine/threonine kinase regulator activity	 13	0.0975861781940815	0.843214701401555	9	4	6715	7435	1.45823227932092
GO:0016540	protein autoprocessing	 11	0.850917330440019	1	4	7	6720	7432	0.765940187118057
GO:0016558	protein import into peroxisome matrix	  9	0.69404490204849	1	4	5	6720	7434	0.936149117588737
GO:0016559	peroxisome fission	  9	0.206720270758876	0.983668097955673	6	3	6718	7436	1.40422367638311
GO:0016570	histone modification	  9	0.972243904416257	1	2	7	6722	7432	0.468074558794368
GO:0016571	histone methylation	 17	0.118839522247653	0.899006189270582	11	6	6713	7433	1.3629229800189
GO:0016572	histone phosphorylation	  8	0.952366339066048	1	2	6	6722	7433	0.526583878643665
GO:0016573	histone acetylation	 33	0.522004835191274	1	16	17	6708	7422	1.02125358282408
GO:0016574	histone ubiquitination	  8	0.819878207576373	1	3	5	6721	7434	0.789875817965497
GO:0016575	histone deacetylation	 48	0.216081229449964	1	26	22	6698	7417	1.14093173706127
GO:0016576	histone dephosphorylation	  6	0.607836179256654	1	3	3	6721	7436	1.05316775728733
GO:0016578	histone deubiquitination	 12	0.148657926965624	0.919686434773344	8	4	6716	7435	1.40422367638311
GO:0016580	Sin3 complex	 12	0.148657926965624	0.919686434773344	8	4	6716	7435	1.40422367638311
GO:0016581	NuRD complex	 16	0.324860333233664	1	9	7	6715	7432	1.18481372694825
GO:0016584	nucleosome positioning	  7	0.919244306193629	1	2	5	6722	7434	0.601810147021331
GO:0016589	NURF complex	  6	0.297654371351411	1	4	2	6720	7437	1.40422367638311
GO:0016591	DNA-directed RNA polymerase II, holoenzyme	  7	0.187210848839696	0.949543953868825	5	2	6719	7437	1.50452536755333
GO:0016592	mediator complex	 34	0.0140542082563776	0.453189329920734	23	11	6701	7428	1.42487402456521
GO:0016593	Cdc73/Paf1 complex	  8	0.952366339066048	1	2	6	6722	7433	0.526583878643665
GO:0016594	glycine binding	 11	0.665993939534306	1	5	6	6719	7433	0.957425233897572
GO:0016595	glutamate binding	  9	0.206720270758876	0.983668097955673	6	3	6718	7436	1.40422367638311
GO:0016597	amino acid binding	 15	0.623867966210499	1	7	8	6717	7431	0.982956573468174
GO:0016600	flotillin complex	  7	0.187210848839696	0.949543953868825	5	2	6719	7437	1.50452536755333
GO:0016601	Rac protein signal transduction	 19	0.411669949440149	1	10	9	6714	7430	1.10859763924982
GO:0016605	PML body	 87	0.0387968183573539	0.625040317669623	50	37	6674	7402	1.2105376520544
GO:0016614	oxidoreductase activity, acting on CH-OH group of donors	  8	0.580280354503036	1	4	4	6720	7435	1.05316775728733
GO:0016616	oxidoreductase activity, acting on the CH-OH group of donors, NAD or NADP as acceptor	 25	0.557266861497771	1	12	13	6712	7426	1.01104104699584
GO:0016627	oxidoreductase activity, acting on the CH-CH group of donors	 20	0.325733222000695	1	11	9	6713	7430	1.15848453301606
GO:0016628	oxidoreductase activity, acting on the CH-CH group of donors, NAD or NADP as acceptor	  6	0.0874151689581943	0.807895728316903	5	1	6719	7438	1.75527959547888
GO:0016641	oxidoreductase activity, acting on the CH-NH2 group of donors, oxygen as acceptor	  5	0.960049771736903	1	1	4	6723	7435	0.421267102914932
GO:0016651	oxidoreductase activity, acting on NAD(P)H	 11	0.0838548499097086	0.807895728316903	8	3	6716	7436	1.53188037423611
GO:0016655	oxidoreductase activity, acting on NAD(P)H, quinone or similar compound as acceptor	  6	0.865182793759413	1	2	4	6722	7435	0.702111838191553
GO:0016671	oxidoreductase activity, acting on a sulfur group of donors, disulfide as acceptor	  9	0.438074670071218	1	5	4	6719	7435	1.17018639698592
GO:0016702	oxidoreductase activity, acting on single donors with incorporation of molecular oxygen, incorporation of two atoms of oxygen	 13	0.997057742126947	1	2	11	6722	7428	0.32405161762687
GO:0016705	oxidoreductase activity, acting on paired donors, with incorporation or reduction of molecular oxygen	 49	0.914515497881174	1	19	30	6705	7409	0.816742342386092
GO:0016706	oxidoreductase activity, acting on paired donors, with incorporation or reduction of molecular oxygen, 2-oxoglutarate as one donor, and incorporation of one atom each of oxygen into both donors	 19	0.756503853067433	1	8	11	6716	7428	0.886878111399856
GO:0016709	oxidoreductase activity, acting on paired donors, with incorporation or reduction of molecular oxygen, NAD(P)H as one donor, and incorporation of one atom of oxygen	 10	0.0390070262266277	0.625040317669623	8	2	6716	7437	1.68506841165973
GO:0016712	oxidoreductase activity, acting on paired donors, with incorporation or reduction of molecular oxygen, reduced flavin or flavoprotein as one donor, and incorporation of one atom of oxygen	 12	0.899474094191123	1	4	8	6720	7431	0.702111838191553
GO:0016747	transferase activity, transferring acyl groups other than amino-acyl groups	 16	0.0242540767935066	0.495149842313607	12	4	6712	7435	1.57975163593099
GO:0016758	transferase activity, transferring hexosyl groups	 15	0.623867966210499	1	7	8	6717	7431	0.982956573468174
GO:0016763	transferase activity, transferring pentosyl groups	  6	0.865182793759413	1	2	4	6722	7435	0.702111838191553
GO:0016765	transferase activity, transferring alkyl or aryl (other than methyl) groups	  5	0.77940058892516	1	2	3	6722	7436	0.842534205829863
GO:0016772	transferase activity, transferring phosphorus-containing groups	 10	0.316545776550851	1	6	4	6718	7435	1.26380130874479
GO:0016773	phosphotransferase activity, alcohol group as acceptor	 18	0.974269347793119	1	5	13	6719	7426	0.585093198492961
GO:0016779	nucleotidyltransferase activity	 71	0.0838450456908249	0.807895728316903	40	31	6684	7408	1.18666789553502
GO:0016780	phosphotransferase activity, for other substituted phosphate groups	  7	0.444912401367032	1	4	3	6720	7436	1.20362029404266
GO:0016783	sulfurtransferase activity	  5	0.452745275304033	1	3	2	6721	7437	1.26380130874479
GO:0016788	hydrolase activity, acting on ester bonds	 24	0.10185657048721	0.868413773784606	15	9	6709	7430	1.31645969660916
GO:0016790	thiolester hydrolase activity	  5	0.77940058892516	1	2	3	6722	7436	0.842534205829863
GO:0016798	hydrolase activity, acting on glycosyl bonds	 70	0.473699071768718	1	34	36	6690	7403	1.02307724993626
GO:0016799	hydrolase activity, hydrolyzing N-glycosyl compounds	  5	0.157494903089267	0.919686434773344	4	1	6720	7438	1.68506841165973
GO:0016805	dipeptidase activity	 12	0.148657926965624	0.919686434773344	8	4	6716	7435	1.40422367638311
GO:0016810	hydrolase activity, acting on carbon-nitrogen (but not peptide) bonds	 17	0.416253886790052	1	9	8	6715	7431	1.11511880183364
GO:0016811	hydrolase activity, acting on carbon-nitrogen (but not peptide) bonds, in linear amides	  9	0.882794860340315	1	3	6	6721	7433	0.702111838191553
GO:0016817	hydrolase activity, acting on acid anhydrides	  8	0.309544448231027	1	5	3	6719	7436	1.31645969660916
GO:0016818	hydrolase activity, acting on acid anhydrides, in phosphorus-containing anhydrides	 10	0.559603563591584	1	5	5	6719	7434	1.05316775728733
GO:0016820	hydrolase activity, acting on acid anhydrides, catalyzing transmembrane movement of substances	  5	0.157494903089267	0.919686434773344	4	1	6720	7438	1.68506841165973
GO:0016831	carboxy-lyase activity	 18	0.974269347793119	1	5	13	6719	7426	0.585093198492961
GO:0016849	phosphorus-oxygen lyase activity	 18	0.993133250054207	1	4	14	6720	7425	0.468074558794368
GO:0016868	intramolecular transferase activity, phosphotransferases	  7	0.444912401367032	1	4	3	6720	7436	1.20362029404266
GO:0016876	ligase activity, forming aminoacyl-tRNA and related compounds	  7	0.444912401367032	1	4	3	6720	7436	1.20362029404266
GO:0016918	retinal binding	 10	0.925275888620553	1	3	7	6721	7432	0.631900654372397
GO:0016922	ligand-dependent nuclear receptor binding	 18	0.0300950583180779	0.549711001936538	13	5	6711	7434	1.5212423160817
GO:0016925	protein sumoylation	 68	0.102126992444143	0.869435103816509	38	30	6686	7409	1.17706984637996
GO:0016926	protein desumoylation	  6	0.297654371351411	1	4	2	6720	7437	1.40422367638311
GO:0016929	SUMO-specific protease activity	  5	0.452745275304033	1	3	2	6721	7437	1.26380130874479
GO:0016973	poly(A)+ mRNA export from nucleus	 10	0.316545776550851	1	6	4	6718	7435	1.26380130874479
GO:0016998	cell wall macromolecule catabolic process	  6	1	1	0	6	6724	7433	0
GO:0017015	regulation of transforming growth factor beta receptor signaling pathway	 18	0.687525801418504	1	8	10	6716	7429	0.936149117588737
GO:0017016	Ras GTPase binding	 15	0.421118865258844	1	8	7	6716	7432	1.12337894110648
GO:0017017	MAP kinase tyrosine/serine/threonine phosphatase activity	 12	0.5430601307694	1	6	6	6718	7433	1.05316775728733
GO:0017022	myosin binding	 19	0.756503853067433	1	8	11	6716	7428	0.886878111399856
GO:0017025	TBP-class protein binding	 22	0.655120963592744	1	10	12	6714	7427	0.957425233897572
GO:0017034	Rap guanyl-nucleotide exchange factor activity	  5	0.77940058892516	1	2	3	6722	7436	0.842534205829863
GO:0017038	protein import	  5	0.77940058892516	1	2	3	6722	7436	0.842534205829863
GO:0017046	peptide hormone binding	 17	0.988941271773965	1	4	13	6720	7426	0.495608356370508
GO:0017048	Rho GTPase binding	 32	0.321021215389182	1	17	15	6707	7424	1.11899074211779
GO:0017049	GTP-Rho binding	 16	0.324860333233664	1	9	7	6715	7432	1.18481372694825
GO:0017053	transcriptional repressor complex	 51	0.114258683446597	0.885236403830546	29	22	6695	7417	1.19772019456206
GO:0017056	structural constituent of nuclear pore	 19	0.411669949440149	1	10	9	6714	7430	1.10859763924982
GO:0017059	serine C-palmitoyltransferase complex	  5	0.77940058892516	1	2	3	6722	7436	0.842534205829863
GO:0017069	snRNA binding	  8	0.580280354503036	1	4	4	6720	7435	1.05316775728733
GO:0017070	U6 snRNA binding	 10	0.925275888620553	1	3	7	6721	7432	0.631900654372397
GO:0017075	syntaxin-1 binding	 18	0.178063825749389	0.949543953868825	11	7	6713	7432	1.28720503668451
GO:0017080	sodium channel regulator activity	 26	0.198303125650341	0.983668097955673	15	11	6709	7428	1.21519356610076
GO:0017081	chloride channel regulator activity	  7	0.730029012673872	1	3	4	6721	7435	0.902715220531996
GO:0017091	AU-rich element binding	 16	0.324860333233664	1	9	7	6715	7432	1.18481372694825
GO:0017101	aminoacyl-tRNA synthetase multienzyme complex	 11	0.0838548499097086	0.807895728316903	8	3	6716	7436	1.53188037423611
GO:0017110	nucleoside-diphosphatase activity	  8	0.819878207576373	1	3	5	6721	7434	0.789875817965497
GO:0017111	nucleoside-triphosphatase activity	  9	0.438074670071218	1	5	4	6719	7435	1.17018639698592
GO:0017112	Rab guanyl-nucleotide exchange factor activity	 48	0.0862724562776354	0.807895728316903	28	20	6696	7419	1.22869571683522
GO:0017119	Golgi transport complex	 12	0.320810094151237	1	7	5	6717	7434	1.22869571683522
GO:0017127	cholesterol transporter activity	 13	0.982330979346752	1	3	10	6721	7429	0.486077426440306
GO:0017128	phospholipid scramblase activity	  7	0.730029012673872	1	3	4	6721	7435	0.902715220531996
GO:0017134	fibroblast growth factor binding	 18	0.325568860476231	1	10	8	6714	7431	1.17018639698592
GO:0017144	drug metabolic process	 16	0.517377397284026	1	8	8	6716	7431	1.05316775728733
GO:0017145	stem cell division	  5	0.0241003244622537	0.495149842313607	5	0	6719	7439	2.10633551457466
GO:0017146	NMDA selective glutamate receptor complex	  9	0.882794860340315	1	3	6	6721	7433	0.702111838191553
GO:0017147	Wnt-protein binding	 28	0.925771692110364	1	10	18	6714	7421	0.752262683776664
GO:0017148	negative regulation of translation	 61	0.0464170241890774	0.646585116783694	36	25	6688	7414	1.24308325450308
GO:0017151	DEAD/H-box RNA helicase binding	  7	0.00542743198931091	0.334473021939644	7	0	6717	7439	2.10633551457466
GO:0017154	semaphorin receptor activity	 11	0.665993939534306	1	5	6	6719	7433	0.957425233897572
GO:0017156	calcium ion regulated exocytosis	 14	0.323388997222084	1	8	6	6716	7433	1.20362029404266
GO:0017157	regulation of exocytosis	 32	0.000389040039453431	0.129194878970953	25	7	6699	7432	1.64557462076145
GO:0017158	regulation of calcium ion-dependent exocytosis	 18	0.178063825749389	0.949543953868825	11	7	6713	7432	1.28720503668451
GO:0017160	Ral GTPase binding	 12	0.5430601307694	1	6	6	6718	7433	1.05316775728733
GO:0017162	aryl hydrocarbon receptor binding	  9	0.882794860340315	1	3	6	6721	7433	0.702111838191553
GO:0017166	vinculin binding	 10	0.559603563591584	1	5	5	6719	7434	1.05316775728733
GO:0017176	phosphatidylinositol N-acetylglucosaminyltransferase activity	  5	0.960049771736903	1	1	4	6723	7435	0.421267102914932
GO:0017183	peptidyl-diphthamide biosynthetic process from peptidyl-histidine	  7	0.919244306193629	1	2	5	6722	7434	0.601810147021331
GO:0017185	peptidyl-lysine hydroxylation	  5	0.157494903089267	0.919686434773344	4	1	6720	7438	1.68506841165973
GO:0017187	peptidyl-glutamic acid carboxylation	  8	0.994217735396885	1	1	7	6723	7432	0.263291939321832
GO:0017196	N-terminal peptidyl-methionine acetylation	  6	0.607836179256654	1	3	3	6721	7436	1.05316775728733
GO:0018022	peptidyl-lysine methylation	 11	0.850917330440019	1	4	7	6720	7432	0.765940187118057
GO:0018023	peptidyl-lysine trimethylation	  5	0.452745275304033	1	3	2	6721	7437	1.26380130874479
GO:0018024	histone-lysine N-methyltransferase activity	 36	0.0157975510434834	0.485018428845672	24	12	6700	7427	1.40422367638311
GO:0018026	peptidyl-lysine monomethylation	  6	0.297654371351411	1	4	2	6720	7437	1.40422367638311
GO:0018095	protein polyglutamylation	  9	0.067355898427907	0.780679208284898	7	2	6717	7437	1.63826095578029
GO:0018107	peptidyl-threonine phosphorylation	 63	0.00754263964913917	0.365849714746482	40	23	6684	7416	1.33735588226962
GO:0018146	keratan sulfate biosynthetic process	 26	0.868518735159201	1	10	16	6714	7423	0.810129044067176
GO:0018149	peptide cross-linking	 27	0.999991347289097	1	3	24	6721	7415	0.234037279397184
GO:0018230	peptidyl-L-cysteine S-palmitoylation	  6	0.0874151689581943	0.807895728316903	5	1	6719	7438	1.75527959547888
GO:0018279	protein N-linked glycosylation via asparagine	 41	0.170912593352478	0.949543953868825	23	18	6701	7421	1.18160284963944
GO:0018298	protein-chromophore linkage	  7	0.730029012673872	1	3	4	6721	7435	0.902715220531996
GO:0018344	protein geranylgeranylation	  6	0.297654371351411	1	4	2	6720	7437	1.40422367638311
GO:0018345	protein palmitoylation	 19	0.411669949440149	1	10	9	6714	7430	1.10859763924982
GO:0018406	protein C-linked glycosylation via 2	  5	0.157494903089267	0.919686434773344	4	1	6720	7438	1.68506841165973
GO:0019001	guanyl nucleotide binding	 15	0.623867966210499	1	7	8	6717	7431	0.982956573468174
GO:0019003	GDP binding	 57	0.012317207846393	0.427208830906354	36	21	6688	7418	1.33031716709978
GO:0019005	SCF ubiquitin ligase complex	 43	0.369309686584353	1	22	21	6702	7418	1.07766003071262
GO:0019013	viral nucleocapsid	 18	0.00881923479062879	0.410349233027118	14	4	6710	7435	1.63826095578029
GO:0019048	modulation by virus of host morphology or physiology	  7	0.730029012673872	1	3	4	6721	7435	0.902715220531996
GO:0019054	modulation by virus of host process	  5	0.452745275304033	1	3	2	6721	7437	1.26380130874479
GO:0019058	viral life cycle	 26	0.474259103737385	1	13	13	6711	7426	1.05316775728733
GO:0019064	fusion of virus membrane with host plasma membrane	  6	0.865182793759413	1	2	4	6722	7435	0.702111838191553
GO:0019068	virion assembly	  8	0.819878207576373	1	3	5	6721	7434	0.789875817965497
GO:0019076	viral release from host cell	  5	0.77940058892516	1	2	3	6722	7436	0.842534205829863
GO:0019079	viral genome replication	 14	0.323388997222084	1	8	6	6716	7433	1.20362029404266
GO:0019083	viral transcription	 64	0.217093769480669	1	34	30	6690	7409	1.11899074211779
GO:0019104	DNA N-glycosylase activity	  8	0.00257530804409448	0.243683246401858	8	0	6716	7439	2.10633551457466
GO:0019205	nucleobase-containing compound kinase activity	  7	0.730029012673872	1	3	4	6721	7435	0.902715220531996
GO:0019206	nucleoside kinase activity	  9	0.69404490204849	1	4	5	6720	7434	0.936149117588737
GO:0019208	phosphatase regulator activity	  6	0.607836179256654	1	3	3	6721	7436	1.05316775728733
GO:0019209	kinase activator activity	  6	0.297654371351411	1	4	2	6720	7437	1.40422367638311
GO:0019210	kinase inhibitor activity	  5	0.77940058892516	1	2	3	6722	7436	0.842534205829863
GO:0019212	phosphatase inhibitor activity	  6	0.979023167332401	1	1	5	6723	7434	0.351055919095776
GO:0019213	deacetylase activity	  8	0.113810689204897	0.88413902838582	6	2	6718	7437	1.57975163593099
GO:0019215	intermediate filament binding	  6	0.979023167332401	1	1	5	6723	7434	0.351055919095776
GO:0019216	regulation of lipid metabolic process	 78	0.54726787298263	1	37	41	6687	7398	0.999159154349517
GO:0019217	regulation of fatty acid metabolic process	  5	0.77940058892516	1	2	3	6722	7436	0.842534205829863
GO:0019226	transmission of nerve impulse	 16	0.517377397284026	1	8	8	6716	7431	1.05316775728733
GO:0019227	neuronal action potential propagation	  7	0.444912401367032	1	4	3	6720	7436	1.20362029404266
GO:0019228	neuronal action potential	 26	0.868518735159201	1	10	16	6714	7423	0.810129044067176
GO:0019229	regulation of vasoconstriction	 22	0.999058190015592	1	4	18	6720	7421	0.382970093559029
GO:0019233	sensory perception of pain	 44	0.764401418389023	1	19	25	6705	7414	0.909553972202693
GO:0019239	deaminase activity	 11	0.665993939534306	1	5	6	6719	7433	0.957425233897572
GO:0019318	hexose metabolic process	  5	0.77940058892516	1	2	3	6722	7436	0.842534205829863
GO:0019363	pyridine nucleotide biosynthetic process	 12	0.320810094151237	1	7	5	6717	7434	1.22869571683522
GO:0019367	fatty acid elongation, saturated fatty acid	  5	0.452745275304033	1	3	2	6721	7437	1.26380130874479
GO:0019369	arachidonic acid metabolic process	 18	0.974269347793119	1	5	13	6719	7426	0.585093198492961
GO:0019370	leukotriene biosynthetic process	 10	0.998406526036605	1	1	9	6723	7430	0.210633551457466
GO:0019371	cyclooxygenase pathway	 10	0.983985908365184	1	2	8	6722	7431	0.421267102914932
GO:0019372	lipoxygenase pathway	 12	0.971055765853963	1	3	9	6721	7430	0.526583878643665
GO:0019373	epoxygenase P450 pathway	 13	0.933471720877997	1	4	9	6720	7430	0.648103235253741
GO:0019388	galactose catabolic process	  7	0.444912401367032	1	4	3	6720	7436	1.20362029404266
GO:0019395	fatty acid oxidation	 13	0.426320358160906	1	7	6	6717	7433	1.13418066169405
GO:0019430	removal of superoxide radicals	 12	0.899474094191123	1	4	8	6720	7431	0.702111838191553
GO:0019432	triglyceride biosynthetic process	 11	0.665993939534306	1	5	6	6719	7433	0.957425233897572
GO:0019433	triglyceride catabolic process	 18	0.998690537136033	1	3	15	6721	7424	0.351055919095776
GO:0019441	tryptophan catabolic process to kynurenine	  5	0.452745275304033	1	3	2	6721	7437	1.26380130874479
GO:0019511	peptidyl-proline hydroxylation	  6	0.607836179256654	1	3	3	6721	7436	1.05316775728733
GO:0019530	taurine metabolic process	  5	0.960049771736903	1	1	4	6723	7435	0.421267102914932
GO:0019531	oxalate transmembrane transporter activity	  8	0.580280354503036	1	4	4	6720	7435	1.05316775728733
GO:0019532	oxalate transport	  8	0.580280354503036	1	4	4	6720	7435	1.05316775728733
GO:0019538	protein metabolic process	  9	0.206720270758876	0.983668097955673	6	3	6718	7436	1.40422367638311
GO:0019626	short-chain fatty acid catabolic process	  5	0.0241003244622537	0.495149842313607	5	0	6719	7439	2.10633551457466
GO:0019674	NAD metabolic process	 16	0.0724287706601472	0.807895728316903	11	5	6713	7434	1.44810566627008
GO:0019706	protein-cysteine S-palmitoyltransferase activity	 25	0.399232431223553	1	13	12	6711	7427	1.09529446757882
GO:0019722	calcium-mediated signaling	 42	0.856575655499211	1	17	25	6707	7414	0.852564374946885
GO:0019725	cellular homeostasis	 10	0.559603563591584	1	5	5	6719	7434	1.05316775728733
GO:0019730	antimicrobial humoral response	 34	0.999937790646077	1	6	28	6718	7411	0.371706267277881
GO:0019731	antibacterial humoral response	 14	0.998346203775137	1	2	12	6722	7427	0.300905073510665
GO:0019752	carboxylic acid metabolic process	 10	0.316545776550851	1	6	4	6718	7435	1.26380130874479
GO:0019773	proteasome core complex, alpha-subunit complex	  5	0.77940058892516	1	2	3	6722	7436	0.842534205829863
GO:0019774	proteasome core complex, beta-subunit complex	  9	0.438074670071218	1	5	4	6719	7435	1.17018639698592
GO:0019784	NEDD8-specific protease activity	  6	0.0874151689581943	0.807895728316903	5	1	6719	7438	1.75527959547888
GO:0019787	ubiquitin-like protein transferase activity	  8	0.113810689204897	0.88413902838582	6	2	6718	7437	1.57975163593099
GO:0019788	NEDD8 transferase activity	  5	0.157494903089267	0.919686434773344	4	1	6720	7438	1.68506841165973
GO:0019789	SUMO transferase activity	 14	0.160610520833599	0.919686434773344	9	5	6715	7434	1.35407283079799
GO:0019800	peptide cross-linking via chondroitin 4-sulfate glycosaminoglycan	  6	0.297654371351411	1	4	2	6720	7437	1.40422367638311
GO:0019825	oxygen binding	 23	0.843995637843635	1	9	14	6715	7425	0.824218244833562
GO:0019827	stem cell population maintenance	 52	0.519827977363538	1	25	27	6699	7412	1.01266130508397
GO:0019829	cation-transporting ATPase activity	  8	0.309544448231027	1	5	3	6719	7436	1.31645969660916
GO:0019835	cytolysis	 20	0.989190352963028	1	5	15	6719	7424	0.526583878643665
GO:0019838	growth factor binding	 38	0.931128916433265	1	14	24	6710	7415	0.776018347474874
GO:0019841	retinol binding	 11	0.850917330440019	1	4	7	6720	7432	0.765940187118057
GO:0019843	rRNA binding	 32	0.063268776163272	0.772066334068511	20	12	6704	7427	1.31645969660916
GO:0019852	L-ascorbic acid metabolic process	  9	0.69404490204849	1	4	5	6720	7434	0.936149117588737
GO:0019855	calcium channel inhibitor activity	 10	0.316545776550851	1	6	4	6718	7435	1.26380130874479
GO:0019863	IgE binding	  5	1	1	0	5	6724	7434	0
GO:0019864	IgG binding	  5	1	1	0	5	6724	7434	0
GO:0019869	chloride channel inhibitor activity	  9	0.69404490204849	1	4	5	6720	7434	0.936149117588737
GO:0019870	potassium channel inhibitor activity	  6	0.607836179256654	1	3	3	6721	7436	1.05316775728733
GO:0019871	sodium channel inhibitor activity	  5	0.452745275304033	1	3	2	6721	7437	1.26380130874479
GO:0019882	antigen processing and presentation	 33	0.928099429218047	1	12	21	6712	7418	0.765940187118057
GO:0019885	antigen processing and presentation of endogenous peptide antigen via MHC class I	  6	0.979023167332401	1	1	5	6723	7434	0.351055919095776
GO:0019886	antigen processing and presentation of exogenous peptide antigen via MHC class II	 77	0.129012933772088	0.919686434773344	42	35	6682	7404	1.14891028067709
GO:0019887	protein kinase regulator activity	  8	0.113810689204897	0.88413902838582	6	2	6718	7437	1.57975163593099
GO:0019888	protein phosphatase regulator activity	 41	0.0291653004249913	0.548345648381269	26	15	6698	7424	1.33572496046198
GO:0019894	kinesin binding	 39	0.0121821327825983	0.427208830906354	26	13	6698	7426	1.40422367638311
GO:0019896	axonal transport of mitochondrion	  6	0.297654371351411	1	4	2	6720	7437	1.40422367638311
GO:0019897	extrinsic component of plasma membrane	 21	0.738560418161868	1	9	12	6715	7427	0.902715220531996
GO:0019898	extrinsic component of membrane	 60	0.497633769606333	1	29	31	6695	7408	1.01806216537775
GO:0019900	kinase binding	 87	0.131608245391955	0.919686434773344	47	40	6677	7399	1.13790539293114
GO:0019902	phosphatase binding	 44	0.312693872692444	1	23	21	6701	7418	1.10103901898221
GO:0019903	protein phosphatase binding	 60	0.217281384190897	1	32	28	6692	7411	1.12337894110648
GO:0019905	syntaxin binding	 64	0.0054728713374782	0.334473021939644	41	23	6683	7416	1.34937118902439
GO:0019907	cyclin-dependent protein kinase activating kinase holoenzyme complex	  5	0.452745275304033	1	3	2	6721	7437	1.26380130874479
GO:0019911	structural constituent of myelin sheath	  8	0.580280354503036	1	4	4	6720	7435	1.05316775728733
GO:0019915	lipid storage	 18	0.506938913103874	1	9	9	6715	7430	1.05316775728733
GO:0019919	peptidyl-arginine methylation, to asymmetrical-dimethyl arginine	  7	0.187210848839696	0.949543953868825	5	2	6719	7437	1.50452536755333
GO:0019933	cAMP-mediated signaling	 28	0.323270654016595	1	15	13	6709	7426	1.128394025665
GO:0019934	cGMP-mediated signaling	  8	0.819878207576373	1	3	5	6721	7434	0.789875817965497
GO:0019953	sexual reproduction	  6	0.979023167332401	1	1	5	6723	7434	0.351055919095776
GO:0019955	cytokine binding	 19	0.949176156916864	1	6	13	6718	7426	0.665158583549892
GO:0019956	chemokine binding	  5	1	1	0	5	6724	7434	0
GO:0019957	C-C chemokine binding	  6	0.979023167332401	1	1	5	6723	7434	0.351055919095776
GO:0019985	translesion synthesis	 30	0.1166008275708	0.893784829666214	18	12	6706	7427	1.26380130874479
GO:0019992	diacylglycerol binding	 11	0.665993939534306	1	5	6	6719	7433	0.957425233897572
GO:0020037	heme binding	 85	0.899266200739691	1	35	50	6689	7389	0.867314623648389
GO:0021510	spinal cord development	 29	0.945287796141565	1	10	19	6714	7420	0.726322591232641
GO:0021513	spinal cord dorsal/ventral patterning	  5	0.77940058892516	1	2	3	6722	7436	0.842534205829863
GO:0021517	ventral spinal cord development	  6	0.297654371351411	1	4	2	6720	7437	1.40422367638311
GO:0021522	spinal cord motor neuron differentiation	 18	0.974269347793119	1	5	13	6719	7426	0.585093198492961
GO:0021527	spinal cord association neuron differentiation	 10	0.998406526036605	1	1	9	6723	7430	0.210633551457466
GO:0021532	neural tube patterning	  5	0.77940058892516	1	2	3	6722	7436	0.842534205829863
GO:0021537	telencephalon development	 23	0.989780830505069	1	6	17	6718	7422	0.549478829889041
GO:0021542	dentate gyrus development	 16	0.324860333233664	1	9	7	6715	7432	1.18481372694825
GO:0021544	subpallium development	  5	1	1	0	5	6724	7434	0
GO:0021549	cerebellum development	 43	0.488572000794972	1	21	22	6703	7417	1.02867548386204
GO:0021554	optic nerve development	  5	0.77940058892516	1	2	3	6722	7436	0.842534205829863
GO:0021591	ventricular system development	 12	0.148657926965624	0.919686434773344	8	4	6716	7435	1.40422367638311
GO:0021612	facial nerve structural organization	  7	0.919244306193629	1	2	5	6722	7434	0.601810147021331
GO:0021631	optic nerve morphogenesis	  5	0.960049771736903	1	1	4	6723	7435	0.421267102914932
GO:0021670	lateral ventricle development	  9	0.206720270758876	0.983668097955673	6	3	6718	7436	1.40422367638311
GO:0021675	nerve development	  8	0.819878207576373	1	3	5	6721	7434	0.789875817965497
GO:0021680	cerebellar Purkinje cell layer development	 12	0.5430601307694	1	6	6	6718	7433	1.05316775728733
GO:0021696	cerebellar cortex morphogenesis	  5	0.960049771736903	1	1	4	6723	7435	0.421267102914932
GO:0021702	cerebellar Purkinje cell differentiation	 10	0.78367246101976	1	4	6	6720	7433	0.842534205829863
GO:0021756	striatum development	 11	0.0838548499097086	0.807895728316903	8	3	6716	7436	1.53188037423611
GO:0021762	substantia nigra development	 37	0.261641792098177	1	20	17	6704	7422	1.13855973760792
GO:0021766	hippocampus development	 55	0.117607086013058	0.899006189270582	31	24	6693	7415	1.18720729003299
GO:0021772	olfactory bulb development	 17	0.776294265732228	1	7	10	6717	7429	0.867314623648389
GO:0021782	glial cell development	  5	0.77940058892516	1	2	3	6722	7436	0.842534205829863
GO:0021785	branchiomotor neuron axon guidance	  6	0.865182793759413	1	2	4	6722	7435	0.702111838191553
GO:0021794	thalamus development	 14	0.529251719099727	1	7	7	6717	7432	1.05316775728733
GO:0021795	cerebral cortex cell migration	 11	0.220387996626296	1	7	4	6717	7435	1.3403953274566
GO:0021796	cerebral cortex regionalization	  6	0.0874151689581943	0.807895728316903	5	1	6719	7438	1.75527959547888
GO:0021798	forebrain dorsal/ventral pattern formation	  6	0.979023167332401	1	1	5	6723	7434	0.351055919095776
GO:0021799	cerebral cortex radially oriented cell migration	 11	0.850917330440019	1	4	7	6720	7432	0.765940187118057
GO:0021819	layer formation in cerebral cortex	 13	0.426320358160906	1	7	6	6717	7433	1.13418066169405
GO:0021846	cell proliferation in forebrain	 10	0.983985908365184	1	2	8	6722	7431	0.421267102914932
GO:0021854	hypothalamus development	 12	0.320810094151237	1	7	5	6717	7434	1.22869571683522
GO:0021860	pyramidal neuron development	  7	0.0474968970055936	0.646585116783694	6	1	6718	7438	1.80543044106399
GO:0021871	forebrain regionalization	  5	0.77940058892516	1	2	3	6722	7436	0.842534205829863
GO:0021879	forebrain neuron differentiation	  9	0.996964464269463	1	1	8	6723	7431	0.234037279397184
GO:0021884	forebrain neuron development	  5	0.77940058892516	1	2	3	6722	7436	0.842534205829863
GO:0021889	olfactory bulb interneuron differentiation	  5	1	1	0	5	6724	7434	0
GO:0021895	cerebral cortex neuron differentiation	 11	0.220387996626296	1	7	4	6717	7435	1.3403953274566
GO:0021902	commitment of neuronal cell to specific neuron type in forebrain	  6	0.607836179256654	1	3	3	6721	7436	1.05316775728733
GO:0021904	dorsal/ventral neural tube patterning	 12	0.971055765853963	1	3	9	6721	7430	0.526583878643665
GO:0021915	neural tube development	 41	0.893366538462545	1	16	25	6708	7414	0.821984591053525
GO:0021930	cerebellar granule cell precursor proliferation	  6	0.865182793759413	1	2	4	6722	7435	0.702111838191553
GO:0021942	radial glia guided migration of Purkinje cell	  5	0.452745275304033	1	3	2	6721	7437	1.26380130874479
GO:0021952	central nervous system projection neuron axonogenesis	  8	0.580280354503036	1	4	4	6720	7435	1.05316775728733
GO:0021953	central nervous system neuron differentiation	  8	0.580280354503036	1	4	4	6720	7435	1.05316775728733
GO:0021954	central nervous system neuron development	 13	0.230372725000093	1	8	5	6716	7434	1.29620647050748
GO:0021955	central nervous system neuron axonogenesis	  5	0.452745275304033	1	3	2	6721	7437	1.26380130874479
GO:0021960	anterior commissure morphogenesis	  5	0.77940058892516	1	2	3	6722	7436	0.842534205829863
GO:0021978	telencephalon regionalization	  7	0.98898631085553	1	1	6	6723	7433	0.300905073510665
GO:0021983	pituitary gland development	 21	0.738560418161868	1	9	12	6715	7427	0.902715220531996
GO:0021987	cerebral cortex development	 62	0.298971487762969	1	32	30	6692	7409	1.08714091074821
GO:0022008	neurogenesis	 55	0.990780470632242	1	18	37	6706	7402	0.689346168406252
GO:0022010	central nervous system myelination	 10	0.316545776550851	1	6	4	6718	7435	1.26380130874479
GO:0022011	myelination in peripheral nervous system	 14	0.0625726545054608	0.771729405567349	10	4	6714	7435	1.50452536755333
GO:0022027	interkinetic nuclear migration	  5	0.452745275304033	1	3	2	6721	7437	1.26380130874479
GO:0022029	telencephalon cell migration	  5	0.452745275304033	1	3	2	6721	7437	1.26380130874479
GO:0022038	corpus callosum development	  9	0.206720270758876	0.983668097955673	6	3	6718	7436	1.40422367638311
GO:0022400	regulation of rhodopsin mediated signaling pathway	 20	0.911428444807446	1	7	13	6717	7426	0.73721743010113
GO:0022405	hair cycle process	  6	0.607836179256654	1	3	3	6721	7436	1.05316775728733
GO:0022407	regulation of cell-cell adhesion	 10	0.925275888620553	1	3	7	6721	7432	0.631900654372397
GO:0022408	negative regulation of cell-cell adhesion	 12	0.899474094191123	1	4	8	6720	7431	0.702111838191553
GO:0022409	positive regulation of cell-cell adhesion	  9	0.882794860340315	1	3	6	6721	7433	0.702111838191553
GO:0022414	reproductive process	  8	0.994217735396885	1	1	7	6723	7432	0.263291939321832
GO:0022417	protein maturation by protein folding	  9	0.438074670071218	1	5	4	6719	7435	1.17018639698592
GO:0022604	regulation of cell morphogenesis	 26	0.0508264286032431	0.679607581911819	17	9	6707	7430	1.3772193749142
GO:0022612	gland morphogenesis	  5	0.452745275304033	1	3	2	6721	7437	1.26380130874479
GO:0022614	membrane to membrane docking	  5	0.960049771736903	1	1	4	6723	7435	0.421267102914932
GO:0022617	extracellular matrix disassembly	 61	0.998628599924314	1	18	43	6706	7396	0.621541627251538
GO:0022624	proteasome accessory complex	 15	0.421118865258844	1	8	7	6716	7432	1.12337894110648
GO:0022625	cytosolic large ribosomal subunit	 32	0.905424112434511	1	12	20	6712	7419	0.789875817965497
GO:0022626	cytosolic ribosome	  7	0.444912401367032	1	4	3	6720	7436	1.20362029404266
GO:0022627	cytosolic small ribosomal subunit	 22	0.189941610858229	0.956669265160296	13	9	6711	7430	1.24465280406684
GO:0022820	potassium ion symporter activity	  6	0.865182793759413	1	2	4	6722	7435	0.702111838191553
GO:0022841	potassium ion leak channel activity	 13	0.982330979346752	1	3	10	6721	7429	0.486077426440306
GO:0022848	acetylcholine-gated cation-selective channel activity	 11	1	1	0	11	6724	7428	0
GO:0022851	GABA-gated chloride ion channel activity	  5	0.0241003244622537	0.495149842313607	5	0	6719	7439	2.10633551457466
GO:0022857	transmembrane transporter activity	 60	0.59984399808945	1	28	32	6696	7407	0.982956573468174
GO:0022891	substrate-specific transmembrane transporter activity	 13	0.933471720877997	1	4	9	6720	7430	0.648103235253741
GO:0022904	respiratory electron transport chain	 16	0.170220385600338	0.949543953868825	10	6	6714	7433	1.31645969660916
GO:0023014	signal transduction by protein phosphorylation	 47	0.363644452082085	1	24	23	6700	7416	1.07557558191046
GO:0023019	signal transduction involved in regulation of gene expression	 19	0.983231201677496	1	5	14	6719	7425	0.55429881962491
GO:0023026	MHC class II protein complex binding	 12	0.5430601307694	1	6	6	6718	7433	1.05316775728733
GO:0023041	neuronal signal transduction	  5	0.77940058892516	1	2	3	6722	7436	0.842534205829863
GO:0023051	regulation of signaling	  5	0.452745275304033	1	3	2	6721	7437	1.26380130874479
GO:0023052	signaling	  7	0.444912401367032	1	4	3	6720	7436	1.20362029404266
GO:0030001	metal ion transport	 24	0.194475510371151	0.972714597800941	14	10	6710	7429	1.22869571683522
GO:0030007	cellular potassium ion homeostasis	  9	0.438074670071218	1	5	4	6719	7435	1.17018639698592
GO:0030008	TRAPP complex	 12	0.0514533113817507	0.679607581911819	9	3	6715	7436	1.57975163593099
GO:0030010	establishment of cell polarity	 26	0.198303125650341	0.983668097955673	15	11	6709	7428	1.21519356610076
GO:0030011	maintenance of cell polarity	  6	0.607836179256654	1	3	3	6721	7436	1.05316775728733
GO:0030014	CCR4-NOT complex	 16	0.706693964264422	1	7	9	6717	7430	0.921521787626413
GO:0030015	CCR4-NOT core complex	  6	0.0874151689581943	0.807895728316903	5	1	6719	7438	1.75527959547888
GO:0030016	myofibril	 25	0.399232431223553	1	13	12	6711	7427	1.09529446757882
GO:0030017	sarcomere	 34	0.712778465907433	1	15	19	6709	7420	0.929265668194702
GO:0030020	extracellular matrix structural constituent conferring tensile strength	  5	0.157494903089267	0.919686434773344	4	1	6720	7438	1.68506841165973
GO:0030031	cell projection assembly	  8	0.819878207576373	1	3	5	6721	7434	0.789875817965497
GO:0030032	lamellipodium assembly	 29	0.538368194874272	1	14	15	6710	7424	1.0168516277257
GO:0030033	microvillus assembly	  9	0.438074670071218	1	5	4	6719	7435	1.17018639698592
GO:0030035	microspike assembly	  5	0.157494903089267	0.919686434773344	4	1	6720	7438	1.68506841165973
GO:0030041	actin filament polymerization	 24	0.641180248362636	1	11	13	6713	7426	0.965403777513385
GO:0030042	actin filament depolymerization	  8	0.113810689204897	0.88413902838582	6	2	6718	7437	1.57975163593099
GO:0030048	actin filament-based movement	 14	0.98932697223781	1	3	11	6721	7428	0.451357610265998
GO:0030049	muscle filament sliding	 26	0.990538704738386	1	7	19	6717	7420	0.567090330847023
GO:0030050	vesicle transport along actin filament	  7	0.919244306193629	1	2	5	6722	7434	0.601810147021331
GO:0030056	hemidesmosome	  6	0.607836179256654	1	3	3	6721	7436	1.05316775728733
GO:0030057	desmosome	 19	0.756503853067433	1	8	11	6716	7428	0.886878111399856
GO:0030061	mitochondrial crista	  5	0.452745275304033	1	3	2	6721	7437	1.26380130874479
GO:0030071	regulation of mitotic metaphase/anaphase transition	  6	0.979023167332401	1	1	5	6723	7434	0.351055919095776
GO:0030073	insulin secretion	 24	0.641180248362636	1	11	13	6713	7426	0.965403777513385
GO:0030091	protein repair	  6	0.607836179256654	1	3	3	6721	7436	1.05316775728733
GO:0030097	hemopoiesis	 65	0.435910159801246	1	32	33	6692	7406	1.03696517640599
GO:0030098	lymphocyte differentiation	  5	0.960049771736903	1	1	4	6723	7435	0.421267102914932
GO:0030099	myeloid cell differentiation	 20	0.813860390499775	1	8	12	6716	7427	0.842534205829863
GO:0030100	regulation of endocytosis	 28	0.0238373256969171	0.495149842313607	19	9	6705	7430	1.42929909917566
GO:0030101	natural killer cell activation	 13	1	1	0	13	6724	7426	0
GO:0030111	regulation of Wnt signaling pathway	 25	0.912607021347774	1	9	16	6715	7423	0.758280785246877
GO:0030117	membrane coat	 28	0.00285126500989527	0.244538441062453	21	7	6703	7432	1.57975163593099
GO:0030118	clathrin coat	  7	0.187210848839696	0.949543953868825	5	2	6719	7437	1.50452536755333
GO:0030119	AP-type membrane coat adaptor complex	  7	0.444912401367032	1	4	3	6720	7436	1.20362029404266
GO:0030121	AP-1 adaptor complex	  6	0.297654371351411	1	4	2	6720	7437	1.40422367638311
GO:0030122	AP-2 adaptor complex	 13	0.000953326541898035	0.165233002219546	12	1	6712	7438	1.94430970576122
GO:0030123	AP-3 adaptor complex	 10	0.133503266897558	0.919686434773344	7	3	6717	7436	1.47443486020226
GO:0030126	COPI vesicle coat	 13	0.822979434145659	1	5	8	6719	7431	0.810129044067176
GO:0030127	COPII vesicle coat	 13	0.230372725000093	1	8	5	6716	7434	1.29620647050748
GO:0030130	clathrin coat of trans-Golgi network vesicle	  6	0.0114373555630656	0.427208830906354	6	0	6718	7439	2.10633551457466
GO:0030131	clathrin adaptor complex	 18	0.00196064838978763	0.222937212333575	15	3	6709	7436	1.75527959547888
GO:0030132	clathrin coat of coated pit	  8	0.025392299605826	0.495149842313607	7	1	6717	7438	1.84304357525283
GO:0030133	transport vesicle	 88	0.075101563944416	0.807895728316903	49	39	6675	7400	1.17284591152453
GO:0030134	COPII-coated ER to Golgi transport vesicle	 26	0.0208257637244103	0.495149842313607	18	8	6706	7431	1.45823227932092
GO:0030136	clathrin-coated vesicle	 60	0.0188223977909217	0.495149842313607	37	23	6687	7416	1.29890690065437
GO:0030137	COPI-coated vesicle	 12	0.5430601307694	1	6	6	6718	7433	1.05316775728733
GO:0030139	endocytic vesicle	 44	0.0104681396322092	0.427208830906354	29	15	6695	7424	1.38826658915148
GO:0030140	trans-Golgi network transport vesicle	 14	0.160610520833599	0.919686434773344	9	5	6715	7434	1.35407283079799
GO:0030141	secretory granule	 75	0.600461171617625	1	35	40	6689	7399	0.982956573468174
GO:0030145	manganese ion binding	 49	0.859722651784109	1	20	29	6704	7410	0.859728781459044
GO:0030148	sphingolipid biosynthetic process	 46	0.421689519133964	1	23	23	6701	7416	1.05316775728733
GO:0030150	protein import into mitochondrial matrix	 13	0.0309498150207146	0.552600112408603	10	3	6714	7436	1.62025808813435
GO:0030155	regulation of cell adhesion	 41	0.893366538462545	1	16	25	6708	7414	0.821984591053525
GO:0030157	pancreatic juice secretion	  5	0.77940058892516	1	2	3	6722	7436	0.842534205829863
GO:0030159	receptor signaling complex scaffold activity	 20	0.184541691833438	0.949543953868825	12	8	6712	7431	1.26380130874479
GO:0030162	regulation of proteolysis	 17	0.607264962167558	1	8	9	6716	7430	0.991216712741015
GO:0030163	protein catabolic process	 34	0.586036077818074	1	16	18	6708	7421	0.991216712741015
GO:0030165	PDZ domain binding	 80	0.365995412422105	1	40	40	6684	7399	1.05316775728733
GO:0030166	proteoglycan biosynthetic process	 12	0.971055765853963	1	3	9	6721	7430	0.526583878643665
GO:0030168	platelet activation	 98	0.96711624970593	1	38	60	6686	7379	0.816742342386092
GO:0030169	low-density lipoprotein particle binding	 11	0.990836032904502	1	2	9	6722	7430	0.382970093559029
GO:0030170	pyridoxal phosphate binding	 43	0.369309686584353	1	22	21	6702	7418	1.07766003071262
GO:0030173	integral component of Golgi membrane	 39	0.0546234523521783	0.703764658430297	24	15	6700	7424	1.29620647050748
GO:0030175	filopodium	 64	0.930714170111895	1	25	39	6699	7400	0.822787310380726
GO:0030176	integral component of endoplasmic reticulum membrane	 82	0.0168567541415661	0.495149842313607	49	33	6675	7406	1.25866390505071
GO:0030177	positive regulation of Wnt signaling pathway	 35	0.646218304563881	1	16	19	6708	7420	0.962896235234129
GO:0030178	negative regulation of Wnt signaling pathway	 51	0.993448265343146	1	16	35	6708	7404	0.660811141827344
GO:0030183	B cell differentiation	 40	0.923587950498548	1	15	25	6709	7414	0.789875817965497
GO:0030193	regulation of blood coagulation	 17	0.607264962167558	1	8	9	6716	7430	0.991216712741015
GO:0030194	positive regulation of blood coagulation	 12	0.899474094191123	1	4	8	6720	7431	0.702111838191553
GO:0030195	negative regulation of blood coagulation	 10	0.998406526036605	1	1	9	6723	7430	0.210633551457466
GO:0030199	collagen fibril organization	 36	0.701531598327634	1	16	20	6708	7419	0.936149117588737
GO:0030203	glycosaminoglycan metabolic process	 31	0.668178704248721	1	14	17	6710	7422	0.951248296904684
GO:0030204	chondroitin sulfate metabolic process	  7	0.187210848839696	0.949543953868825	5	2	6719	7437	1.50452536755333
GO:0030206	chondroitin sulfate biosynthetic process	 22	0.796326194402031	1	9	13	6715	7426	0.861682710507815
GO:0030207	chondroitin sulfate catabolic process	 14	0.529251719099727	1	7	7	6717	7432	1.05316775728733
GO:0030208	dermatan sulfate biosynthetic process	 12	0.5430601307694	1	6	6	6718	7433	1.05316775728733
GO:0030210	heparin biosynthetic process	  6	0.979023167332401	1	1	5	6723	7434	0.351055919095776
GO:0030212	hyaluronan metabolic process	 10	0.998406526036605	1	1	9	6723	7430	0.210633551457466
GO:0030213	hyaluronan biosynthetic process	  5	0.960049771736903	1	1	4	6723	7435	0.421267102914932
GO:0030214	hyaluronan catabolic process	 14	0.98932697223781	1	3	11	6721	7428	0.451357610265998
GO:0030215	semaphorin receptor binding	  9	0.067355898427907	0.780679208284898	7	2	6717	7437	1.63826095578029
GO:0030216	keratinocyte differentiation	 45	0.980934441491871	1	15	30	6709	7409	0.702111838191553
GO:0030217	T cell differentiation	 28	0.966852873120196	1	9	19	6715	7420	0.677036415398997
GO:0030218	erythrocyte differentiation	 41	0.494590306023443	1	20	21	6704	7418	1.02748073881691
GO:0030219	megakaryocyte differentiation	  8	0.952366339066048	1	2	6	6722	7433	0.526583878643665
GO:0030220	platelet formation	 18	0.993133250054207	1	4	14	6720	7425	0.468074558794368
GO:0030224	monocyte differentiation	 15	0.99361188809009	1	3	12	6721	7427	0.421267102914932
GO:0030225	macrophage differentiation	 17	0.997764322622395	1	3	14	6721	7425	0.371706267277881
GO:0030234	enzyme regulator activity	 17	0.243621618961318	1	10	7	6714	7432	1.23902089092627
GO:0030235	nitric-oxide synthase regulator activity	  5	0.157494903089267	0.919686434773344	4	1	6720	7438	1.68506841165973
GO:0030238	male sex determination	 11	0.953160347938253	1	3	8	6721	7431	0.574455140338543
GO:0030239	myofibril assembly	  7	0.444912401367032	1	4	3	6720	7436	1.20362029404266
GO:0030242	autophagy of peroxisome	  5	0.157494903089267	0.919686434773344	4	1	6720	7438	1.68506841165973
GO:0030247	polysaccharide binding	  9	0.438074670071218	1	5	4	6719	7435	1.17018639698592
GO:0030252	growth hormone secretion	  6	0.979023167332401	1	1	5	6723	7434	0.351055919095776
GO:0030261	chromosome condensation	 12	0.75380380293781	1	5	7	6719	7432	0.877639797739441
GO:0030263	apoptotic chromosome condensation	  5	0.452745275304033	1	3	2	6721	7437	1.26380130874479
GO:0030274	LIM domain binding	  6	0.607836179256654	1	3	3	6721	7436	1.05316775728733
GO:0030275	LRR domain binding	  5	0.0241003244622537	0.495149842313607	5	0	6719	7439	2.10633551457466
GO:0030276	clathrin binding	 37	0.00145698256897053	0.195574497397626	27	10	6697	7429	1.5370556457707
GO:0030277	maintenance of gastrointestinal epithelium	  8	0.952366339066048	1	2	6	6722	7433	0.526583878643665
GO:0030278	regulation of ossification	 10	0.78367246101976	1	4	6	6720	7433	0.842534205829863
GO:0030279	negative regulation of ossification	 18	0.687525801418504	1	8	10	6716	7429	0.936149117588737
GO:0030280	structural constituent of epidermis	  9	0.972243904416257	1	2	7	6722	7432	0.468074558794368
GO:0030282	bone mineralization	 28	0.995871123915027	1	7	21	6717	7418	0.526583878643665
GO:0030284	estrogen receptor activity	  5	0.157494903089267	0.919686434773344	4	1	6720	7438	1.68506841165973
GO:0030285	integral component of synaptic vesicle membrane	 14	0.0183006792268162	0.495149842313607	11	3	6713	7436	1.65497790430866
GO:0030286	dynein complex	 30	0.1166008275708	0.893784829666214	18	12	6706	7427	1.26380130874479
GO:0030291	protein serine/threonine kinase inhibitor activity	  9	0.882794860340315	1	3	6	6721	7433	0.702111838191553
GO:0030295	protein kinase activator activity	 22	0.325498770721016	1	12	10	6712	7429	1.14891028067709
GO:0030296	protein tyrosine kinase activator activity	  9	0.438074670071218	1	5	4	6719	7435	1.17018639698592
GO:0030297	transmembrane receptor protein tyrosine kinase activator activity	  5	0.157494903089267	0.919686434773344	4	1	6720	7438	1.68506841165973
GO:0030299	intestinal cholesterol absorption	  7	1	1	0	7	6724	7432	0
GO:0030301	cholesterol transport	 21	0.993100479805263	1	5	16	6719	7423	0.501508455851109
GO:0030306	ADP-ribosylation factor binding	  8	0.113810689204897	0.88413902838582	6	2	6718	7437	1.57975163593099
GO:0030307	positive regulation of cell growth	 68	0.821351222409525	1	29	39	6695	7400	0.898290145921545
GO:0030314	junctional membrane complex	  6	0.865182793759413	1	2	4	6722	7435	0.702111838191553
GO:0030315	T-tubule	 36	0.444708914602519	1	18	18	6706	7421	1.05316775728733
GO:0030316	osteoclast differentiation	 24	0.946019062510409	1	8	16	6716	7423	0.702111838191553
GO:0030317	flagellated sperm motility	 37	0.9910373833468	1	11	26	6713	7413	0.626207855684358
GO:0030318	melanocyte differentiation	 19	0.248077880408704	1	11	8	6713	7431	1.2194574031748
GO:0030321	transepithelial chloride transport	  5	0.77940058892516	1	2	3	6722	7436	0.842534205829863
GO:0030322	stabilization of membrane potential	 13	0.997057742126947	1	2	11	6722	7428	0.32405161762687
GO:0030323	respiratory tube development	  6	0.979023167332401	1	1	5	6723	7434	0.351055919095776
GO:0030324	lung development	 82	0.997354600374202	1	27	55	6697	7384	0.693549498701412
GO:0030325	adrenal gland development	 17	0.607264962167558	1	8	9	6716	7430	0.991216712741015
GO:0030326	embryonic limb morphogenesis	 44	0.988172250282583	1	14	30	6710	7409	0.6701976637283
GO:0030330	DNA damage response, signal transduction by p53 class mediator	 14	0.529251719099727	1	7	7	6717	7432	1.05316775728733
GO:0030331	estrogen receptor binding	 36	0.127348553929636	0.919686434773344	21	15	6703	7424	1.22869571683522
GO:0030332	cyclin binding	 20	0.813860390499775	1	8	12	6716	7427	0.842534205829863
GO:0030334	regulation of cell migration	 62	0.842059409524676	1	26	36	6698	7403	0.883301989982921
GO:0030336	negative regulation of cell migration	 90	0.601880523548969	1	42	48	6682	7391	0.982956573468174
GO:0030345	structural constituent of tooth enamel	  5	0.77940058892516	1	2	3	6722	7436	0.842534205829863
GO:0030346	protein phosphatase 2B binding	  7	0.444912401367032	1	4	3	6720	7436	1.20362029404266
GO:0030368	interleukin-17 receptor activity	  5	0.960049771736903	1	1	4	6723	7435	0.421267102914932
GO:0030371	translation repressor activity	 10	0.559603563591584	1	5	5	6719	7434	1.05316775728733
GO:0030374	ligand-dependent nuclear receptor transcription coactivator activity	 47	0.260932299681936	1	25	22	6699	7417	1.12039123115673
GO:0030388	fructose 1,6-bisphosphate metabolic process	  6	0.297654371351411	1	4	2	6720	7437	1.40422367638311
GO:0030414	peptidase inhibitor activity	 84	0.999999811350151	1	18	66	6706	7373	0.451357610265998
GO:0030422	production of siRNA involved in RNA interference	  8	0.113810689204897	0.88413902838582	6	2	6718	7437	1.57975163593099
GO:0030431	sleep	 11	0.990836032904502	1	2	9	6722	7430	0.382970093559029
GO:0030432	peristalsis	  7	0.730029012673872	1	3	4	6721	7435	0.902715220531996
GO:0030433	ubiquitin-dependent ERAD pathway	 61	0.00328190293253998	0.25949511954275	40	21	6684	7418	1.38120361611453
GO:0030449	regulation of complement activation	 40	0.999924891888554	1	8	32	6716	7407	0.421267102914932
GO:0030488	tRNA methylation	 23	0.0670050066345162	0.780679208284898	15	8	6709	7431	1.3736970747226
GO:0030490	maturation of SSU-rRNA	 16	0.324860333233664	1	9	7	6715	7432	1.18481372694825
GO:0030497	fatty acid elongation	  5	0.157494903089267	0.919686434773344	4	1	6720	7438	1.68506841165973
GO:0030500	regulation of bone mineralization	 16	0.706693964264422	1	7	9	6717	7430	0.921521787626413
GO:0030501	positive regulation of bone mineralization	 30	0.915575929257217	1	11	19	6713	7420	0.772323022010708
GO:0030502	negative regulation of bone mineralization	 14	0.529251719099727	1	7	7	6717	7432	1.05316775728733
GO:0030506	ankyrin binding	 16	0.94165410331218	1	5	11	6719	7428	0.658229848304581
GO:0030507	spectrin binding	 24	0.324965824259735	1	13	11	6711	7428	1.14093173706127
GO:0030509	BMP signaling pathway	 74	0.860298829851755	1	31	43	6693	7396	0.882383796646141
GO:0030510	regulation of BMP signaling pathway	  8	0.952366339066048	1	2	6	6722	7433	0.526583878643665
GO:0030511	positive regulation of transforming growth factor beta receptor signaling pathway	 25	0.14581109956432	0.919686434773344	15	10	6709	7429	1.26380130874479
GO:0030512	negative regulation of transforming growth factor beta receptor signaling pathway	 55	0.667727474650433	1	25	30	6699	7409	0.957425233897572
GO:0030513	positive regulation of BMP signaling pathway	 31	0.877080826063238	1	12	19	6712	7420	0.815355683061158
GO:0030514	negative regulation of BMP signaling pathway	 40	0.680701626877675	1	18	22	6706	7417	0.947850981558596
GO:0030515	snoRNA binding	 18	0.0811513291101853	0.807895728316903	12	6	6712	7433	1.40422367638311
GO:0030516	regulation of axon extension	 10	0.559603563591584	1	5	5	6719	7434	1.05316775728733
GO:0030517	negative regulation of axon extension	 15	0.798298186583662	1	6	9	6718	7430	0.842534205829863
GO:0030518	intracellular steroid hormone receptor signaling pathway	 17	0.416253886790052	1	9	8	6715	7431	1.11511880183364
GO:0030520	intracellular estrogen receptor signaling pathway	 16	0.517377397284026	1	8	8	6716	7431	1.05316775728733
GO:0030521	androgen receptor signaling pathway	 41	0.103180061828763	0.873532642568676	24	17	6700	7422	1.23297688658029
GO:0030522	intracellular receptor signaling pathway	 39	0.500905896338627	1	19	20	6705	7419	1.02616345581842
GO:0030532	small nuclear ribonucleoprotein complex	 17	0.416253886790052	1	9	8	6715	7431	1.11511880183364
GO:0030534	adult behavior	 24	0.324965824259735	1	13	11	6711	7428	1.14093173706127
GO:0030539	male genitalia development	 12	0.75380380293781	1	5	7	6719	7432	0.877639797739441
GO:0030540	female genitalia development	  6	0.979023167332401	1	1	5	6723	7434	0.351055919095776
GO:0030544	Hsp70 protein binding	 34	0.586036077818074	1	16	18	6708	7421	0.991216712741015
GO:0030552	cAMP binding	 22	0.325498770721016	1	12	10	6712	7429	1.14891028067709
GO:0030553	cGMP binding	 12	0.994792086314609	1	2	10	6722	7429	0.351055919095776
GO:0030574	collagen catabolic process	 52	0.878289526286966	1	21	31	6703	7408	0.850635496270535
GO:0030579	ubiquitin-dependent SMAD protein catabolic process	  6	0.865182793759413	1	2	4	6722	7435	0.702111838191553
GO:0030593	neutrophil chemotaxis	 42	0.999877690916697	1	9	33	6715	7406	0.451357610265998
GO:0030594	neurotransmitter receptor activity	 10	0.998406526036605	1	1	9	6723	7430	0.210633551457466
GO:0030595	leukocyte chemotaxis	  9	0.972243904416257	1	2	7	6722	7432	0.468074558794368
GO:0030618	transforming growth factor beta receptor, pathway-specific cytoplasmic mediator activity	  5	0.452745275304033	1	3	2	6721	7437	1.26380130874479
GO:0030619	U1 snRNA binding	  7	0.730029012673872	1	3	4	6721	7435	0.902715220531996
GO:0030620	U2 snRNA binding	  6	0.607836179256654	1	3	3	6721	7436	1.05316775728733
GO:0030621	U4 snRNA binding	  6	0.607836179256654	1	3	3	6721	7436	1.05316775728733
GO:0030643	cellular phosphate ion homeostasis	  6	0.865182793759413	1	2	4	6722	7435	0.702111838191553
GO:0030644	cellular chloride ion homeostasis	  5	0.960049771736903	1	1	4	6723	7435	0.421267102914932
GO:0030658	transport vesicle membrane	 35	0.514569683557429	1	17	18	6707	7421	1.02307724993626
GO:0030660	Golgi-associated vesicle membrane	 18	0.0811513291101853	0.807895728316903	12	6	6712	7433	1.40422367638311
GO:0030663	COPI-coated vesicle membrane	 14	0.529251719099727	1	7	7	6717	7432	1.05316775728733
GO:0030665	clathrin-coated vesicle membrane	 46	0.0840330034659214	0.807895728316903	27	19	6697	7420	1.23632736725034
GO:0030666	endocytic vesicle membrane	 58	0.908249657058201	1	23	35	6701	7404	0.835270979917537
GO:0030667	secretory granule membrane	 80	0.452899385582141	1	39	41	6685	7398	1.02683856335515
GO:0030669	clathrin-coated endocytic vesicle membrane	 30	0.1166008275708	0.893784829666214	18	12	6706	7427	1.26380130874479
GO:0030670	phagocytic vesicle membrane	 60	0.695762082380854	1	27	33	6697	7406	0.947850981558596
GO:0030672	synaptic vesicle membrane	 59	3.74407557852459e-07	0.00216108042392439	47	12	6677	7427	1.67792829127134
GO:0030673	axolemma	 15	0.0106614103540833	0.427208830906354	12	3	6712	7436	1.68506841165973
GO:0030674	protein binding, bridging	 70	0.74350086638346	1	31	39	6693	7400	0.932805727883063
GO:0030676	Rac guanyl-nucleotide exchange factor activity	 15	0.623867966210499	1	7	8	6717	7431	0.982956573468174
GO:0030681	multimeric ribonuclease P complex	  7	0.919244306193629	1	2	5	6722	7434	0.601810147021331
GO:0030686	90S preribosome	 11	0.220387996626296	1	7	4	6717	7435	1.3403953274566
GO:0030687	preribosome, large subunit precursor	 20	0.497606676879603	1	10	10	6714	7429	1.05316775728733
GO:0030688	preribosome, small subunit precursor	  8	0.309544448231027	1	5	3	6719	7436	1.31645969660916
GO:0030695	GTPase regulator activity	 15	0.421118865258844	1	8	7	6716	7432	1.12337894110648
GO:0030705	cytoskeleton-dependent intracellular transport	 17	0.118839522247653	0.899006189270582	11	6	6713	7433	1.3629229800189
GO:0030728	ovulation	  8	0.580280354503036	1	4	4	6720	7435	1.05316775728733
GO:0030742	GTP-dependent protein binding	 22	0.325498770721016	1	12	10	6712	7429	1.14891028067709
GO:0030816	positive regulation of cAMP metabolic process	 11	0.999163575349816	1	1	10	6723	7429	0.191485046779514
GO:0030818	negative regulation of cAMP biosynthetic process	 13	0.643122793005253	1	6	7	6718	7432	0.972154852880611
GO:0030819	positive regulation of cAMP biosynthetic process	 32	0.905424112434511	1	12	20	6712	7419	0.789875817965497
GO:0030828	positive regulation of cGMP biosynthetic process	 10	0.925275888620553	1	3	7	6721	7432	0.631900654372397
GO:0030833	regulation of actin filament polymerization	 19	0.127144513269886	0.919686434773344	12	7	6712	7432	1.33031716709978
GO:0030836	positive regulation of actin filament depolymerization	  8	0.309544448231027	1	5	3	6719	7436	1.31645969660916
GO:0030837	negative regulation of actin filament polymerization	 12	0.148657926965624	0.919686434773344	8	4	6716	7435	1.40422367638311
GO:0030838	positive regulation of actin filament polymerization	 46	0.311195693409669	1	24	22	6700	7417	1.09895765977808
GO:0030850	prostate gland development	 14	0.956679005412873	1	4	10	6720	7429	0.601810147021331
GO:0030851	granulocyte differentiation	 10	0.925275888620553	1	3	7	6721	7432	0.631900654372397
GO:0030853	negative regulation of granulocyte differentiation	  6	0.607836179256654	1	3	3	6721	7436	1.05316775728733
GO:0030854	positive regulation of granulocyte differentiation	  5	0.77940058892516	1	2	3	6722	7436	0.842534205829863
GO:0030855	epithelial cell differentiation	 63	0.99831125669636	1	19	44	6705	7395	0.635244044078071
GO:0030856	regulation of epithelial cell differentiation	  6	0.607836179256654	1	3	3	6721	7436	1.05316775728733
GO:0030857	negative regulation of epithelial cell differentiation	  8	0.819878207576373	1	3	5	6721	7434	0.789875817965497
GO:0030863	cortical cytoskeleton	 21	0.738560418161868	1	9	12	6715	7427	0.902715220531996
GO:0030864	cortical actin cytoskeleton	 37	0.166731939115621	0.949543953868825	21	16	6703	7423	1.19548772448832
GO:0030866	cortical actin cytoskeleton organization	 22	0.0957434892101259	0.843214701401555	14	8	6710	7431	1.3403953274566
GO:0030867	rough endoplasmic reticulum membrane	  8	0.580280354503036	1	4	4	6720	7435	1.05316775728733
GO:0030868	smooth endoplasmic reticulum membrane	  5	0.452745275304033	1	3	2	6721	7437	1.26380130874479
GO:0030870	Mre11 complex	  6	0.607836179256654	1	3	3	6721	7436	1.05316775728733
GO:0030877	beta-catenin destruction complex	 11	0.220387996626296	1	7	4	6717	7435	1.3403953274566
GO:0030878	thyroid gland development	 19	0.877279625799761	1	7	12	6717	7427	0.776018347474874
GO:0030879	mammary gland development	 27	0.693189244333171	1	12	15	6712	7424	0.936149117588737
GO:0030881	beta-2-microglobulin binding	  6	0.979023167332401	1	1	5	6723	7434	0.351055919095776
GO:0030889	negative regulation of B cell proliferation	 16	0.853260719975205	1	6	10	6718	7429	0.789875817965497
GO:0030890	positive regulation of B cell proliferation	 29	0.991361084025245	1	8	21	6716	7418	0.581058072986113
GO:0030891	VCB complex	  5	0.452745275304033	1	3	2	6721	7437	1.26380130874479
GO:0030893	meiotic cohesin complex	  5	0.77940058892516	1	2	3	6722	7436	0.842534205829863
GO:0030897	HOPS complex	 14	0.00376490525152056	0.275076368503502	12	2	6712	7437	1.80543044106399
GO:0030898	actin-dependent ATPase activity	  8	0.819878207576373	1	3	5	6721	7434	0.789875817965497
GO:0030900	forebrain development	 65	0.0801599494597634	0.807895728316903	37	28	6687	7411	1.19899098521942
GO:0030901	midbrain development	 30	0.915575929257217	1	11	19	6713	7420	0.772323022010708
GO:0030902	hindbrain development	 19	0.756503853067433	1	8	11	6716	7428	0.886878111399856
GO:0030903	notochord development	  7	0.444912401367032	1	4	3	6720	7436	1.20362029404266
GO:0030904	retromer complex	 20	0.0357139492882998	0.606296809682549	14	6	6710	7433	1.47443486020226
GO:0030911	TPR domain binding	  6	0.0874151689581943	0.807895728316903	5	1	6719	7438	1.75527959547888
GO:0030913	paranodal junction assembly	  7	0.0474968970055936	0.646585116783694	6	1	6718	7438	1.80543044106399
GO:0030914	STAGA complex	 12	0.5430601307694	1	6	6	6718	7433	1.05316775728733
GO:0030915	Smc5-Smc6 complex	  7	0.730029012673872	1	3	4	6721	7435	0.902715220531996
GO:0030916	otic vesicle formation	  5	0.452745275304033	1	3	2	6721	7437	1.26380130874479
GO:0030948	negative regulation of vascular endothelial growth factor receptor signaling pathway	  7	0.919244306193629	1	2	5	6722	7434	0.601810147021331
GO:0030949	positive regulation of vascular endothelial growth factor receptor signaling pathway	 11	0.953160347938253	1	3	8	6721	7431	0.574455140338543
GO:0030953	astral microtubule organization	  7	0.187210848839696	0.949543953868825	5	2	6719	7437	1.50452536755333
GO:0030955	potassium ion binding	 14	0.529251719099727	1	7	7	6717	7432	1.05316775728733
GO:0030957	Tat protein binding	 10	0.559603563591584	1	5	5	6719	7434	1.05316775728733
GO:0030968	endoplasmic reticulum unfolded protein response	 41	0.261700823716251	1	22	19	6702	7420	1.1302288126986
GO:0030970	retrograde protein transport, ER to cytosol	 12	0.012434352666713	0.427208830906354	10	2	6714	7437	1.75527959547888
GO:0030971	receptor tyrosine kinase binding	 39	0.100380621024561	0.864771559035475	23	16	6701	7423	1.24219786756967
GO:0030976	thiamine pyrophosphate binding	  5	0.157494903089267	0.919686434773344	4	1	6720	7438	1.68506841165973
GO:0030983	mismatched DNA binding	  7	0.444912401367032	1	4	3	6720	7436	1.20362029404266
GO:0030991	intraciliary transport particle A	  7	0.00542743198931091	0.334473021939644	7	0	6717	7439	2.10633551457466
GO:0030992	intraciliary transport particle B	 19	0.0543219716836929	0.703764658430297	13	6	6711	7433	1.44117693102477
GO:0031000	response to caffeine	  9	0.438074670071218	1	5	4	6719	7435	1.17018639698592
GO:0031005	filamin binding	 12	0.148657926965624	0.919686434773344	8	4	6716	7435	1.40422367638311
GO:0031011	Ino80 complex	 14	0.323388997222084	1	8	6	6716	7433	1.20362029404266
GO:0031016	pancreas development	 19	0.949176156916864	1	6	13	6718	7426	0.665158583549892
GO:0031018	endocrine pancreas development	 21	0.993100479805263	1	5	16	6719	7423	0.501508455851109
GO:0031023	microtubule organizing center organization	  9	0.206720270758876	0.983668097955673	6	3	6718	7436	1.40422367638311
GO:0031032	actomyosin structure organization	 25	0.399232431223553	1	13	12	6711	7427	1.09529446757882
GO:0031045	dense core granule	 12	0.0514533113817507	0.679607581911819	9	3	6715	7436	1.57975163593099
GO:0031047	gene silencing by RNA	 48	0.0862724562776354	0.807895728316903	28	20	6696	7419	1.22869571683522
GO:0031053	primary miRNA processing	  9	0.206720270758876	0.983668097955673	6	3	6718	7436	1.40422367638311
GO:0031054	pre-miRNA processing	 10	0.00700161837131091	0.354502993326374	9	1	6715	7438	1.89570196311719
GO:0031062	positive regulation of histone methylation	  6	0.297654371351411	1	4	2	6720	7437	1.40422367638311
GO:0031063	regulation of histone deacetylation	  5	0.77940058892516	1	2	3	6722	7436	0.842534205829863
GO:0031065	positive regulation of histone deacetylation	 10	0.316545776550851	1	6	4	6718	7435	1.26380130874479
GO:0031069	hair follicle morphogenesis	 22	0.955871272394322	1	7	15	6717	7424	0.6701976637283
GO:0031072	heat shock protein binding	 48	0.0862724562776354	0.807895728316903	28	20	6696	7419	1.22869571683522
GO:0031076	embryonic camera-type eye development	 11	0.850917330440019	1	4	7	6720	7432	0.765940187118057
GO:0031080	nuclear pore outer ring	 10	0.78367246101976	1	4	6	6720	7433	0.842534205829863
GO:0031083	BLOC-1 complex	 14	0.160610520833599	0.919686434773344	9	5	6715	7434	1.35407283079799
GO:0031087	deadenylation-independent decapping of nuclear-transcribed mRNA	  5	0.157494903089267	0.919686434773344	4	1	6720	7438	1.68506841165973
GO:0031088	platelet dense granule membrane	  6	0.607836179256654	1	3	3	6721	7436	1.05316775728733
GO:0031089	platelet dense granule lumen	 12	0.971055765853963	1	3	9	6721	7430	0.526583878643665
GO:0031090	organelle membrane	 75	0.329934529178392	1	38	37	6686	7402	1.06720999405116
GO:0031091	platelet alpha granule	 13	0.933471720877997	1	4	9	6720	7430	0.648103235253741
GO:0031092	platelet alpha granule membrane	 14	0.529251719099727	1	7	7	6717	7432	1.05316775728733
GO:0031093	platelet alpha granule lumen	 55	0.835699945165586	1	23	32	6701	7407	0.880831215185766
GO:0031095	platelet dense tubular network membrane	  9	0.438074670071218	1	5	4	6719	7435	1.17018639698592
GO:0031098	stress-activated protein kinase signaling cascade	 27	0.547450272919978	1	13	14	6711	7425	1.01416154405446
GO:0031100	animal organ regeneration	 42	0.990225736217838	1	13	29	6711	7410	0.651960992606442
GO:0031102	neuron projection regeneration	  7	0.98898631085553	1	1	6	6723	7433	0.300905073510665
GO:0031103	axon regeneration	 11	0.0838548499097086	0.807895728316903	8	3	6716	7436	1.53188037423611
GO:0031105	septin complex	  6	0.297654371351411	1	4	2	6720	7437	1.40422367638311
GO:0031110	regulation of microtubule polymerization or depolymerization	  7	0.0474968970055936	0.646585116783694	6	1	6718	7438	1.80543044106399
GO:0031113	regulation of microtubule polymerization	  6	0.607836179256654	1	3	3	6721	7436	1.05316775728733
GO:0031115	negative regulation of microtubule polymerization	 11	0.0838548499097086	0.807895728316903	8	3	6716	7436	1.53188037423611
GO:0031116	positive regulation of microtubule polymerization	 17	0.243621618961318	1	10	7	6714	7432	1.23902089092627
GO:0031118	rRNA pseudouridine synthesis	  5	0.452745275304033	1	3	2	6721	7437	1.26380130874479
GO:0031119	tRNA pseudouridine synthesis	  7	0.730029012673872	1	3	4	6721	7435	0.902715220531996
GO:0031122	cytoplasmic microtubule organization	 29	0.391787364159249	1	15	14	6709	7425	1.08948388684896
GO:0031124	mRNA 3	 48	0.005654598410677	0.335064747230886	32	16	6692	7423	1.40422367638311
GO:0031143	pseudopodium	 15	0.237875362689918	1	9	6	6715	7433	1.26380130874479
GO:0031145	anaphase-promoting complex-dependent catabolic process	 67	0.431995636460854	1	33	34	6691	7405	1.03744883553677
GO:0031146	SCF-dependent proteasomal ubiquitin-dependent protein catabolic process	 62	0.217216095681194	1	33	29	6691	7410	1.12111406420909
GO:0031167	rRNA methylation	 15	0.109100626262719	0.88413902838582	10	5	6714	7434	1.40422367638311
GO:0031201	SNARE complex	 45	0.00111643920418612	0.165233002219546	32	13	6692	7426	1.49783858814198
GO:0031209	SCAR complex	  8	0.952366339066048	1	2	6	6722	7433	0.526583878643665
GO:0031210	phosphatidylcholine binding	 15	0.972187308828691	1	4	11	6720	7428	0.561689470553242
GO:0031214	biomineral tissue development	 25	0.985872368040077	1	7	18	6717	7421	0.589773944080904
GO:0031224	intrinsic component of membrane	 14	0.956679005412873	1	4	10	6720	7429	0.601810147021331
GO:0031226	intrinsic component of plasma membrane	 28	0.966852873120196	1	9	19	6715	7420	0.677036415398997
GO:0031232	extrinsic component of external side of plasma membrane	  7	0.919244306193629	1	2	5	6722	7434	0.601810147021331
GO:0031234	extrinsic component of cytoplasmic side of plasma membrane	 69	0.706731900079853	1	31	38	6693	7401	0.946324651475571
GO:0031235	intrinsic component of the cytoplasmic side of the plasma membrane	 12	0.320810094151237	1	7	5	6717	7434	1.22869571683522
GO:0031252	cell leading edge	 47	0.701307255246909	1	21	26	6703	7413	0.941128634171656
GO:0031253	cell projection membrane	 10	0.133503266897558	0.919686434773344	7	3	6717	7436	1.47443486020226
GO:0031256	leading edge membrane	  7	0.98898631085553	1	1	6	6723	7433	0.300905073510665
GO:0031258	lamellipodium membrane	 18	0.832783288477324	1	7	11	6717	7428	0.819130477890145
GO:0031264	death-inducing signaling complex	  7	0.98898631085553	1	1	6	6723	7433	0.300905073510665
GO:0031265	CD95 death-inducing signaling complex	  6	0.865182793759413	1	2	4	6722	7435	0.702111838191553
GO:0031267	small GTPase binding	 19	0.127144513269886	0.919686434773344	12	7	6712	7432	1.33031716709978
GO:0031274	positive regulation of pseudopodium assembly	 12	0.5430601307694	1	6	6	6718	7433	1.05316775728733
GO:0031284	positive regulation of guanylate cyclase activity	  9	0.972243904416257	1	2	7	6722	7432	0.468074558794368
GO:0031290	retinal ganglion cell axon guidance	 14	0.529251719099727	1	7	7	6717	7432	1.05316775728733
GO:0031293	membrane protein intracellular domain proteolysis	 15	0.237875362689918	1	9	6	6715	7433	1.26380130874479
GO:0031295	T cell costimulation	 60	0.981506012696284	1	21	39	6703	7400	0.73721743010113
GO:0031297	replication fork processing	 21	0.407325414326014	1	11	10	6713	7429	1.10331860287244
GO:0031301	integral component of organelle membrane	  9	0.882794860340315	1	3	6	6721	7433	0.702111838191553
GO:0031305	integral component of mitochondrial inner membrane	 21	0.0609416617953418	0.764685373658072	14	7	6710	7432	1.40422367638311
GO:0031307	integral component of mitochondrial outer membrane	 18	0.0300950583180779	0.549711001936538	13	5	6711	7434	1.5212423160817
GO:0031313	extrinsic component of endosome membrane	  5	0.452745275304033	1	3	2	6721	7437	1.26380130874479
GO:0031314	extrinsic component of mitochondrial inner membrane	  6	0.607836179256654	1	3	3	6721	7436	1.05316775728733
GO:0031325	positive regulation of cellular metabolic process	  5	0.452745275304033	1	3	2	6721	7437	1.26380130874479
GO:0031333	negative regulation of protein complex assembly	 17	0.243621618961318	1	10	7	6714	7432	1.23902089092627
GO:0031334	positive regulation of protein complex assembly	 22	0.0957434892101259	0.843214701401555	14	8	6710	7431	1.3403953274566
GO:0031338	regulation of vesicle fusion	 35	0.38156969113121	1	18	17	6706	7422	1.0832582646384
GO:0031340	positive regulation of vesicle fusion	  7	0.187210848839696	0.949543953868825	5	2	6719	7437	1.50452536755333
GO:0031346	positive regulation of cell projection organization	  6	0.607836179256654	1	3	3	6721	7436	1.05316775728733
GO:0031362	anchored component of external side of plasma membrane	 11	0.990836032904502	1	2	9	6722	7430	0.382970093559029
GO:0031369	translation initiation factor binding	 19	0.592680980401227	1	9	10	6715	7429	0.997737875324838
GO:0031386	protein tag	  8	0.580280354503036	1	4	4	6720	7435	1.05316775728733
GO:0031390	Ctf18 RFC-like complex	  8	0.309544448231027	1	5	3	6719	7436	1.31645969660916
GO:0031396	regulation of protein ubiquitination	 13	0.230372725000093	1	8	5	6716	7434	1.29620647050748
GO:0031397	negative regulation of protein ubiquitination	 43	0.172656161739525	0.949543953868825	24	19	6700	7420	1.17562912441376
GO:0031398	positive regulation of protein ubiquitination	 57	0.660039179595297	1	26	31	6698	7408	0.960784620683177
GO:0031402	sodium ion binding	  9	0.206720270758876	0.983668097955673	6	3	6718	7436	1.40422367638311
GO:0031404	chloride ion binding	  7	0.919244306193629	1	2	5	6722	7434	0.601810147021331
GO:0031406	carboxylic acid binding	  9	0.882794860340315	1	3	6	6721	7433	0.702111838191553
GO:0031415	NatA complex	  5	0.157494903089267	0.919686434773344	4	1	6720	7438	1.68506841165973
GO:0031418	L-ascorbic acid binding	 17	0.607264962167558	1	8	9	6716	7430	0.991216712741015
GO:0031419	cobalamin binding	  7	0.730029012673872	1	3	4	6721	7435	0.902715220531996
GO:0031424	keratinization	 71	0.999999986399376	1	12	59	6712	7380	0.356000368660506
GO:0031428	box C/D snoRNP complex	  5	0.157494903089267	0.919686434773344	4	1	6720	7438	1.68506841165973
GO:0031429	box H/ACA snoRNP complex	  5	0.452745275304033	1	3	2	6721	7437	1.26380130874479
GO:0031430	M band	 24	0.780026211443039	1	10	14	6714	7425	0.877639797739441
GO:0031432	titin binding	  8	0.580280354503036	1	4	4	6720	7435	1.05316775728733
GO:0031433	telethonin binding	  6	0.979023167332401	1	1	5	6723	7434	0.351055919095776
GO:0031434	mitogen-activated protein kinase kinase binding	 15	0.237875362689918	1	9	6	6715	7433	1.26380130874479
GO:0031435	mitogen-activated protein kinase kinase kinase binding	 16	0.853260719975205	1	6	10	6718	7429	0.789875817965497
GO:0031442	positive regulation of mRNA 3	  6	0.979023167332401	1	1	5	6723	7434	0.351055919095776
GO:0031461	cullin-RING ubiquitin ligase complex	 11	0.000274998075234999	0.113377777875458	11	0	6713	7439	2.10633551457466
GO:0031462	Cul2-RING ubiquitin ligase complex	 10	0.0390070262266277	0.625040317669623	8	2	6716	7437	1.68506841165973
GO:0031463	Cul3-RING ubiquitin ligase complex	 60	0.0345269011561827	0.599479186247127	36	24	6688	7415	1.26380130874479
GO:0031464	Cul4A-RING E3 ubiquitin ligase complex	 10	0.000579691355198234	0.129194878970953	10	0	6714	7439	2.10633551457466
GO:0031466	Cul5-RING ubiquitin ligase complex	  7	0.187210848839696	0.949543953868825	5	2	6719	7437	1.50452536755333
GO:0031468	nuclear envelope reassembly	  7	0.444912401367032	1	4	3	6720	7436	1.20362029404266
GO:0031489	myosin V binding	 17	0.0147291857704758	0.464573006924516	13	4	6711	7435	1.61072715820415
GO:0031490	chromatin DNA binding	 50	0.736571156986416	1	22	28	6702	7411	0.926787626412849
GO:0031491	nucleosome binding	 18	0.0811513291101853	0.807895728316903	12	6	6712	7433	1.40422367638311
GO:0031492	nucleosomal DNA binding	 28	0.855143171976428	1	11	17	6713	7422	0.82748895215433
GO:0031497	chromatin assembly	  8	0.819878207576373	1	3	5	6721	7434	0.789875817965497
GO:0031514	motile cilium	 62	0.772368819085306	1	27	35	6697	7404	0.917275143443803
GO:0031519	PcG protein complex	 21	0.25155850170495	1	12	9	6712	7430	1.20362029404266
GO:0031526	brush border membrane	 39	0.947441359711541	1	14	25	6710	7414	0.756120441129364
GO:0031527	filopodium membrane	 15	0.798298186583662	1	6	9	6718	7430	0.842534205829863
GO:0031528	microvillus membrane	 19	0.99923742604504	1	3	16	6721	7423	0.332579291774946
GO:0031529	ruffle organization	 14	0.529251719099727	1	7	7	6717	7432	1.05316775728733
GO:0031532	actin cytoskeleton reorganization	 44	0.312693872692444	1	23	21	6701	7418	1.10103901898221
GO:0031571	mitotic G1 DNA damage checkpoint	  9	0.996964464269463	1	1	8	6723	7431	0.234037279397184
GO:0031572	G2 DNA damage checkpoint	 14	0.323388997222084	1	8	6	6716	7433	1.20362029404266
GO:0031573	intra-S DNA damage checkpoint	 13	0.822979434145659	1	5	8	6719	7431	0.810129044067176
GO:0031579	membrane raft organization	  5	0.77940058892516	1	2	3	6722	7436	0.842534205829863
GO:0031581	hemidesmosome assembly	  9	0.972243904416257	1	2	7	6722	7432	0.468074558794368
GO:0031584	activation of phospholipase D activity	  6	0.297654371351411	1	4	2	6720	7437	1.40422367638311
GO:0031588	nucleotide-activated protein kinase complex	 10	0.0390070262266277	0.625040317669623	8	2	6716	7437	1.68506841165973
GO:0031589	cell-substrate adhesion	 14	0.998346203775137	1	2	12	6722	7427	0.300905073510665
GO:0031593	polyubiquitin modification-dependent protein binding	 21	0.738560418161868	1	9	12	6715	7427	0.902715220531996
GO:0031594	neuromuscular junction	 52	0.144433128315724	0.919686434773344	29	23	6695	7416	1.17468711389741
GO:0031595	nuclear proteasome complex	  6	0.979023167332401	1	1	5	6723	7434	0.351055919095776
GO:0031597	cytosolic proteasome complex	  7	0.730029012673872	1	3	4	6721	7435	0.902715220531996
GO:0031616	spindle pole centrosome	 11	0.850917330440019	1	4	7	6720	7432	0.765940187118057
GO:0031618	nuclear pericentric heterochromatin	  7	0.187210848839696	0.949543953868825	5	2	6719	7437	1.50452536755333
GO:0031623	receptor internalization	 36	0.701531598327634	1	16	20	6708	7419	0.936149117588737
GO:0031624	ubiquitin conjugating enzyme binding	 34	0.124123412353081	0.919686434773344	20	14	6704	7425	1.23902089092627
GO:0031629	synaptic vesicle fusion to presynaptic active zone membrane	 11	0.220387996626296	1	7	4	6717	7435	1.3403953274566
GO:0031638	zymogen activation	  7	0.919244306193629	1	2	5	6722	7434	0.601810147021331
GO:0031639	plasminogen activation	  8	0.952366339066048	1	2	6	6722	7433	0.526583878643665
GO:0031640	killing of cells of other organism	 16	0.982365044000861	1	4	12	6720	7427	0.526583878643665
GO:0031641	regulation of myelination	 12	0.971055765853963	1	3	9	6721	7430	0.526583878643665
GO:0031642	negative regulation of myelination	  6	0.607836179256654	1	3	3	6721	7436	1.05316775728733
GO:0031643	positive regulation of myelination	 12	0.5430601307694	1	6	6	6718	7433	1.05316775728733
GO:0031647	regulation of protein stability	 58	0.703435029123524	1	26	32	6698	7407	0.944219368602433
GO:0031648	protein destabilization	 36	0.0702499206658422	0.807895728316903	22	14	6702	7425	1.28720503668451
GO:0031659	positive regulation of cyclin-dependent protein serine/threonine kinase activity involved in G1/S transition of mitotic cell cycle	  6	0.607836179256654	1	3	3	6721	7436	1.05316775728733
GO:0031663	lipopolysaccharide-mediated signaling pathway	 29	0.97655715776058	1	9	20	6715	7419	0.653690332109377
GO:0031665	negative regulation of lipopolysaccharide-mediated signaling pathway	  9	0.972243904416257	1	2	7	6722	7432	0.468074558794368
GO:0031666	positive regulation of lipopolysaccharide-mediated signaling pathway	  7	0.919244306193629	1	2	5	6722	7434	0.601810147021331
GO:0031667	response to nutrient levels	 45	0.999579639370924	1	11	34	6713	7405	0.514882014673805
GO:0031668	cellular response to extracellular stimulus	 17	0.895242422289557	1	6	11	6718	7428	0.743412534555762
GO:0031669	cellular response to nutrient levels	 11	0.665993939534306	1	5	6	6719	7433	0.957425233897572
GO:0031672	A band	 12	0.5430601307694	1	6	6	6718	7433	1.05316775728733
GO:0031674	I band	 20	0.989190352963028	1	5	15	6719	7424	0.526583878643665
GO:0031681	G-protein beta-subunit binding	  8	0.025392299605826	0.495149842313607	7	1	6717	7438	1.84304357525283
GO:0031683	G-protein beta/gamma-subunit complex binding	 19	0.877279625799761	1	7	12	6717	7427	0.776018347474874
GO:0031694	alpha-2A adrenergic receptor binding	  5	0.452745275304033	1	3	2	6721	7437	1.26380130874479
GO:0031702	type 1 angiotensin receptor binding	 10	0.316545776550851	1	6	4	6718	7435	1.26380130874479
GO:0031730	CCR5 chemokine receptor binding	  5	0.452745275304033	1	3	2	6721	7437	1.26380130874479
GO:0031748	D1 dopamine receptor binding	  6	0.297654371351411	1	4	2	6720	7437	1.40422367638311
GO:0031848	protection from non-homologous end joining at telomere	  7	0.730029012673872	1	3	4	6721	7435	0.902715220531996
GO:0031902	late endosome membrane	 93	0.0629759273256812	0.772066334068511	52	41	6672	7398	1.17773598664389
GO:0031904	endosome lumen	 13	0.230372725000093	1	8	5	6716	7434	1.29620647050748
GO:0031915	positive regulation of synaptic plasticity	  9	0.206720270758876	0.983668097955673	6	3	6718	7436	1.40422367638311
GO:0031929	TOR signaling	 13	0.230372725000093	1	8	5	6716	7434	1.29620647050748
GO:0031931	TORC1 complex	  7	0.730029012673872	1	3	4	6721	7435	0.902715220531996
GO:0031932	TORC2 complex	 11	0.220387996626296	1	7	4	6717	7435	1.3403953274566
GO:0031941	filamentous actin	 25	0.399232431223553	1	13	12	6711	7427	1.09529446757882
GO:0031953	negative regulation of protein autophosphorylation	  8	0.994217735396885	1	1	7	6723	7432	0.263291939321832
GO:0031954	positive regulation of protein autophosphorylation	 17	0.960992303738273	1	5	12	6719	7427	0.619510445463135
GO:0031957	very long-chain fatty acid-CoA ligase activity	  8	0.580280354503036	1	4	4	6720	7435	1.05316775728733
GO:0031960	response to corticosteroid	  6	1	1	0	6	6724	7433	0
GO:0031985	Golgi cisterna	  9	0.438074670071218	1	5	4	6719	7435	1.17018639698592
GO:0031987	locomotion involved in locomotory behavior	  5	0.77940058892516	1	2	3	6722	7436	0.842534205829863
GO:0031994	insulin-like growth factor I binding	 12	0.971055765853963	1	3	9	6721	7430	0.526583878643665
GO:0031995	insulin-like growth factor II binding	  8	0.952366339066048	1	2	6	6722	7433	0.526583878643665
GO:0031996	thioesterase binding	  9	0.206720270758876	0.983668097955673	6	3	6718	7436	1.40422367638311
GO:0032000	positive regulation of fatty acid beta-oxidation	  9	0.206720270758876	0.983668097955673	6	3	6718	7436	1.40422367638311
GO:0032006	regulation of TOR signaling	 16	0.324860333233664	1	9	7	6715	7432	1.18481372694825
GO:0032007	negative regulation of TOR signaling	 27	0.150496283020169	0.919686434773344	16	11	6708	7428	1.24819882345165
GO:0032008	positive regulation of TOR signaling	 27	0.0776311536569698	0.807895728316903	17	10	6707	7429	1.32621124991738
GO:0032009	early phagosome	  7	0.730029012673872	1	3	4	6721	7435	0.902715220531996
GO:0032012	regulation of ARF protein signal transduction	 16	0.170220385600338	0.949543953868825	10	6	6714	7433	1.31645969660916
GO:0032020	ISG15-protein conjugation	  5	0.960049771736903	1	1	4	6723	7435	0.421267102914932
GO:0032024	positive regulation of insulin secretion	 38	0.568620924038179	1	18	20	6706	7419	0.997737875324838
GO:0032025	response to cobalt ion	  6	0.297654371351411	1	4	2	6720	7437	1.40422367638311
GO:0032026	response to magnesium ion	 12	0.899474094191123	1	4	8	6720	7431	0.702111838191553
GO:0032036	myosin heavy chain binding	  6	0.979023167332401	1	1	5	6723	7434	0.351055919095776
GO:0032039	integrator complex	 12	0.148657926965624	0.919686434773344	8	4	6716	7435	1.40422367638311
GO:0032040	small-subunit processome	 30	0.322199322975026	1	16	14	6708	7425	1.12337894110648
GO:0032041	NAD-dependent histone deacetylase activity (H3-K14 specific)	 11	0.665993939534306	1	5	6	6719	7433	0.957425233897572
GO:0032045	guanyl-nucleotide exchange factor complex	 11	0.665993939534306	1	5	6	6719	7433	0.957425233897572
GO:0032049	cardiolipin biosynthetic process	  7	0.187210848839696	0.949543953868825	5	2	6719	7437	1.50452536755333
GO:0032050	clathrin heavy chain binding	  7	0.444912401367032	1	4	3	6720	7436	1.20362029404266
GO:0032051	clathrin light chain binding	  7	0.00542743198931091	0.334473021939644	7	0	6717	7439	2.10633551457466
GO:0032052	bile acid binding	  5	0.960049771736903	1	1	4	6723	7435	0.421267102914932
GO:0032057	negative regulation of translational initiation in response to stress	  6	0.607836179256654	1	3	3	6721	7436	1.05316775728733
GO:0032059	bleb	  8	0.819878207576373	1	3	5	6721	7434	0.789875817965497
GO:0032060	bleb assembly	 10	0.559603563591584	1	5	5	6719	7434	1.05316775728733
GO:0032088	negative regulation of NF-kappaB transcription factor activity	 60	0.59984399808945	1	28	32	6696	7407	0.982956573468174
GO:0032091	negative regulation of protein binding	 57	0.96026591584122	1	21	36	6703	7403	0.776018347474874
GO:0032092	positive regulation of protein binding	 59	0.652598944449722	1	27	32	6697	7407	0.963916252432471
GO:0032094	response to food	 15	0.914031171019375	1	5	10	6719	7429	0.702111838191553
GO:0032098	regulation of appetite	  6	0.979023167332401	1	1	5	6723	7434	0.351055919095776
GO:0032099	negative regulation of appetite	  5	0.157494903089267	0.919686434773344	4	1	6720	7438	1.68506841165973
GO:0032147	activation of protein kinase activity	 60	0.59984399808945	1	28	32	6696	7407	0.982956573468174
GO:0032148	activation of protein kinase B activity	 24	0.481410334966146	1	12	12	6712	7427	1.05316775728733
GO:0032154	cleavage furrow	 43	0.172656161739525	0.949543953868825	24	19	6700	7420	1.17562912441376
GO:0032182	ubiquitin-like protein binding	  5	0.157494903089267	0.919686434773344	4	1	6720	7438	1.68506841165973
GO:0032183	SUMO binding	  8	0.025392299605826	0.495149842313607	7	1	6717	7438	1.84304357525283
GO:0032200	telomere organization	  7	0.919244306193629	1	2	5	6722	7434	0.601810147021331
GO:0032201	telomere maintenance via semi-conservative replication	 21	0.57968055192832	1	10	11	6714	7428	1.00301691170222
GO:0032204	regulation of telomere maintenance	 11	0.665993939534306	1	5	6	6719	7433	0.957425233897572
GO:0032206	positive regulation of telomere maintenance	  6	0.297654371351411	1	4	2	6720	7437	1.40422367638311
GO:0032210	regulation of telomere maintenance via telomerase	  6	0.607836179256654	1	3	3	6721	7436	1.05316775728733
GO:0032211	negative regulation of telomere maintenance via telomerase	 19	0.248077880408704	1	11	8	6713	7431	1.2194574031748
GO:0032212	positive regulation of telomere maintenance via telomerase	 33	0.00288091025506702	0.244538441062453	24	9	6700	7430	1.53188037423611
GO:0032228	regulation of synaptic transmission, GABAergic	 11	0.431935112460319	1	6	5	6718	7434	1.14891028067709
GO:0032229	negative regulation of synaptic transmission, GABAergic	  5	0.157494903089267	0.919686434773344	4	1	6720	7438	1.68506841165973
GO:0032230	positive regulation of synaptic transmission, GABAergic	 11	0.953160347938253	1	3	8	6721	7431	0.574455140338543
GO:0032233	positive regulation of actin filament bundle assembly	 10	0.316545776550851	1	6	4	6718	7435	1.26380130874479
GO:0032266	phosphatidylinositol-3-phosphate binding	 29	0.538368194874272	1	14	15	6710	7424	1.0168516277257
GO:0032270	positive regulation of cellular protein metabolic process	 14	0.998346203775137	1	2	12	6722	7427	0.300905073510665
GO:0032279	asymmetric synapse	  7	0.730029012673872	1	3	4	6721	7435	0.902715220531996
GO:0032281	AMPA glutamate receptor complex	 24	0.0460940683228998	0.646585116783694	16	8	6708	7431	1.40422367638311
GO:0032287	peripheral nervous system myelin maintenance	  7	0.444912401367032	1	4	3	6720	7436	1.20362029404266
GO:0032288	myelin assembly	  6	0.607836179256654	1	3	3	6721	7436	1.05316775728733
GO:0032308	positive regulation of prostaglandin secretion	  5	0.77940058892516	1	2	3	6722	7436	0.842534205829863
GO:0032324	molybdopterin cofactor biosynthetic process	  5	0.452745275304033	1	3	2	6721	7437	1.26380130874479
GO:0032330	regulation of chondrocyte differentiation	  7	0.444912401367032	1	4	3	6720	7436	1.20362029404266
GO:0032331	negative regulation of chondrocyte differentiation	 14	0.956679005412873	1	4	10	6720	7429	0.601810147021331
GO:0032332	positive regulation of chondrocyte differentiation	 15	0.914031171019375	1	5	10	6719	7429	0.702111838191553
GO:0032355	response to estradiol	 86	0.996515976109521	1	29	57	6695	7382	0.710275929333315
GO:0032364	oxygen homeostasis	  6	0.865182793759413	1	2	4	6722	7435	0.702111838191553
GO:0032367	intracellular cholesterol transport	  5	0.452745275304033	1	3	2	6721	7437	1.26380130874479
GO:0032391	photoreceptor connecting cilium	 31	0.0422584590581389	0.646585116783694	20	11	6704	7428	1.35892613843526
GO:0032395	MHC class II receptor activity	  6	0.865182793759413	1	2	4	6722	7435	0.702111838191553
GO:0032400	melanosome localization	  5	0.452745275304033	1	3	2	6721	7437	1.26380130874479
GO:0032402	melanosome transport	 19	0.0543219716836929	0.703764658430297	13	6	6711	7433	1.44117693102477
GO:0032410	negative regulation of transporter activity	  5	0.0241003244622537	0.495149842313607	5	0	6719	7439	2.10633551457466
GO:0032411	positive regulation of transporter activity	  5	0.157494903089267	0.919686434773344	4	1	6720	7438	1.68506841165973
GO:0032418	lysosome localization	 16	0.0724287706601472	0.807895728316903	11	5	6713	7434	1.44810566627008
GO:0032420	stereocilium	 27	0.693189244333171	1	12	15	6712	7424	0.936149117588737
GO:0032426	stereocilium tip	  6	0.865182793759413	1	2	4	6722	7435	0.702111838191553
GO:0032432	actin filament bundle	  8	0.819878207576373	1	3	5	6721	7434	0.789875817965497
GO:0032433	filopodium tip	 13	0.933471720877997	1	4	9	6720	7430	0.648103235253741
GO:0032434	regulation of proteasomal ubiquitin-dependent protein catabolic process	 10	0.316545776550851	1	6	4	6718	7435	1.26380130874479
GO:0032435	negative regulation of proteasomal ubiquitin-dependent protein catabolic process	 21	0.407325414326014	1	11	10	6713	7429	1.10331860287244
GO:0032436	positive regulation of proteasomal ubiquitin-dependent protein catabolic process	 70	0.103213662895329	0.873532642568676	39	31	6685	7408	1.1735297866916
GO:0032438	melanosome organization	 18	0.178063825749389	0.949543953868825	11	7	6713	7432	1.28720503668451
GO:0032452	histone demethylase activity	 22	0.796326194402031	1	9	13	6715	7426	0.861682710507815
GO:0032453	histone demethylase activity (H3-K4 specific)	  6	0.979023167332401	1	1	5	6723	7434	0.351055919095776
GO:0032454	histone demethylase activity (H3-K9 specific)	 11	0.953160347938253	1	3	8	6721	7431	0.574455140338543
GO:0032456	endocytic recycling	 24	0.324965824259735	1	13	11	6711	7428	1.14093173706127
GO:0032460	negative regulation of protein oligomerization	  5	0.77940058892516	1	2	3	6722	7436	0.842534205829863
GO:0032461	positive regulation of protein oligomerization	 11	0.665993939534306	1	5	6	6719	7433	0.957425233897572
GO:0032463	negative regulation of protein homooligomerization	  5	0.77940058892516	1	2	3	6722	7436	0.842534205829863
GO:0032464	positive regulation of protein homooligomerization	 10	0.78367246101976	1	4	6	6720	7433	0.842534205829863
GO:0032465	regulation of cytokinesis	 18	0.687525801418504	1	8	10	6716	7429	0.936149117588737
GO:0032467	positive regulation of cytokinesis	 21	0.407325414326014	1	11	10	6713	7429	1.10331860287244
GO:0032469	endoplasmic reticulum calcium ion homeostasis	 14	0.323388997222084	1	8	6	6716	7433	1.20362029404266
GO:0032471	negative regulation of endoplasmic reticulum calcium ion concentration	  9	0.882794860340315	1	3	6	6721	7433	0.702111838191553
GO:0032479	regulation of type I interferon production	 15	0.798298186583662	1	6	9	6718	7430	0.842534205829863
GO:0032480	negative regulation of type I interferon production	 31	0.388266848384344	1	16	15	6708	7424	1.08714091074821
GO:0032481	positive regulation of type I interferon production	 49	0.360911040306687	1	25	24	6699	7415	1.07466097682381
GO:0032486	Rap protein signal transduction	  8	0.580280354503036	1	4	4	6720	7435	1.05316775728733
GO:0032494	response to peptidoglycan	  6	1	1	0	6	6724	7433	0
GO:0032495	response to muramyl dipeptide	 11	0.665993939534306	1	5	6	6719	7433	0.957425233897572
GO:0032502	developmental process	 21	0.25155850170495	1	12	9	6712	7430	1.20362029404266
GO:0032508	DNA duplex unwinding	 41	0.103180061828763	0.873532642568676	24	17	6700	7422	1.23297688658029
GO:0032515	negative regulation of phosphoprotein phosphatase activity	 12	0.5430601307694	1	6	6	6718	7433	1.05316775728733
GO:0032516	positive regulation of phosphoprotein phosphatase activity	  9	0.438074670071218	1	5	4	6719	7435	1.17018639698592
GO:0032525	somite rostral/caudal axis specification	  8	0.819878207576373	1	3	5	6721	7434	0.789875817965497
GO:0032526	response to retinoic acid	 34	0.945955639398543	1	12	22	6712	7417	0.743412534555762
GO:0032532	regulation of microvillus length	  7	1	1	0	7	6724	7432	0
GO:0032534	regulation of microvillus assembly	  5	0.452745275304033	1	3	2	6721	7437	1.26380130874479
GO:0032541	cortical endoplasmic reticulum	  5	0.452745275304033	1	3	2	6721	7437	1.26380130874479
GO:0032543	mitochondrial translation	 27	0.150496283020169	0.919686434773344	16	11	6708	7428	1.24819882345165
GO:0032570	response to progesterone	 33	0.999898125355243	1	6	27	6718	7412	0.382970093559029
GO:0032580	Golgi cisterna membrane	 63	0.00754263964913917	0.365849714746482	40	23	6684	7416	1.33735588226962
GO:0032584	growth cone membrane	  7	0.444912401367032	1	4	3	6720	7436	1.20362029404266
GO:0032585	multivesicular body membrane	  8	0.113810689204897	0.88413902838582	6	2	6718	7437	1.57975163593099
GO:0032587	ruffle membrane	 78	0.931785456230798	1	31	47	6693	7392	0.837133345536082
GO:0032588	trans-Golgi network membrane	 71	0.00973708499053196	0.427208830906354	44	27	6680	7412	1.30533468508852
GO:0032590	dendrite membrane	 14	0.0625726545054608	0.771729405567349	10	4	6714	7435	1.50452536755333
GO:0032591	dendritic spine membrane	 11	0.665993939534306	1	5	6	6719	7433	0.957425233897572
GO:0032592	integral component of mitochondrial membrane	  7	0.187210848839696	0.949543953868825	5	2	6719	7437	1.50452536755333
GO:0032593	insulin-responsive compartment	  6	0.607836179256654	1	3	3	6721	7436	1.05316775728733
GO:0032680	regulation of tumor necrosis factor production	  6	0.865182793759413	1	2	4	6722	7435	0.702111838191553
GO:0032688	negative regulation of interferon-beta production	  8	0.819878207576373	1	3	5	6721	7434	0.789875817965497
GO:0032689	negative regulation of interferon-gamma production	 19	0.949176156916864	1	6	13	6718	7426	0.665158583549892
GO:0032691	negative regulation of interleukin-1 beta production	  7	0.98898631085553	1	1	6	6723	7433	0.300905073510665
GO:0032693	negative regulation of interleukin-10 production	  8	0.819878207576373	1	3	5	6721	7434	0.789875817965497
GO:0032695	negative regulation of interleukin-12 production	 10	0.925275888620553	1	3	7	6721	7432	0.631900654372397
GO:0032700	negative regulation of interleukin-17 production	  7	0.444912401367032	1	4	3	6720	7436	1.20362029404266
GO:0032703	negative regulation of interleukin-2 production	  8	0.819878207576373	1	3	5	6721	7434	0.789875817965497
GO:0032715	negative regulation of interleukin-6 production	 20	0.911428444807446	1	7	13	6717	7426	0.73721743010113
GO:0032720	negative regulation of tumor necrosis factor production	 30	0.737235950138567	1	13	17	6711	7422	0.912745389649018
GO:0032722	positive regulation of chemokine production	 14	0.728526098434397	1	6	8	6718	7431	0.902715220531996
GO:0032727	positive regulation of interferon-alpha production	 11	0.850917330440019	1	4	7	6720	7432	0.765940187118057
GO:0032728	positive regulation of interferon-beta production	 26	0.62841636814953	1	12	14	6712	7425	0.972154852880611
GO:0032729	positive regulation of interferon-gamma production	 31	0.97128444080747	1	10	21	6714	7418	0.679463069217632
GO:0032731	positive regulation of interleukin-1 beta production	  8	0.309544448231027	1	5	3	6719	7436	1.31645969660916
GO:0032733	positive regulation of interleukin-10 production	 16	0.853260719975205	1	6	10	6718	7429	0.789875817965497
GO:0032735	positive regulation of interleukin-12 production	 16	0.982365044000861	1	4	12	6720	7427	0.526583878643665
GO:0032736	positive regulation of interleukin-13 production	  5	1	1	0	5	6724	7434	0
GO:0032740	positive regulation of interleukin-17 production	  7	0.98898631085553	1	1	6	6723	7433	0.300905073510665
GO:0032743	positive regulation of interleukin-2 production	 13	0.643122793005253	1	6	7	6718	7432	0.972154852880611
GO:0032753	positive regulation of interleukin-4 production	 14	0.956679005412873	1	4	10	6720	7429	0.601810147021331
GO:0032754	positive regulation of interleukin-5 production	  6	1	1	0	6	6724	7433	0
GO:0032755	positive regulation of interleukin-6 production	 37	0.9910373833468	1	11	26	6713	7413	0.626207855684358
GO:0032757	positive regulation of interleukin-8 production	 21	0.937043249703464	1	7	14	6717	7425	0.702111838191553
GO:0032760	positive regulation of tumor necrosis factor production	 38	0.993731365992993	1	11	27	6713	7412	0.609728701587401
GO:0032780	negative regulation of ATPase activity	  9	0.69404490204849	1	4	5	6720	7434	0.936149117588737
GO:0032781	positive regulation of ATPase activity	 31	0.26026101790379	1	17	14	6707	7425	1.15508721766997
GO:0032784	regulation of DNA-templated transcription, elongation	 11	0.0838548499097086	0.807895728316903	8	3	6716	7436	1.53188037423611
GO:0032786	positive regulation of DNA-templated transcription, elongation	  8	0.580280354503036	1	4	4	6720	7435	1.05316775728733
GO:0032790	ribosome disassembly	  7	0.444912401367032	1	4	3	6720	7436	1.20362029404266
GO:0032793	positive regulation of CREB transcription factor activity	 13	0.230372725000093	1	8	5	6716	7434	1.29620647050748
GO:0032794	GTPase activating protein binding	 13	0.822979434145659	1	5	8	6719	7431	0.810129044067176
GO:0032797	SMN complex	 10	0.925275888620553	1	3	7	6721	7432	0.631900654372397
GO:0032801	receptor catabolic process	 12	0.971055765853963	1	3	9	6721	7430	0.526583878643665
GO:0032802	low-density lipoprotein particle receptor catabolic process	 10	0.00700161837131091	0.354502993326374	9	1	6715	7438	1.89570196311719
GO:0032808	lacrimal gland development	  5	0.157494903089267	0.919686434773344	4	1	6720	7438	1.68506841165973
GO:0032809	neuronal cell body membrane	 21	0.134279084429805	0.919686434773344	13	8	6711	7431	1.30392198521288
GO:0032813	tumor necrosis factor receptor superfamily binding	  5	0.960049771736903	1	1	4	6723	7435	0.421267102914932
GO:0032825	positive regulation of natural killer cell differentiation	  6	0.297654371351411	1	4	2	6720	7437	1.40422367638311
GO:0032835	glomerulus development	  7	0.730029012673872	1	3	4	6721	7435	0.902715220531996
GO:0032836	glomerular basement membrane development	  8	0.580280354503036	1	4	4	6720	7435	1.05316775728733
GO:0032839	dendrite cytoplasm	 19	0.00521417364603678	0.334473021939644	15	4	6709	7435	1.66289645887473
GO:0032868	response to insulin	 62	0.772368819085306	1	27	35	6697	7404	0.917275143443803
GO:0032869	cellular response to insulin stimulus	 74	0.374218666471818	1	37	37	6687	7402	1.05316775728733
GO:0032870	cellular response to hormone stimulus	 37	0.978436787719667	1	12	25	6712	7414	0.683135842564754
GO:0032872	regulation of stress-activated MAPK cascade	  8	0.819878207576373	1	3	5	6721	7434	0.789875817965497
GO:0032873	negative regulation of stress-activated MAPK cascade	  5	0.960049771736903	1	1	4	6723	7435	0.421267102914932
GO:0032874	positive regulation of stress-activated MAPK cascade	 17	0.243621618961318	1	10	7	6714	7432	1.23902089092627
GO:0032876	negative regulation of DNA endoreduplication	  5	0.77940058892516	1	2	3	6722	7436	0.842534205829863
GO:0032880	regulation of protein localization	 48	0.309683462977558	1	25	23	6699	7416	1.0970497471743
GO:0032886	regulation of microtubule-based process	  8	0.113810689204897	0.88413902838582	6	2	6718	7437	1.57975163593099
GO:0032897	negative regulation of viral transcription	 10	0.925275888620553	1	3	7	6721	7432	0.631900654372397
GO:0032914	positive regulation of transforming growth factor beta1 production	  5	0.77940058892516	1	2	3	6722	7436	0.842534205829863
GO:0032922	circadian regulation of gene expression	 50	0.820677799182351	1	21	29	6703	7410	0.884660916121356
GO:0032924	activin receptor signaling pathway	 14	0.529251719099727	1	7	7	6717	7432	1.05316775728733
GO:0032926	negative regulation of activin receptor signaling pathway	  6	0.865182793759413	1	2	4	6722	7435	0.702111838191553
GO:0032927	positive regulation of activin receptor signaling pathway	  6	0.607836179256654	1	3	3	6721	7436	1.05316775728733
GO:0032930	positive regulation of superoxide anion generation	 10	0.559603563591584	1	5	5	6719	7434	1.05316775728733
GO:0032933	SREBP signaling pathway	  7	0.919244306193629	1	2	5	6722	7434	0.601810147021331
GO:0032940	secretion by cell	  9	0.882794860340315	1	3	6	6721	7433	0.702111838191553
GO:0032947	protein complex scaffold activity	 40	0.0401507445605401	0.629755700009341	25	15	6699	7424	1.31645969660916
GO:0032956	regulation of actin cytoskeleton organization	 43	0.720084586280627	1	19	24	6705	7415	0.930706390160895
GO:0032958	inositol phosphate biosynthetic process	  5	0.452745275304033	1	3	2	6721	7437	1.26380130874479
GO:0032963	collagen metabolic process	 10	0.559603563591584	1	5	5	6719	7434	1.05316775728733
GO:0032964	collagen biosynthetic process	  6	0.979023167332401	1	1	5	6723	7434	0.351055919095776
GO:0032966	negative regulation of collagen biosynthetic process	  7	0.98898631085553	1	1	6	6723	7433	0.300905073510665
GO:0032967	positive regulation of collagen biosynthetic process	 17	0.997764322622395	1	3	14	6721	7425	0.371706267277881
GO:0032968	positive regulation of transcription elongation from RNA polymerase II promoter	 14	0.728526098434397	1	6	8	6718	7431	0.902715220531996
GO:0032981	mitochondrial respiratory chain complex I assembly	 53	0.00208569117567793	0.222937212333575	36	17	6688	7422	1.43071846272996
GO:0032982	myosin filament	 10	0.559603563591584	1	5	5	6719	7434	1.05316775728733
GO:0032993	protein-DNA complex	 37	0.0517779357449354	0.680779601639561	23	14	6701	7425	1.30934369824911
GO:0033004	negative regulation of mast cell activation	  5	0.960049771736903	1	1	4	6723	7435	0.421267102914932
GO:0033010	paranodal junction	  7	0.187210848839696	0.949543953868825	5	2	6719	7437	1.50452536755333
GO:0033014	tetrapyrrole biosynthetic process	  5	0.157494903089267	0.919686434773344	4	1	6720	7438	1.68506841165973
GO:0033017	sarcoplasmic reticulum membrane	 33	0.522004835191274	1	16	17	6708	7422	1.02125358282408
GO:0033018	sarcoplasmic reticulum lumen	  6	0.979023167332401	1	1	5	6723	7434	0.351055919095776
GO:0033038	bitter taste receptor activity	  6	0.607836179256654	1	3	3	6721	7436	1.05316775728733
GO:0033063	Rad51B-Rad51C-Rad51D-XRCC2 complex	  5	0.157494903089267	0.919686434773344	4	1	6720	7438	1.68506841165973
GO:0033077	T cell differentiation in thymus	 25	0.0725535511024713	0.807895728316903	16	9	6708	7430	1.34805472932778
GO:0033081	regulation of T cell differentiation in thymus	  5	0.0241003244622537	0.495149842313607	5	0	6719	7439	2.10633551457466
GO:0033085	negative regulation of T cell differentiation in thymus	  5	0.960049771736903	1	1	4	6723	7435	0.421267102914932
GO:0033088	negative regulation of immature T cell proliferation in thymus	  5	1	1	0	5	6724	7434	0
GO:0033089	positive regulation of T cell differentiation in thymus	  8	0.580280354503036	1	4	4	6720	7435	1.05316775728733
GO:0033093	Weibel-Palade body	  5	0.960049771736903	1	1	4	6723	7435	0.421267102914932
GO:0033108	mitochondrial respiratory chain complex assembly	  5	0.157494903089267	0.919686434773344	4	1	6720	7438	1.68506841165973
GO:0033116	endoplasmic reticulum-Golgi intermediate compartment membrane	 57	0.012317207846393	0.427208830906354	36	21	6688	7418	1.33031716709978
GO:0033120	positive regulation of RNA splicing	 10	0.133503266897558	0.919686434773344	7	3	6717	7436	1.47443486020226
GO:0033129	positive regulation of histone phosphorylation	  7	0.730029012673872	1	3	4	6721	7435	0.902715220531996
GO:0033130	acetylcholine receptor binding	  8	0.309544448231027	1	5	3	6719	7436	1.31645969660916
GO:0033132	negative regulation of glucokinase activity	  5	0.77940058892516	1	2	3	6722	7436	0.842534205829863
GO:0033133	positive regulation of glucokinase activity	  6	0.607836179256654	1	3	3	6721	7436	1.05316775728733
GO:0033135	regulation of peptidyl-serine phosphorylation	  7	0.730029012673872	1	3	4	6721	7435	0.902715220531996
GO:0033137	negative regulation of peptidyl-serine phosphorylation	 22	0.955871272394322	1	7	15	6717	7424	0.6701976637283
GO:0033138	positive regulation of peptidyl-serine phosphorylation	 72	0.377076499607311	1	36	36	6688	7403	1.05316775728733
GO:0033141	positive regulation of peptidyl-serine phosphorylation of STAT protein	  7	1	1	0	7	6724	7432	0
GO:0033146	regulation of intracellular estrogen receptor signaling pathway	 15	0.421118865258844	1	8	7	6716	7432	1.12337894110648
GO:0033147	negative regulation of intracellular estrogen receptor signaling pathway	 12	0.320810094151237	1	7	5	6717	7434	1.22869571683522
GO:0033148	positive regulation of intracellular estrogen receptor signaling pathway	  7	0.187210848839696	0.949543953868825	5	2	6719	7437	1.50452536755333
GO:0033151	V(D)J recombination	  7	0.187210848839696	0.949543953868825	5	2	6719	7437	1.50452536755333
GO:0033153	T cell receptor V(D)J recombination	  5	0.0241003244622537	0.495149842313607	5	0	6719	7439	2.10633551457466
GO:0033157	regulation of intracellular protein transport	  5	0.77940058892516	1	2	3	6722	7436	0.842534205829863
GO:0033160	positive regulation of protein import into nucleus, translocation	 11	0.0838548499097086	0.807895728316903	8	3	6716	7436	1.53188037423611
GO:0033162	melanosome membrane	  8	0.309544448231027	1	5	3	6719	7436	1.31645969660916
GO:0033169	histone H3-K9 demethylation	 12	0.971055765853963	1	3	9	6721	7430	0.526583878643665
GO:0033173	calcineurin-NFAT signaling cascade	  8	0.580280354503036	1	4	4	6720	7435	1.05316775728733
GO:0033179	proton-transporting V-type ATPase, V0 domain	  8	0.025392299605826	0.495149842313607	7	1	6717	7438	1.84304357525283
GO:0033180	proton-transporting V-type ATPase, V1 domain	  7	0.187210848839696	0.949543953868825	5	2	6719	7437	1.50452536755333
GO:0033189	response to vitamin A	 16	0.996207313649143	1	3	13	6721	7426	0.394937908982748
GO:0033194	response to hydroperoxide	  6	0.0874151689581943	0.807895728316903	5	1	6719	7438	1.75527959547888
GO:0033197	response to vitamin E	  9	0.69404490204849	1	4	5	6720	7434	0.936149117588737
GO:0033198	response to ATP	 16	0.853260719975205	1	6	10	6718	7429	0.789875817965497
GO:0033210	leptin-mediated signaling pathway	  7	0.187210848839696	0.949543953868825	5	2	6719	7437	1.50452536755333
GO:0033227	dsRNA transport	  5	0.77940058892516	1	2	3	6722	7436	0.842534205829863
GO:0033234	negative regulation of protein sumoylation	  6	0.607836179256654	1	3	3	6721	7436	1.05316775728733
GO:0033235	positive regulation of protein sumoylation	  7	0.444912401367032	1	4	3	6720	7436	1.20362029404266
GO:0033256	I-kappaB/NF-kappaB complex	  5	0.77940058892516	1	2	3	6722	7436	0.842534205829863
GO:0033263	CORVET complex	  5	0.157494903089267	0.919686434773344	4	1	6720	7438	1.68506841165973
GO:0033268	node of Ranvier	 15	0.237875362689918	1	9	6	6715	7433	1.26380130874479
GO:0033270	paranode region of axon	 11	0.665993939534306	1	5	6	6719	7433	0.957425233897572
GO:0033276	transcription factor TFTC complex	 14	0.728526098434397	1	6	8	6718	7431	0.902715220531996
GO:0033280	response to vitamin D	 15	0.999074560034374	1	2	13	6722	7426	0.280844735276621
GO:0033290	eukaryotic 48S preinitiation complex	  7	0.444912401367032	1	4	3	6720	7436	1.20362029404266
GO:0033314	mitotic DNA replication checkpoint	  7	0.730029012673872	1	3	4	6721	7435	0.902715220531996
GO:0033327	Leydig cell differentiation	 10	0.78367246101976	1	4	6	6720	7433	0.842534205829863
GO:0033344	cholesterol efflux	 19	0.983231201677496	1	5	14	6719	7425	0.55429881962491
GO:0033365	protein localization to organelle	 14	0.323388997222084	1	8	6	6716	7433	1.20362029404266
GO:0033391	chromatoid body	 10	0.559603563591584	1	5	5	6719	7434	1.05316775728733
GO:0033503	HULC complex	  5	0.452745275304033	1	3	2	6721	7437	1.26380130874479
GO:0033504	floor plate development	  5	0.77940058892516	1	2	3	6722	7436	0.842534205829863
GO:0033523	histone H2B ubiquitination	  8	0.994217735396885	1	1	7	6723	7432	0.263291939321832
GO:0033539	fatty acid beta-oxidation using acyl-CoA dehydrogenase	 10	0.559603563591584	1	5	5	6719	7434	1.05316775728733
GO:0033540	fatty acid beta-oxidation using acyl-CoA oxidase	 12	0.75380380293781	1	5	7	6719	7432	0.877639797739441
GO:0033553	rDNA heterochromatin	  5	0.452745275304033	1	3	2	6721	7437	1.26380130874479
GO:0033555	multicellular organismal response to stress	  6	0.0874151689581943	0.807895728316903	5	1	6719	7438	1.75527959547888
GO:0033558	protein deacetylase activity	 11	0.953160347938253	1	3	8	6721	7431	0.574455140338543
GO:0033564	anterior/posterior axon guidance	  5	0.452745275304033	1	3	2	6721	7437	1.26380130874479
GO:0033572	transferrin transport	 30	0.000266605877309511	0.113377777875458	24	6	6700	7433	1.68506841165973
GO:0033574	response to testosterone	 29	0.888691094451083	1	11	18	6713	7421	0.798954850355905
GO:0033588	Elongator holoenzyme complex	  6	0.607836179256654	1	3	3	6721	7436	1.05316775728733
GO:0033591	response to L-ascorbic acid	  5	1	1	0	5	6724	7434	0
GO:0033598	mammary gland epithelial cell proliferation	  9	0.972243904416257	1	2	7	6722	7432	0.468074558794368
GO:0033601	positive regulation of mammary gland epithelial cell proliferation	  7	0.187210848839696	0.949543953868825	5	2	6719	7437	1.50452536755333
GO:0033603	positive regulation of dopamine secretion	  6	0.607836179256654	1	3	3	6721	7436	1.05316775728733
GO:0033613	activating transcription factor binding	 28	0.925771692110364	1	10	18	6714	7421	0.752262683776664
GO:0033617	mitochondrial respiratory chain complex IV assembly	 12	0.148657926965624	0.919686434773344	8	4	6716	7435	1.40422367638311
GO:0033619	membrane protein proteolysis	  8	0.580280354503036	1	4	4	6720	7435	1.05316775728733
GO:0033622	integrin activation	  8	0.113810689204897	0.88413902838582	6	2	6718	7437	1.57975163593099
GO:0033627	cell adhesion mediated by integrin	 11	0.953160347938253	1	3	8	6721	7431	0.574455140338543
GO:0033628	regulation of cell adhesion mediated by integrin	 10	0.78367246101976	1	4	6	6720	7433	0.842534205829863
GO:0033629	negative regulation of cell adhesion mediated by integrin	  6	0.607836179256654	1	3	3	6721	7436	1.05316775728733
GO:0033630	positive regulation of cell adhesion mediated by integrin	 13	0.933471720877997	1	4	9	6720	7430	0.648103235253741
GO:0033673	negative regulation of kinase activity	  8	0.113810689204897	0.88413902838582	6	2	6718	7437	1.57975163593099
GO:0033674	positive regulation of kinase activity	 14	0.956679005412873	1	4	10	6720	7429	0.601810147021331
GO:0033683	nucleotide-excision repair, DNA incision	 32	0.000389040039453431	0.129194878970953	25	7	6699	7432	1.64557462076145
GO:0033689	negative regulation of osteoblast proliferation	  8	0.025392299605826	0.495149842313607	7	1	6717	7438	1.84304357525283
GO:0033690	positive regulation of osteoblast proliferation	 11	0.990836032904502	1	2	9	6722	7430	0.382970093559029
GO:0033691	sialic acid binding	  8	0.819878207576373	1	3	5	6721	7434	0.789875817965497
GO:0033700	phospholipid efflux	  7	0.98898631085553	1	1	6	6723	7433	0.300905073510665
GO:0033762	response to glucagon	  9	0.69404490204849	1	4	5	6720	7434	0.936149117588737
GO:0033864	positive regulation of NAD(P)H oxidase activity	  5	0.77940058892516	1	2	3	6722	7436	0.842534205829863
GO:0033962	cytoplasmic mRNA processing body assembly	 12	0.148657926965624	0.919686434773344	8	4	6716	7435	1.40422367638311
GO:0033993	response to lipid	 12	0.971055765853963	1	3	9	6721	7430	0.526583878643665
GO:0034045	pre-autophagosomal structure membrane	 14	0.323388997222084	1	8	6	6716	7433	1.20362029404266
GO:0034046	poly(G) binding	  6	0.297654371351411	1	4	2	6720	7437	1.40422367638311
GO:0034058	endosomal vesicle fusion	  9	0.0134026999423743	0.442059337527911	8	1	6716	7438	1.87229823517747
GO:0034063	stress granule assembly	 11	0.0838548499097086	0.807895728316903	8	3	6716	7436	1.53188037423611
GO:0034067	protein localization to Golgi apparatus	 11	0.431935112460319	1	6	5	6718	7434	1.14891028067709
GO:0034080	CENP-A containing nucleosome assembly	 23	0.969462705505719	1	7	16	6717	7423	0.641058634870548
GO:0034097	response to cytokine	 56	0.996987798556497	1	17	39	6707	7400	0.639423281210164
GO:0034098	VCP-NPL4-UFD1 AAA ATPase complex	 10	0.133503266897558	0.919686434773344	7	3	6717	7436	1.47443486020226
GO:0034101	erythrocyte homeostasis	  9	0.206720270758876	0.983668097955673	6	3	6718	7436	1.40422367638311
GO:0034109	homotypic cell-cell adhesion	  5	0.452745275304033	1	3	2	6721	7437	1.26380130874479
GO:0034113	heterotypic cell-cell adhesion	 16	0.853260719975205	1	6	10	6718	7429	0.789875817965497
GO:0034115	negative regulation of heterotypic cell-cell adhesion	  7	0.919244306193629	1	2	5	6722	7434	0.601810147021331
GO:0034116	positive regulation of heterotypic cell-cell adhesion	  9	0.972243904416257	1	2	7	6722	7432	0.468074558794368
GO:0034122	negative regulation of toll-like receptor signaling pathway	  9	0.69404490204849	1	4	5	6720	7434	0.936149117588737
GO:0034128	negative regulation of MyD88-independent toll-like receptor signaling pathway	  6	0.865182793759413	1	2	4	6722	7435	0.702111838191553
GO:0034134	toll-like receptor 2 signaling pathway	  5	1	1	0	5	6724	7434	0
GO:0034138	toll-like receptor 3 signaling pathway	  7	0.919244306193629	1	2	5	6722	7434	0.601810147021331
GO:0034141	positive regulation of toll-like receptor 3 signaling pathway	  5	0.157494903089267	0.919686434773344	4	1	6720	7438	1.68506841165973
GO:0034142	toll-like receptor 4 signaling pathway	 12	0.971055765853963	1	3	9	6721	7430	0.526583878643665
GO:0034144	negative regulation of toll-like receptor 4 signaling pathway	  6	0.979023167332401	1	1	5	6723	7434	0.351055919095776
GO:0034145	positive regulation of toll-like receptor 4 signaling pathway	  7	0.444912401367032	1	4	3	6720	7436	1.20362029404266
GO:0034162	toll-like receptor 9 signaling pathway	 13	0.933471720877997	1	4	9	6720	7430	0.648103235253741
GO:0034184	positive regulation of maintenance of mitotic sister chromatid cohesion	  5	0.157494903089267	0.919686434773344	4	1	6720	7438	1.68506841165973
GO:0034185	apolipoprotein binding	 13	0.230372725000093	1	8	5	6716	7434	1.29620647050748
GO:0034198	cellular response to amino acid starvation	 41	0.372250359182329	1	21	20	6703	7419	1.07885477575775
GO:0034199	activation of protein kinase A activity	 16	0.94165410331218	1	5	11	6719	7428	0.658229848304581
GO:0034214	protein hexamerization	 10	0.0390070262266277	0.625040317669623	8	2	6716	7437	1.68506841165973
GO:0034235	GPI anchor binding	  7	0.0474968970055936	0.646585116783694	6	1	6718	7438	1.80543044106399
GO:0034236	protein kinase A catalytic subunit binding	 13	0.426320358160906	1	7	6	6717	7433	1.13418066169405
GO:0034237	protein kinase A regulatory subunit binding	 16	0.170220385600338	0.949543953868825	10	6	6714	7433	1.31645969660916
GO:0034244	negative regulation of transcription elongation from RNA polymerase II promoter	  9	0.69404490204849	1	4	5	6720	7434	0.936149117588737
GO:0034260	negative regulation of GTPase activity	 38	0.130268659230789	0.919686434773344	22	16	6702	7423	1.2194574031748
GO:0034314	Arp2/3 complex-mediated actin nucleation	 13	0.00687971396051248	0.354502993326374	11	2	6713	7437	1.78228389694779
GO:0034315	regulation of Arp2/3 complex-mediated actin nucleation	  6	0.607836179256654	1	3	3	6721	7436	1.05316775728733
GO:0034316	negative regulation of Arp2/3 complex-mediated actin nucleation	  5	0.452745275304033	1	3	2	6721	7437	1.26380130874479
GO:0034329	cell junction assembly	 11	0.665993939534306	1	5	6	6719	7433	0.957425233897572
GO:0034332	adherens junction organization	 35	0.919397122807978	1	13	22	6711	7417	0.78235319112773
GO:0034333	adherens junction assembly	  9	0.69404490204849	1	4	5	6720	7434	0.936149117588737
GO:0034340	response to type I interferon	  5	0.77940058892516	1	2	3	6722	7436	0.842534205829863
GO:0034341	response to interferon-gamma	 20	0.9653537478209	1	6	14	6718	7425	0.631900654372397
GO:0034351	negative regulation of glial cell apoptotic process	  7	0.730029012673872	1	3	4	6721	7435	0.902715220531996
GO:0034356	NAD biosynthesis via nicotinamide riboside salvage pathway	 15	0.972187308828691	1	4	11	6720	7428	0.561689470553242
GO:0034361	very-low-density lipoprotein particle	 13	0.933471720877997	1	4	9	6720	7430	0.648103235253741
GO:0034362	low-density lipoprotein particle	 11	0.953160347938253	1	3	8	6721	7431	0.574455140338543
GO:0034364	high-density lipoprotein particle	 11	0.953160347938253	1	3	8	6721	7431	0.574455140338543
GO:0034371	chylomicron remodeling	  6	1	1	0	6	6724	7433	0
GO:0034374	low-density lipoprotein particle remodeling	  9	1	1	0	9	6724	7430	0
GO:0034375	high-density lipoprotein particle remodeling	 12	0.971055765853963	1	3	9	6721	7430	0.526583878643665
GO:0034378	chylomicron assembly	  6	0.979023167332401	1	1	5	6723	7434	0.351055919095776
GO:0034379	very-low-density lipoprotein particle assembly	  7	0.919244306193629	1	2	5	6722	7434	0.601810147021331
GO:0034380	high-density lipoprotein particle assembly	 11	0.953160347938253	1	3	8	6721	7431	0.574455140338543
GO:0034382	chylomicron remnant clearance	  5	0.960049771736903	1	1	4	6723	7435	0.421267102914932
GO:0034383	low-density lipoprotein particle clearance	 23	0.254283570903419	1	13	10	6711	7429	1.19053746475959
GO:0034384	high-density lipoprotein particle clearance	  6	0.979023167332401	1	1	5	6723	7434	0.351055919095776
GO:0034388	Pwp2p-containing subcomplex of 90S preribosome	  5	0.77940058892516	1	2	3	6722	7436	0.842534205829863
GO:0034389	lipid particle organization	 16	0.517377397284026	1	8	8	6716	7431	1.05316775728733
GO:0034393	positive regulation of smooth muscle cell apoptotic process	  6	0.865182793759413	1	2	4	6722	7435	0.702111838191553
GO:0034394	protein localization to cell surface	 20	0.670469046918919	1	9	11	6715	7428	0.947850981558596
GO:0034399	nuclear periphery	 18	0.178063825749389	0.949543953868825	11	7	6713	7432	1.28720503668451
GO:0034405	response to fluid shear stress	  8	0.819878207576373	1	3	5	6721	7434	0.789875817965497
GO:0034427	nuclear-transcribed mRNA catabolic process, exonucleolytic, 3	  9	0.067355898427907	0.780679208284898	7	2	6717	7437	1.63826095578029
GO:0034446	substrate adhesion-dependent cell spreading	 35	0.762698586915096	1	15	20	6709	7419	0.902715220531996
GO:0034448	EGO complex	  5	0.0241003244622537	0.495149842313607	5	0	6719	7439	2.10633551457466
GO:0034450	ubiquitin-ubiquitin ligase activity	 12	0.148657926965624	0.919686434773344	8	4	6716	7435	1.40422367638311
GO:0034451	centriolar satellite	 24	0.194475510371151	0.972714597800941	14	10	6710	7429	1.22869571683522
GO:0034452	dynactin binding	 10	0.0390070262266277	0.625040317669623	8	2	6716	7437	1.68506841165973
GO:0034453	microtubule anchoring	 12	0.148657926965624	0.919686434773344	8	4	6716	7435	1.40422367638311
GO:0034454	microtubule anchoring at centrosome	  6	0.297654371351411	1	4	2	6720	7437	1.40422367638311
GO:0034464	BBSome	  7	0.187210848839696	0.949543953868825	5	2	6719	7437	1.50452536755333
GO:0034475	U4 snRNA 3	  8	0.113810689204897	0.88413902838582	6	2	6718	7437	1.57975163593099
GO:0034497	protein localization to pre-autophagosomal structure	 12	0.320810094151237	1	7	5	6717	7434	1.22869571683522
GO:0034498	early endosome to Golgi transport	  7	0.187210848839696	0.949543953868825	5	2	6719	7437	1.50452536755333
GO:0034501	protein localization to kinetochore	  6	1	1	0	6	6724	7433	0
GO:0034504	protein localization to nucleus	 32	0.979524591051875	1	10	22	6714	7417	0.658229848304581
GO:0034511	U3 snoRNA binding	  6	0.297654371351411	1	4	2	6720	7437	1.40422367638311
GO:0034513	box H/ACA snoRNA binding	  5	0.452745275304033	1	3	2	6721	7437	1.26380130874479
GO:0034551	mitochondrial respiratory chain complex III assembly	  8	0.113810689204897	0.88413902838582	6	2	6718	7437	1.57975163593099
GO:0034587	piRNA metabolic process	 10	0.559603563591584	1	5	5	6719	7434	1.05316775728733
GO:0034599	cellular response to oxidative stress	 80	0.710644291777848	1	36	44	6688	7395	0.947850981558596
GO:0034604	pyruvate dehydrogenase (NAD+) activity	  5	0.0241003244622537	0.495149842313607	5	0	6719	7439	2.10633551457466
GO:0034605	cellular response to heat	 40	0.680701626877675	1	18	22	6706	7417	0.947850981558596
GO:0034612	response to tumor necrosis factor	 25	0.828635555615045	1	10	15	6714	7424	0.842534205829863
GO:0034613	cellular protein localization	 44	0.312693872692444	1	23	21	6701	7418	1.10103901898221
GO:0034614	cellular response to reactive oxygen species	 28	0.467605035218744	1	14	14	6710	7425	1.05316775728733
GO:0034616	response to laminar fluid shear stress	  7	0.187210848839696	0.949543953868825	5	2	6719	7437	1.50452536755333
GO:0034618	arginine binding	  6	0.865182793759413	1	2	4	6722	7435	0.702111838191553
GO:0034620	cellular response to unfolded protein	  7	0.444912401367032	1	4	3	6720	7436	1.20362029404266
GO:0034625	fatty acid elongation, monounsaturated fatty acid	  5	0.452745275304033	1	3	2	6721	7437	1.26380130874479
GO:0034626	fatty acid elongation, polyunsaturated fatty acid	  5	0.452745275304033	1	3	2	6721	7437	1.26380130874479
GO:0034629	cellular protein complex localization	  8	0.309544448231027	1	5	3	6719	7436	1.31645969660916
GO:0034641	cellular nitrogen compound metabolic process	 18	0.325568860476231	1	10	8	6714	7431	1.17018639698592
GO:0034644	cellular response to UV	 41	0.941023380519319	1	15	26	6709	7413	0.77061055411268
GO:0034656	nucleobase-containing small molecule catabolic process	 14	0.529251719099727	1	7	7	6717	7432	1.05316775728733
GO:0034663	endoplasmic reticulum chaperone complex	  8	0.952366339066048	1	2	6	6722	7433	0.526583878643665
GO:0034695	response to prostaglandin E	  7	0.919244306193629	1	2	5	6722	7434	0.601810147021331
GO:0034702	ion channel complex	  6	0.297654371351411	1	4	2	6720	7437	1.40422367638311
GO:0034704	calcium channel complex	 16	0.324860333233664	1	9	7	6715	7432	1.18481372694825
GO:0034705	potassium channel complex	  6	0.607836179256654	1	3	3	6721	7436	1.05316775728733
GO:0034706	sodium channel complex	  6	0.979023167332401	1	1	5	6723	7434	0.351055919095776
GO:0034707	chloride channel complex	 35	0.514569683557429	1	17	18	6707	7421	1.02307724993626
GO:0034709	methylosome	 10	0.78367246101976	1	4	6	6720	7433	0.842534205829863
GO:0034711	inhibin binding	  5	0.77940058892516	1	2	3	6722	7436	0.842534205829863
GO:0034713	type I transforming growth factor beta receptor binding	  9	0.882794860340315	1	3	6	6721	7433	0.702111838191553
GO:0034715	pICln-Sm protein complex	  6	0.865182793759413	1	2	4	6722	7435	0.702111838191553
GO:0034719	SMN-Sm protein complex	 14	0.875453509540804	1	5	9	6719	7430	0.752262683776664
GO:0034720	histone H3-K4 demethylation	  8	0.819878207576373	1	3	5	6721	7434	0.789875817965497
GO:0034755	iron ion transmembrane transport	  6	0.297654371351411	1	4	2	6720	7437	1.40422367638311
GO:0034773	histone H4-K20 trimethylation	  6	0.865182793759413	1	2	4	6722	7435	0.702111838191553
GO:0034968	histone lysine methylation	 24	0.10185657048721	0.868413773784606	15	9	6709	7430	1.31645969660916
GO:0034969	histone arginine methylation	  5	0.157494903089267	0.919686434773344	4	1	6720	7438	1.68506841165973
GO:0034975	protein folding in endoplasmic reticulum	 14	0.00376490525152056	0.275076368503502	12	2	6712	7437	1.80543044106399
GO:0034976	response to endoplasmic reticulum stress	 70	0.292913573792695	1	36	34	6688	7405	1.0832582646384
GO:0034979	NAD-dependent protein deacetylase activity	  5	0.452745275304033	1	3	2	6721	7437	1.26380130874479
GO:0034983	peptidyl-lysine deacetylation	  7	0.444912401367032	1	4	3	6720	7436	1.20362029404266
GO:0034987	immunoglobulin receptor binding	  9	1	1	0	9	6724	7430	0
GO:0034993	LINC complex	  6	0.297654371351411	1	4	2	6720	7437	1.40422367638311
GO:0035004	phosphatidylinositol 3-kinase activity	  6	0.607836179256654	1	3	3	6721	7436	1.05316775728733
GO:0035005	1-phosphatidylinositol-4-phosphate 3-kinase activity	  6	0.865182793759413	1	2	4	6722	7435	0.702111838191553
GO:0035019	somatic stem cell population maintenance	 50	0.525913184706037	1	24	26	6700	7413	1.01104104699584
GO:0035020	regulation of Rac protein signal transduction	  5	0.0241003244622537	0.495149842313607	5	0	6719	7439	2.10633551457466
GO:0035023	regulation of Rho protein signal transduction	 70	0.216434740707052	1	37	33	6687	7406	1.11334877198946
GO:0035024	negative regulation of Rho protein signal transduction	 16	0.324860333233664	1	9	7	6715	7432	1.18481372694825
GO:0035025	positive regulation of Rho protein signal transduction	 21	0.86019883501541	1	8	13	6716	7426	0.802413529361774
GO:0035032	phosphatidylinositol 3-kinase complex, class III	  5	0.77940058892516	1	2	3	6722	7436	0.842534205829863
GO:0035035	histone acetyltransferase binding	 25	0.399232431223553	1	13	12	6711	7427	1.09529446757882
GO:0035036	sperm-egg recognition	  6	1	1	0	6	6724	7433	0
GO:0035050	embryonic heart tube development	 15	0.798298186583662	1	6	9	6718	7430	0.842534205829863
GO:0035064	methylated histone binding	 45	0.108144230217026	0.88413902838582	26	19	6698	7420	1.21699385286536
GO:0035065	regulation of histone acetylation	  9	0.438074670071218	1	5	4	6719	7435	1.17018639698592
GO:0035066	positive regulation of histone acetylation	 16	0.94165410331218	1	5	11	6719	7428	0.658229848304581
GO:0035067	negative regulation of histone acetylation	 10	0.316545776550851	1	6	4	6718	7435	1.26380130874479
GO:0035068	micro-ribonucleoprotein complex	  8	0.025392299605826	0.495149842313607	7	1	6717	7438	1.84304357525283
GO:0035082	axoneme assembly	  9	0.69404490204849	1	4	5	6720	7434	0.936149117588737
GO:0035091	phosphatidylinositol binding	 80	0.0457013909799628	0.646585116783694	46	34	6678	7405	1.21114292088043
GO:0035093	spermatogenesis, exchange of chromosomal proteins	  5	0.77940058892516	1	2	3	6722	7436	0.842534205829863
GO:0035094	response to nicotine	 29	0.97655715776058	1	9	20	6715	7419	0.653690332109377
GO:0035095	behavioral response to nicotine	  5	0.960049771736903	1	1	4	6723	7435	0.421267102914932
GO:0035097	histone methyltransferase complex	 22	0.0957434892101259	0.843214701401555	14	8	6710	7431	1.3403953274566
GO:0035098	ESC/E(Z) complex	 15	0.0106614103540833	0.427208830906354	12	3	6712	7436	1.68506841165973
GO:0035102	PRC1 complex	  8	0.819878207576373	1	3	5	6721	7434	0.789875817965497
GO:0035108	limb morphogenesis	 19	0.756503853067433	1	8	11	6716	7428	0.886878111399856
GO:0035115	embryonic forelimb morphogenesis	 24	0.946019062510409	1	8	16	6716	7423	0.702111838191553
GO:0035116	embryonic hindlimb morphogenesis	 26	0.997238836294189	1	6	20	6718	7419	0.486077426440306
GO:0035136	forelimb morphogenesis	  8	0.819878207576373	1	3	5	6721	7434	0.789875817965497
GO:0035137	hindlimb morphogenesis	  8	0.952366339066048	1	2	6	6722	7433	0.526583878643665
GO:0035145	exon-exon junction complex	 19	0.411669949440149	1	10	9	6714	7430	1.10859763924982
GO:0035148	tube formation	  8	0.819878207576373	1	3	5	6721	7434	0.789875817965497
GO:0035162	embryonic hemopoiesis	 13	0.933471720877997	1	4	9	6720	7430	0.648103235253741
GO:0035174	histone serine kinase activity	  5	0.452745275304033	1	3	2	6721	7437	1.26380130874479
GO:0035176	social behavior	 40	0.680701626877675	1	18	22	6706	7417	0.947850981558596
GO:0035194	posttranscriptional gene silencing by RNA	  7	0.00542743198931091	0.334473021939644	7	0	6717	7439	2.10633551457466
GO:0035195	gene silencing by miRNA	 12	0.320810094151237	1	7	5	6717	7434	1.22869571683522
GO:0035196	production of miRNAs involved in gene silencing by miRNA	  9	0.067355898427907	0.780679208284898	7	2	6717	7437	1.63826095578029
GO:0035197	siRNA binding	  8	0.580280354503036	1	4	4	6720	7435	1.05316775728733
GO:0035198	miRNA binding	 12	0.320810094151237	1	7	5	6717	7434	1.22869571683522
GO:0035234	ectopic germ cell programmed cell death	  5	0.960049771736903	1	1	4	6723	7435	0.421267102914932
GO:0035235	ionotropic glutamate receptor signaling pathway	 20	0.497606676879603	1	10	10	6714	7429	1.05316775728733
GO:0035242	protein-arginine omega-N asymmetric methyltransferase activity	  7	0.187210848839696	0.949543953868825	5	2	6719	7437	1.50452536755333
GO:0035246	peptidyl-arginine N-methylation	  8	0.113810689204897	0.88413902838582	6	2	6718	7437	1.57975163593099
GO:0035249	synaptic transmission, glutamatergic	 18	0.0811513291101853	0.807895728316903	12	6	6712	7433	1.40422367638311
GO:0035252	UDP-xylosyltransferase activity	  6	0.865182793759413	1	2	4	6722	7435	0.702111838191553
GO:0035253	ciliary rootlet	  9	0.0134026999423743	0.442059337527911	8	1	6716	7438	1.87229823517747
GO:0035254	glutamate receptor binding	  7	0.444912401367032	1	4	3	6720	7436	1.20362029404266
GO:0035255	ionotropic glutamate receptor binding	 21	0.134279084429805	0.919686434773344	13	8	6711	7431	1.30392198521288
GO:0035257	nuclear hormone receptor binding	 23	0.140447795438852	0.919686434773344	14	9	6710	7430	1.2821172697411
GO:0035259	glucocorticoid receptor binding	 15	0.421118865258844	1	8	7	6716	7432	1.12337894110648
GO:0035264	multicellular organism growth	 75	0.085979657179958	0.807895728316903	42	33	6682	7406	1.17954788816181
GO:0035265	organ growth	  9	0.438074670071218	1	5	4	6719	7435	1.17018639698592
GO:0035267	NuA4 histone acetyltransferase complex	 18	0.178063825749389	0.949543953868825	11	7	6713	7432	1.28720503668451
GO:0035269	protein O-linked mannosylation	 12	0.5430601307694	1	6	6	6718	7433	1.05316775728733
GO:0035278	miRNA mediated inhibition of translation	 11	0.0838548499097086	0.807895728316903	8	3	6716	7436	1.53188037423611
GO:0035280	miRNA loading onto RISC involved in gene silencing by miRNA	  7	0.0474968970055936	0.646585116783694	6	1	6718	7438	1.80543044106399
GO:0035307	positive regulation of protein dephosphorylation	 16	0.324860333233664	1	9	7	6715	7432	1.18481372694825
GO:0035308	negative regulation of protein dephosphorylation	  8	0.952366339066048	1	2	6	6722	7433	0.526583878643665
GO:0035313	wound healing, spreading of epidermal cells	  7	0.919244306193629	1	2	5	6722	7434	0.601810147021331
GO:0035325	Toll-like receptor binding	  5	0.960049771736903	1	1	4	6723	7435	0.421267102914932
GO:0035326	enhancer binding	 14	0.875453509540804	1	5	9	6719	7430	0.752262683776664
GO:0035327	transcriptionally active chromatin	 20	0.184541691833438	0.949543953868825	12	8	6712	7431	1.26380130874479
GO:0035329	hippo signaling	 27	0.547450272919978	1	13	14	6711	7425	1.01416154405446
GO:0035331	negative regulation of hippo signaling	  8	0.309544448231027	1	5	3	6719	7436	1.31645969660916
GO:0035335	peptidyl-tyrosine dephosphorylation	 87	0.00219695675895008	0.230560625684725	55	32	6669	7407	1.33159141725984
GO:0035338	long-chain fatty-acyl-CoA biosynthetic process	 14	0.160610520833599	0.919686434773344	9	5	6715	7434	1.35407283079799
GO:0035356	cellular triglyceride homeostasis	  5	0.157494903089267	0.919686434773344	4	1	6720	7438	1.68506841165973
GO:0035357	peroxisome proliferator activated receptor signaling pathway	  7	0.730029012673872	1	3	4	6721	7435	0.902715220531996
GO:0035360	positive regulation of peroxisome proliferator activated receptor signaling pathway	  5	0.452745275304033	1	3	2	6721	7437	1.26380130874479
GO:0035371	microtubule plus-end	 15	0.237875362689918	1	9	6	6715	7433	1.26380130874479
GO:0035372	protein localization to microtubule	  7	0.98898631085553	1	1	6	6723	7433	0.300905073510665
GO:0035374	chondroitin sulfate binding	  6	0.865182793759413	1	2	4	6722	7435	0.702111838191553
GO:0035385	Roundabout signaling pathway	  7	0.730029012673872	1	3	4	6721	7435	0.902715220531996
GO:0035413	positive regulation of catenin import into nucleus	  9	0.438074670071218	1	5	4	6719	7435	1.17018639698592
GO:0035414	negative regulation of catenin import into nucleus	 11	0.990836032904502	1	2	9	6722	7430	0.382970093559029
GO:0035418	protein localization to synapse	 13	0.643122793005253	1	6	7	6718	7432	0.972154852880611
GO:0035434	copper ion transmembrane transport	  5	0.452745275304033	1	3	2	6721	7437	1.26380130874479
GO:0035435	phosphate ion transmembrane transport	 12	0.75380380293781	1	5	7	6719	7432	0.877639797739441
GO:0035455	response to interferon-alpha	  9	0.882794860340315	1	3	6	6721	7433	0.702111838191553
GO:0035456	response to interferon-beta	  7	0.919244306193629	1	2	5	6722	7434	0.601810147021331
GO:0035457	cellular response to interferon-alpha	  7	0.0474968970055936	0.646585116783694	6	1	6718	7438	1.80543044106399
GO:0035458	cellular response to interferon-beta	 13	0.426320358160906	1	7	6	6717	7433	1.13418066169405
GO:0035459	cargo loading into vesicle	  5	0.157494903089267	0.919686434773344	4	1	6720	7438	1.68506841165973
GO:0035473	lipase binding	  5	0.452745275304033	1	3	2	6721	7437	1.26380130874479
GO:0035493	SNARE complex assembly	  7	0.0474968970055936	0.646585116783694	6	1	6718	7438	1.80543044106399
GO:0035497	cAMP response element binding	 10	0.559603563591584	1	5	5	6719	7434	1.05316775728733
GO:0035509	negative regulation of myosin-light-chain-phosphatase activity	  5	0.77940058892516	1	2	3	6722	7436	0.842534205829863
GO:0035518	histone H2A monoubiquitination	 11	0.0221890923454724	0.495149842313607	9	2	6715	7437	1.72336542101563
GO:0035520	monoubiquitinated protein deubiquitination	  6	0.297654371351411	1	4	2	6720	7437	1.40422367638311
GO:0035542	regulation of SNARE complex assembly	  6	0.297654371351411	1	4	2	6720	7437	1.40422367638311
GO:0035562	negative regulation of chromatin binding	  7	0.919244306193629	1	2	5	6722	7434	0.601810147021331
GO:0035563	positive regulation of chromatin binding	  9	0.882794860340315	1	3	6	6721	7433	0.702111838191553
GO:0035567	non-canonical Wnt signaling pathway	 18	0.974269347793119	1	5	13	6719	7426	0.585093198492961
GO:0035577	azurophil granule membrane	 48	0.216081229449964	1	26	22	6698	7417	1.14093173706127
GO:0035578	azurophil granule lumen	 77	0.9680661560177	1	29	48	6695	7391	0.793295193800845
GO:0035579	specific granule membrane	 80	0.542189402191403	1	38	42	6686	7397	1.00050936942296
GO:0035580	specific granule lumen	 56	0.999950763670388	1	13	43	6711	7396	0.488970744454831
GO:0035584	calcium-mediated signaling using intracellular calcium source	 19	0.877279625799761	1	7	12	6717	7427	0.776018347474874
GO:0035589	G-protein coupled purinergic nucleotide receptor signaling pathway	 10	0.925275888620553	1	3	7	6721	7432	0.631900654372397
GO:0035590	purinergic nucleotide receptor signaling pathway	  8	0.580280354503036	1	4	4	6720	7435	1.05316775728733
GO:0035591	signaling adaptor activity	 10	0.559603563591584	1	5	5	6719	7434	1.05316775728733
GO:0035610	protein side chain deglutamylation	  5	0.77940058892516	1	2	3	6722	7436	0.842534205829863
GO:0035612	AP-2 adaptor complex binding	  7	0.444912401367032	1	4	3	6720	7436	1.20362029404266
GO:0035613	RNA stem-loop binding	 10	0.559603563591584	1	5	5	6719	7434	1.05316775728733
GO:0035615	clathrin adaptor activity	 11	0.00362662415483058	0.275076368503502	10	1	6714	7438	1.91485046779514
GO:0035631	CD40 receptor complex	  9	0.206720270758876	0.983668097955673	6	3	6718	7436	1.40422367638311
GO:0035635	entry of bacterium into host cell	 10	0.559603563591584	1	5	5	6719	7434	1.05316775728733
GO:0035640	exploration behavior	 10	0.316545776550851	1	6	4	6718	7435	1.26380130874479
GO:0035641	locomotory exploration behavior	 13	0.426320358160906	1	7	6	6717	7433	1.13418066169405
GO:0035646	endosome to melanosome transport	  9	0.438074670071218	1	5	4	6719	7435	1.17018639698592
GO:0035666	TRIF-dependent toll-like receptor signaling pathway	 25	0.70711219518503	1	11	14	6713	7425	0.926787626412849
GO:0035686	sperm fibrous sheath	  6	0.865182793759413	1	2	4	6722	7435	0.702111838191553
GO:0035690	cellular response to drug	 57	0.751417273854913	1	25	32	6699	7407	0.923831366041517
GO:0035721	intraciliary retrograde transport	 10	0.000579691355198234	0.129194878970953	10	0	6714	7439	2.10633551457466
GO:0035722	interleukin-12-mediated signaling pathway	 41	0.261700823716251	1	22	19	6702	7420	1.1302288126986
GO:0035725	sodium ion transmembrane transport	 77	0.823249255606197	1	33	44	6691	7395	0.902715220531996
GO:0035726	common myeloid progenitor cell proliferation	  6	0.607836179256654	1	3	3	6721	7436	1.05316775728733
GO:0035727	lysophosphatidic acid binding	  5	0.77940058892516	1	2	3	6722	7436	0.842534205829863
GO:0035729	cellular response to hepatocyte growth factor stimulus	 11	0.665993939534306	1	5	6	6719	7433	0.957425233897572
GO:0035735	intraciliary transport involved in cilium assembly	 38	0.00276415695848327	0.244538441062453	27	11	6697	7428	1.49660681298726
GO:0035748	myelin sheath abaxonal region	  5	0.77940058892516	1	2	3	6722	7436	0.842534205829863
GO:0035749	myelin sheath adaxonal region	  6	0.297654371351411	1	4	2	6720	7437	1.40422367638311
GO:0035754	B cell chemotaxis	  5	0.77940058892516	1	2	3	6722	7436	0.842534205829863
GO:0035767	endothelial cell chemotaxis	  8	1	1	0	8	6724	7431	0
GO:0035770	ribonucleoprotein granule	 10	0.559603563591584	1	5	5	6719	7434	1.05316775728733
GO:0035773	insulin secretion involved in cellular response to glucose stimulus	  7	0.0474968970055936	0.646585116783694	6	1	6718	7438	1.80543044106399
GO:0035774	positive regulation of insulin secretion involved in cellular response to glucose stimulus	 24	0.481410334966146	1	12	12	6712	7427	1.05316775728733
GO:0035810	positive regulation of urine volume	  6	0.865182793759413	1	2	4	6722	7435	0.702111838191553
GO:0035815	positive regulation of renal sodium excretion	  8	0.952366339066048	1	2	6	6722	7433	0.526583878643665
GO:0035845	photoreceptor cell outer segment organization	  8	0.113810689204897	0.88413902838582	6	2	6718	7437	1.57975163593099
GO:0035855	megakaryocyte development	 16	0.982365044000861	1	4	12	6720	7427	0.526583878643665
GO:0035860	glial cell-derived neurotrophic factor receptor signaling pathway	  5	0.960049771736903	1	1	4	6723	7435	0.421267102914932
GO:0035861	site of double-strand break	 26	0.107316947101236	0.88413902838582	16	10	6708	7429	1.29620647050748
GO:0035864	response to potassium ion	  5	0.452745275304033	1	3	2	6721	7437	1.26380130874479
GO:0035865	cellular response to potassium ion	  7	0.444912401367032	1	4	3	6720	7436	1.20362029404266
GO:0035869	ciliary transition zone	 24	0.481410334966146	1	12	12	6712	7427	1.05316775728733
GO:0035871	protein K11-linked deubiquitination	  9	0.438074670071218	1	5	4	6719	7435	1.17018639698592
GO:0035878	nail development	  5	0.77940058892516	1	2	3	6722	7436	0.842534205829863
GO:0035897	proteolysis in other organism	  6	0.297654371351411	1	4	2	6720	7437	1.40422367638311
GO:0035900	response to isolation stress	  7	0.444912401367032	1	4	3	6720	7436	1.20362029404266
GO:0035902	response to immobilization stress	 19	0.877279625799761	1	7	12	6717	7427	0.776018347474874
GO:0035904	aorta development	 16	0.706693964264422	1	7	9	6717	7430	0.921521787626413
GO:0035909	aorta morphogenesis	 12	0.999560983443925	1	1	11	6723	7428	0.175527959547888
GO:0035912	dorsal aorta morphogenesis	  8	0.819878207576373	1	3	5	6721	7434	0.789875817965497
GO:0035914	skeletal muscle cell differentiation	 40	0.999704921948891	1	9	31	6715	7408	0.473925490779298
GO:0035924	cellular response to vascular endothelial growth factor stimulus	 21	0.999745254573712	1	3	18	6721	7421	0.300905073510665
GO:0035925	mRNA 3	 10	0.559603563591584	1	5	5	6719	7434	1.05316775728733
GO:0035965	cardiolipin acyl-chain remodeling	  5	0.452745275304033	1	3	2	6721	7437	1.26380130874479
GO:0035970	peptidyl-threonine dephosphorylation	 12	0.5430601307694	1	6	6	6718	7433	1.05316775728733
GO:0035987	endodermal cell differentiation	 24	0.882377293683992	1	9	15	6715	7424	0.789875817965497
GO:0035988	chondrocyte proliferation	  8	0.819878207576373	1	3	5	6721	7434	0.789875817965497
GO:0035994	response to muscle stretch	 15	0.798298186583662	1	6	9	6718	7430	0.842534205829863
GO:0035999	tetrahydrofolate interconversion	  6	0.297654371351411	1	4	2	6720	7437	1.40422367638311
GO:0036002	pre-mRNA binding	 12	0.320810094151237	1	7	5	6717	7434	1.22869571683522
GO:0036003	positive regulation of transcription from RNA polymerase II promoter in response to stress	  5	0.960049771736903	1	1	4	6723	7435	0.421267102914932
GO:0036006	cellular response to macrophage colony-stimulating factor stimulus	  5	0.77940058892516	1	2	3	6722	7436	0.842534205829863
GO:0036010	protein localization to endosome	  7	0.444912401367032	1	4	3	6720	7436	1.20362029404266
GO:0036016	cellular response to interleukin-3	  5	0.77940058892516	1	2	3	6722	7436	0.842534205829863
GO:0036020	endolysosome membrane	 13	0.0975861781940815	0.843214701401555	9	4	6715	7435	1.45823227932092
GO:0036021	endolysosome lumen	  5	0.77940058892516	1	2	3	6722	7436	0.842534205829863
GO:0036035	osteoclast development	  5	0.452745275304033	1	3	2	6721	7437	1.26380130874479
GO:0036038	MKS complex	 12	0.75380380293781	1	5	7	6719	7432	0.877639797739441
GO:0036057	slit diaphragm	  7	0.98898631085553	1	1	6	6723	7433	0.300905073510665
GO:0036064	ciliary basal body	 96	0.000525569871140038	0.129194878970953	62	34	6662	7405	1.36034168649613
GO:0036065	fucosylation	 11	0.665993939534306	1	5	6	6719	7433	0.957425233897572
GO:0036066	protein O-linked fucosylation	 10	0.78367246101976	1	4	6	6720	7433	0.842534205829863
GO:0036089	cleavage furrow formation	  7	0.730029012673872	1	3	4	6721	7435	0.902715220531996
GO:0036092	phosphatidylinositol-3-phosphate biosynthetic process	 40	0.560614403487468	1	19	21	6705	7418	1.00050936942296
GO:0036094	small molecule binding	  5	0.960049771736903	1	1	4	6723	7435	0.421267102914932
GO:0036109	alpha-linolenic acid metabolic process	  9	0.206720270758876	0.983668097955673	6	3	6718	7436	1.40422367638311
GO:0036120	cellular response to platelet-derived growth factor stimulus	 18	0.926471989195673	1	6	12	6718	7427	0.702111838191553
GO:0036122	BMP binding	 10	0.925275888620553	1	3	7	6721	7432	0.631900654372397
GO:0036124	histone H3-K9 trimethylation	  5	0.960049771736903	1	1	4	6723	7435	0.421267102914932
GO:0036126	sperm flagellum	 21	0.57968055192832	1	10	11	6714	7428	1.00301691170222
GO:0036128	CatSper complex	  5	1	1	0	5	6724	7434	0
GO:0036148	phosphatidylglycerol acyl-chain remodeling	 13	0.822979434145659	1	5	8	6719	7431	0.810129044067176
GO:0036149	phosphatidylinositol acyl-chain remodeling	 12	0.75380380293781	1	5	7	6719	7432	0.877639797739441
GO:0036150	phosphatidylserine acyl-chain remodeling	 15	0.914031171019375	1	5	10	6719	7429	0.702111838191553
GO:0036151	phosphatidylcholine acyl-chain remodeling	 20	0.670469046918919	1	9	11	6715	7428	0.947850981558596
GO:0036152	phosphatidylethanolamine acyl-chain remodeling	 20	0.813860390499775	1	8	12	6716	7427	0.842534205829863
GO:0036157	outer dynein arm	  5	0.960049771736903	1	1	4	6723	7435	0.421267102914932
GO:0036158	outer dynein arm assembly	 12	0.971055765853963	1	3	9	6721	7430	0.526583878643665
GO:0036159	inner dynein arm assembly	 11	0.665993939534306	1	5	6	6719	7433	0.957425233897572
GO:0036258	multivesicular body assembly	 27	0.395437844617669	1	14	13	6710	7426	1.09217397052019
GO:0036289	peptidyl-serine autophosphorylation	  6	0.865182793759413	1	2	4	6722	7435	0.702111838191553
GO:0036295	cellular response to increased oxygen levels	  7	0.0474968970055936	0.646585116783694	6	1	6718	7438	1.80543044106399
GO:0036297	interstrand cross-link repair	 40	0.132916295180638	0.919686434773344	23	17	6701	7422	1.21114292088043
GO:0036302	atrioventricular canal development	  6	0.297654371351411	1	4	2	6720	7437	1.40422367638311
GO:0036310	annealing helicase activity	  7	0.919244306193629	1	2	5	6722	7434	0.601810147021331
GO:0036312	phosphatidylinositol 3-kinase regulatory subunit binding	  7	0.444912401367032	1	4	3	6720	7436	1.20362029404266
GO:0036342	post-anal tail morphogenesis	 16	0.982365044000861	1	4	12	6720	7427	0.526583878643665
GO:0036376	sodium ion export from cell	  6	0.297654371351411	1	4	2	6720	7437	1.40422367638311
GO:0036402	proteasome-activating ATPase activity	  5	0.960049771736903	1	1	4	6723	7435	0.421267102914932
GO:0036435	K48-linked polyubiquitin modification-dependent protein binding	  5	0.77940058892516	1	2	3	6722	7436	0.842534205829863
GO:0036444	mitochondrial calcium uptake	  9	0.438074670071218	1	5	4	6719	7435	1.17018639698592
GO:0036459	thiol-dependent ubiquitinyl hydrolase activity	 83	0.000414115528946088	0.129194878970953	55	28	6669	7411	1.39576449760971
GO:0036464	cytoplasmic ribonucleoprotein granule	 18	0.178063825749389	0.949543953868825	11	7	6713	7432	1.28720503668451
GO:0036465	synaptic vesicle recycling	  6	0.607836179256654	1	3	3	6721	7436	1.05316775728733
GO:0036477	somatodendritic compartment	  7	0.00542743198931091	0.334473021939644	7	0	6717	7439	2.10633551457466
GO:0036498	IRE1-mediated unfolded protein response	 52	0.306632340085892	1	27	25	6697	7414	1.09367420949069
GO:0036499	PERK-mediated unfolded protein response	  8	1	1	0	8	6724	7431	0
GO:0036500	ATF6-mediated unfolded protein response	  6	0.0874151689581943	0.807895728316903	5	1	6719	7438	1.75527959547888
GO:0036503	ERAD pathway	 13	0.230372725000093	1	8	5	6716	7434	1.29620647050748
GO:0036513	Derlin-1 retrotranslocation complex	  9	0.0134026999423743	0.442059337527911	8	1	6716	7438	1.87229823517747
GO:0038003	opioid receptor signaling pathway	  5	0.77940058892516	1	2	3	6722	7436	0.842534205829863
GO:0038007	netrin-activated signaling pathway	  5	0.452745275304033	1	3	2	6721	7437	1.26380130874479
GO:0038027	apolipoprotein A-I-mediated signaling pathway	  5	0.960049771736903	1	1	4	6723	7435	0.421267102914932
GO:0038031	non-canonical Wnt signaling pathway via JNK cascade	  5	0.960049771736903	1	1	4	6723	7435	0.421267102914932
GO:0038033	positive regulation of endothelial cell chemotaxis by VEGF-activated vascular endothelial growth factor receptor signaling pathway	  5	0.960049771736903	1	1	4	6723	7435	0.421267102914932
GO:0038036	sphingosine-1-phosphate receptor activity	  8	0.952366339066048	1	2	6	6722	7433	0.526583878643665
GO:0038061	NIK/NF-kappaB signaling	 57	0.558337592380615	1	27	30	6697	7409	0.997737875324838
GO:0038063	collagen-activated tyrosine kinase receptor signaling pathway	  9	0.69404490204849	1	4	5	6720	7434	0.936149117588737
GO:0038066	p38MAPK cascade	  6	0.607836179256654	1	3	3	6721	7436	1.05316775728733
GO:0038083	peptidyl-tyrosine autophosphorylation	 44	0.908412996093135	1	17	27	6707	7412	0.813811448812936
GO:0038084	vascular endothelial growth factor signaling pathway	  6	0.865182793759413	1	2	4	6722	7435	0.702111838191553
GO:0038092	nodal signaling pathway	  6	0.607836179256654	1	3	3	6721	7436	1.05316775728733
GO:0038096	Fc-gamma receptor signaling pathway involved in phagocytosis	 72	0.563318384557247	1	34	38	6690	7401	0.994658437438033
GO:0038111	interleukin-7-mediated signaling pathway	 75	0.600461171617625	1	35	40	6689	7399	0.982956573468174
GO:0038128	ERBB2 signaling pathway	 34	0.0140542082563776	0.453189329920734	23	11	6701	7428	1.42487402456521
GO:0038132	neuregulin binding	  5	0.77940058892516	1	2	3	6722	7436	0.842534205829863
GO:0038166	angiotensin-activated signaling pathway	  5	0.960049771736903	1	1	4	6723	7435	0.421267102914932
GO:0038180	nerve growth factor signaling pathway	  8	0.580280354503036	1	4	4	6720	7435	1.05316775728733
GO:0038191	neuropilin binding	  8	0.309544448231027	1	5	3	6719	7436	1.31645969660916
GO:0038202	TORC1 signaling	  6	0.865182793759413	1	2	4	6722	7435	0.702111838191553
GO:0038203	TORC2 signaling	  5	0.77940058892516	1	2	3	6722	7436	0.842534205829863
GO:0039536	negative regulation of RIG-I signaling pathway	  7	0.187210848839696	0.949543953868825	5	2	6719	7437	1.50452536755333
GO:0039694	viral RNA genome replication	  8	0.025392299605826	0.495149842313607	7	1	6717	7438	1.84304357525283
GO:0039702	viral budding via host ESCRT complex	 17	0.776294265732228	1	7	10	6717	7429	0.867314623648389
GO:0039706	co-receptor binding	  7	0.730029012673872	1	3	4	6721	7435	0.902715220531996
GO:0040007	growth	 12	0.5430601307694	1	6	6	6718	7433	1.05316775728733
GO:0040008	regulation of growth	 65	0.63162480378596	1	30	35	6694	7404	0.972154852880611
GO:0040011	locomotion	  9	0.438074670071218	1	5	4	6719	7435	1.17018639698592
GO:0040012	regulation of locomotion	  5	0.452745275304033	1	3	2	6721	7437	1.26380130874479
GO:0040014	regulation of multicellular organism growth	 25	0.25641203321621	1	14	11	6710	7428	1.17954788816181
GO:0040015	negative regulation of multicellular organism growth	 13	0.997057742126947	1	2	11	6722	7428	0.32405161762687
GO:0040016	embryonic cleavage	  6	0.297654371351411	1	4	2	6720	7437	1.40422367638311
GO:0040018	positive regulation of multicellular organism growth	 28	0.616649478927714	1	13	15	6711	7424	0.977941488909663
GO:0040019	positive regulation of embryonic development	  7	0.730029012673872	1	3	4	6721	7435	0.902715220531996
GO:0040020	regulation of meiotic nuclear division	  5	0.77940058892516	1	2	3	6722	7436	0.842534205829863
GO:0040029	regulation of gene expression, epigenetic	 13	0.0975861781940815	0.843214701401555	9	4	6715	7435	1.45823227932092
GO:0040036	regulation of fibroblast growth factor receptor signaling pathway	  5	0.77940058892516	1	2	3	6722	7436	0.842534205829863
GO:0040037	negative regulation of fibroblast growth factor receptor signaling pathway	 10	0.983985908365184	1	2	8	6722	7431	0.421267102914932
GO:0042026	protein refolding	 12	0.5430601307694	1	6	6	6718	7433	1.05316775728733
GO:0042043	neurexin family protein binding	 13	0.643122793005253	1	6	7	6718	7432	0.972154852880611
GO:0042045	epithelial fluid transport	  5	0.452745275304033	1	3	2	6721	7437	1.26380130874479
GO:0042048	olfactory behavior	  6	0.865182793759413	1	2	4	6722	7435	0.702111838191553
GO:0042053	regulation of dopamine metabolic process	  7	0.444912401367032	1	4	3	6720	7436	1.20362029404266
GO:0042054	histone methyltransferase activity	  8	0.580280354503036	1	4	4	6720	7435	1.05316775728733
GO:0042056	chemoattractant activity	 17	0.997764322622395	1	3	14	6721	7425	0.371706267277881
GO:0042058	regulation of epidermal growth factor receptor signaling pathway	  7	0.919244306193629	1	2	5	6722	7434	0.601810147021331
GO:0042059	negative regulation of epidermal growth factor receptor signaling pathway	 29	0.0822805002524998	0.807895728316903	18	11	6706	7428	1.30738066421875
GO:0042060	wound healing	 81	0.999857949816144	1	23	58	6701	7381	0.598095269570582
GO:0042063	gliogenesis	  5	0.452745275304033	1	3	2	6721	7437	1.26380130874479
GO:0042073	intraciliary transport	 18	0.0300950583180779	0.549711001936538	13	5	6711	7434	1.5212423160817
GO:0042074	cell migration involved in gastrulation	  8	0.819878207576373	1	3	5	6721	7434	0.789875817965497
GO:0042088	T-helper 1 type immune response	 10	0.983985908365184	1	2	8	6722	7431	0.421267102914932
GO:0042098	T cell proliferation	 19	0.592680980401227	1	9	10	6715	7429	0.997737875324838
GO:0042100	B cell proliferation	 16	0.853260719975205	1	6	10	6718	7429	0.789875817965497
GO:0042101	T cell receptor complex	 15	0.914031171019375	1	5	10	6719	7429	0.702111838191553
GO:0042102	positive regulation of T cell proliferation	 42	0.977949243504044	1	14	28	6710	7411	0.702111838191553
GO:0042104	positive regulation of activated T cell proliferation	 20	0.813860390499775	1	8	12	6716	7427	0.842534205829863
GO:0042110	T cell activation	 43	0.813397092897171	1	18	25	6706	7414	0.881721843310322
GO:0042113	B cell activation	 27	0.993722653510536	1	7	20	6717	7419	0.546086985260096
GO:0042116	macrophage activation	  8	0.819878207576373	1	3	5	6721	7434	0.789875817965497
GO:0042117	monocyte activation	  7	0.730029012673872	1	3	4	6721	7435	0.902715220531996
GO:0042118	endothelial cell activation	  9	0.882794860340315	1	3	6	6721	7433	0.702111838191553
GO:0042119	neutrophil activation	  8	0.819878207576373	1	3	5	6721	7434	0.789875817965497
GO:0042129	regulation of T cell proliferation	  6	0.865182793759413	1	2	4	6722	7435	0.702111838191553
GO:0042130	negative regulation of T cell proliferation	 32	0.953156110269778	1	11	21	6713	7418	0.724052833135039
GO:0042135	neurotransmitter catabolic process	 10	0.316545776550851	1	6	4	6718	7435	1.26380130874479
GO:0042136	neurotransmitter biosynthetic process	  9	0.438074670071218	1	5	4	6719	7435	1.17018639698592
GO:0042147	retrograde transport, endosome to Golgi	 58	0.00895772754009301	0.410349233027118	37	21	6687	7418	1.34369679378039
GO:0042148	strand invasion	  5	0.157494903089267	0.919686434773344	4	1	6720	7438	1.68506841165973
GO:0042149	cellular response to glucose starvation	 33	0.656862706456246	1	15	18	6709	7421	0.957425233897572
GO:0042157	lipoprotein metabolic process	 20	0.999558208796652	1	3	17	6721	7422	0.315950327186199
GO:0042158	lipoprotein biosynthetic process	  6	0.979023167332401	1	1	5	6723	7434	0.351055919095776
GO:0042162	telomeric DNA binding	 23	0.567952371389245	1	11	12	6713	7427	1.00737785479658
GO:0042166	acetylcholine binding	 12	0.994792086314609	1	2	10	6722	7429	0.351055919095776
GO:0042167	heme catabolic process	  5	0.77940058892516	1	2	3	6722	7436	0.842534205829863
GO:0042169	SH2 domain binding	 28	0.750594068387264	1	12	16	6712	7423	0.902715220531996
GO:0042176	regulation of protein catabolic process	 16	0.170220385600338	0.949543953868825	10	6	6714	7433	1.31645969660916
GO:0042177	negative regulation of protein catabolic process	 33	0.928099429218047	1	12	21	6712	7418	0.765940187118057
GO:0042178	xenobiotic catabolic process	  5	0.77940058892516	1	2	3	6722	7436	0.842534205829863
GO:0042220	response to cocaine	 32	0.120555485329501	0.909602955976315	19	13	6705	7426	1.2506367117787
GO:0042246	tissue regeneration	 18	0.325568860476231	1	10	8	6714	7431	1.17018639698592
GO:0042254	ribosome biogenesis	 87	1.52068202691114e-05	0.0219434416483278	61	26	6663	7413	1.47685593550637
GO:0042255	ribosome assembly	  7	0.187210848839696	0.949543953868825	5	2	6719	7437	1.50452536755333
GO:0042267	natural killer cell mediated cytotoxicity	 14	0.98932697223781	1	3	11	6721	7428	0.451357610265998
GO:0042273	ribosomal large subunit biogenesis	 26	0.0508264286032431	0.679607581911819	17	9	6707	7430	1.3772193749142
GO:0042274	ribosomal small subunit biogenesis	 15	0.798298186583662	1	6	9	6718	7430	0.842534205829863
GO:0042276	error-prone translesion synthesis	 19	0.127144513269886	0.919686434773344	12	7	6712	7432	1.33031716709978
GO:0042277	peptide binding	 48	0.829367695733477	1	20	28	6704	7411	0.877639797739441
GO:0042288	MHC class I protein binding	 12	0.320810094151237	1	7	5	6717	7434	1.22869571683522
GO:0042297	vocal learning	  6	0.607836179256654	1	3	3	6721	7436	1.05316775728733
GO:0042301	phosphate ion binding	 10	0.78367246101976	1	4	6	6720	7433	0.842534205829863
GO:0042304	regulation of fatty acid biosynthetic process	  7	0.730029012673872	1	3	4	6721	7435	0.902715220531996
GO:0042306	regulation of protein import into nucleus	  5	0.452745275304033	1	3	2	6721	7437	1.26380130874479
GO:0042307	positive regulation of protein import into nucleus	 16	0.94165410331218	1	5	11	6719	7428	0.658229848304581
GO:0042308	negative regulation of protein import into nucleus	  8	0.952366339066048	1	2	6	6722	7433	0.526583878643665
GO:0042310	vasoconstriction	 14	0.998346203775137	1	2	12	6722	7427	0.300905073510665
GO:0042311	vasodilation	 16	0.853260719975205	1	6	10	6718	7429	0.789875817965497
GO:0042325	regulation of phosphorylation	 14	0.529251719099727	1	7	7	6717	7432	1.05316775728733
GO:0042326	negative regulation of phosphorylation	 18	0.506938913103874	1	9	9	6715	7430	1.05316775728733
GO:0042327	positive regulation of phosphorylation	 24	0.324965824259735	1	13	11	6711	7428	1.14093173706127
GO:0042340	keratan sulfate catabolic process	 10	0.983985908365184	1	2	8	6722	7431	0.421267102914932
GO:0042346	positive regulation of NF-kappaB import into nucleus	 17	0.997764322622395	1	3	14	6721	7425	0.371706267277881
GO:0042347	negative regulation of NF-kappaB import into nucleus	 10	0.559603563591584	1	5	5	6719	7434	1.05316775728733
GO:0042355	L-fucose catabolic process	  7	0.730029012673872	1	3	4	6721	7435	0.902715220531996
GO:0042359	vitamin D metabolic process	  6	0.607836179256654	1	3	3	6721	7436	1.05316775728733
GO:0042379	chemokine receptor binding	  7	0.98898631085553	1	1	6	6723	7433	0.300905073510665
GO:0042382	paraspeckles	  5	0.0241003244622537	0.495149842313607	5	0	6719	7439	2.10633551457466
GO:0042383	sarcolemma	 86	0.965023757691245	1	33	53	6691	7386	0.808245023034462
GO:0042391	regulation of membrane potential	 76	0.901087686815794	1	31	45	6693	7394	0.85916317041861
GO:0042392	sphingosine-1-phosphate phosphatase activity	  5	0.452745275304033	1	3	2	6721	7437	1.26380130874479
GO:0042393	histone binding	 93	0.0155245653935197	0.481762319631158	55	38	6669	7401	1.24568229356566
GO:0042403	thyroid hormone metabolic process	  5	0.77940058892516	1	2	3	6722	7436	0.842534205829863
GO:0042405	nuclear inclusion body	 11	0.220387996626296	1	7	4	6717	7435	1.3403953274566
GO:0042407	cristae formation	 25	0.000893992515883898	0.165233002219546	20	5	6704	7434	1.68506841165973
GO:0042415	norepinephrine metabolic process	  5	0.77940058892516	1	2	3	6722	7436	0.842534205829863
GO:0042416	dopamine biosynthetic process	  6	0.607836179256654	1	3	3	6721	7436	1.05316775728733
GO:0042417	dopamine metabolic process	 12	0.320810094151237	1	7	5	6717	7434	1.22869571683522
GO:0042420	dopamine catabolic process	  5	0.960049771736903	1	1	4	6723	7435	0.421267102914932
GO:0042426	choline catabolic process	  6	0.297654371351411	1	4	2	6720	7437	1.40422367638311
GO:0042428	serotonin metabolic process	  6	0.865182793759413	1	2	4	6722	7435	0.702111838191553
GO:0042438	melanin biosynthetic process	  8	0.309544448231027	1	5	3	6719	7436	1.31645969660916
GO:0042445	hormone metabolic process	  9	0.972243904416257	1	2	7	6722	7432	0.468074558794368
GO:0042446	hormone biosynthetic process	  9	0.882794860340315	1	3	6	6721	7433	0.702111838191553
GO:0042448	progesterone metabolic process	  7	0.919244306193629	1	2	5	6722	7434	0.601810147021331
GO:0042462	eye photoreceptor cell development	 15	0.914031171019375	1	5	10	6719	7429	0.702111838191553
GO:0042470	melanosome	 93	0.182488831106203	0.949543953868825	49	44	6675	7395	1.10978967972213
GO:0042471	ear morphogenesis	  6	0.865182793759413	1	2	4	6722	7435	0.702111838191553
GO:0042472	inner ear morphogenesis	 50	0.991021243862083	1	16	34	6708	7405	0.67402736466389
GO:0042473	outer ear morphogenesis	  9	0.882794860340315	1	3	6	6721	7433	0.702111838191553
GO:0042474	middle ear morphogenesis	 17	0.960992303738273	1	5	12	6719	7427	0.619510445463135
GO:0042475	odontogenesis of dentin-containing tooth	 48	0.966673047625761	1	17	31	6707	7408	0.745993828078525
GO:0042476	odontogenesis	 28	0.998890460682561	1	6	22	6718	7417	0.451357610265998
GO:0042491	auditory receptor cell differentiation	  5	0.960049771736903	1	1	4	6723	7435	0.421267102914932
GO:0042500	aspartic endopeptidase activity, intramembrane cleaving	  6	0.0114373555630656	0.427208830906354	6	0	6718	7439	2.10633551457466
GO:0042531	positive regulation of tyrosine phosphorylation of STAT protein	 40	0.981304313641844	1	13	27	6711	7412	0.684559042236764
GO:0042532	negative regulation of tyrosine phosphorylation of STAT protein	 10	0.559603563591584	1	5	5	6719	7434	1.05316775728733
GO:0042535	positive regulation of tumor necrosis factor biosynthetic process	  9	0.882794860340315	1	3	6	6721	7433	0.702111838191553
GO:0042541	hemoglobin biosynthetic process	  5	1	1	0	5	6724	7434	0
GO:0042542	response to hydrogen peroxide	 46	0.652923382796465	1	21	25	6703	7414	0.961587952305822
GO:0042551	neuron maturation	 11	0.665993939534306	1	5	6	6719	7433	0.957425233897572
GO:0042552	myelination	 45	0.174202296951422	0.949543953868825	25	20	6699	7419	1.17018639698592
GO:0042554	superoxide anion generation	 11	0.953160347938253	1	3	8	6721	7431	0.574455140338543
GO:0042555	MCM complex	  8	0.952366339066048	1	2	6	6722	7433	0.526583878643665
GO:0042562	hormone binding	 10	0.559603563591584	1	5	5	6719	7434	1.05316775728733
GO:0042571	immunoglobulin complex, circulating	  7	1	1	0	7	6724	7432	0
GO:0042572	retinol metabolic process	 22	0.896697486794484	1	8	14	6716	7425	0.765940187118057
GO:0042573	retinoic acid metabolic process	 10	0.559603563591584	1	5	5	6719	7434	1.05316775728733
GO:0042574	retinal metabolic process	 12	0.75380380293781	1	5	7	6719	7432	0.877639797739441
GO:0042577	lipid phosphatase activity	  9	0.882794860340315	1	3	6	6721	7433	0.702111838191553
GO:0042578	phosphoric ester hydrolase activity	  6	0.297654371351411	1	4	2	6720	7437	1.40422367638311
GO:0042581	specific granule	 11	0.665993939534306	1	5	6	6719	7433	0.957425233897572
GO:0042582	azurophil granule	  9	0.438074670071218	1	5	4	6719	7435	1.17018639698592
GO:0042584	chromaffin granule membrane	  6	0.0874151689581943	0.807895728316903	5	1	6719	7438	1.75527959547888
GO:0042587	glycogen granule	  5	0.452745275304033	1	3	2	6721	7437	1.26380130874479
GO:0042589	zymogen granule membrane	  9	0.438074670071218	1	5	4	6719	7435	1.17018639698592
GO:0042592	homeostatic process	 12	0.75380380293781	1	5	7	6719	7432	0.877639797739441
GO:0042593	glucose homeostasis	 81	0.811111776920457	1	35	46	6689	7393	0.910144975433494
GO:0042594	response to starvation	 24	0.481410334966146	1	12	12	6712	7427	1.05316775728733
GO:0042599	lamellar body	  6	0.607836179256654	1	3	3	6721	7436	1.05316775728733
GO:0042605	peptide antigen binding	 16	0.982365044000861	1	4	12	6720	7427	0.526583878643665
GO:0042608	T cell receptor binding	  6	0.865182793759413	1	2	4	6722	7435	0.702111838191553
GO:0042609	CD4 receptor binding	  7	0.919244306193629	1	2	5	6722	7434	0.601810147021331
GO:0042612	MHC class I protein complex	  6	0.979023167332401	1	1	5	6723	7434	0.351055919095776
GO:0042613	MHC class II protein complex	  9	0.972243904416257	1	2	7	6722	7432	0.468074558794368
GO:0042622	photoreceptor outer segment membrane	 10	0.983985908365184	1	2	8	6722	7431	0.421267102914932
GO:0042623	ATPase activity, coupled	  9	0.882794860340315	1	3	6	6721	7433	0.702111838191553
GO:0042626	ATPase activity, coupled to transmembrane movement of substances	 36	0.210339168864363	0.998026267702333	20	16	6704	7423	1.17018639698592
GO:0042627	chylomicron	  7	1	1	0	7	6724	7432	0
GO:0042629	mast cell granule	 20	0.9653537478209	1	6	14	6718	7425	0.631900654372397
GO:0042632	cholesterol homeostasis	 46	0.94374782456266	1	17	29	6707	7410	0.778428342342808
GO:0042633	hair cycle	 11	1	1	0	11	6724	7428	0
GO:0042641	actomyosin	 12	0.5430601307694	1	6	6	6718	7433	1.05316775728733
GO:0042645	mitochondrial nucleoid	 39	0.0546234523521783	0.703764658430297	24	15	6700	7424	1.29620647050748
GO:0042692	muscle cell differentiation	 16	0.170220385600338	0.949543953868825	10	6	6714	7433	1.31645969660916
GO:0042693	muscle cell fate commitment	  5	1	1	0	5	6724	7434	0
GO:0042698	ovulation cycle	  9	0.438074670071218	1	5	4	6719	7435	1.17018639698592
GO:0042711	maternal behavior	 13	0.822979434145659	1	5	8	6719	7431	0.810129044067176
GO:0042713	sperm ejaculation	  5	0.960049771736903	1	1	4	6723	7435	0.421267102914932
GO:0042730	fibrinolysis	 15	0.99361188809009	1	3	12	6721	7427	0.421267102914932
GO:0042733	embryonic digit morphogenesis	 51	0.578323588134388	1	24	27	6700	7412	0.991216712741016
GO:0042734	presynaptic membrane	 62	0.15009462790899	0.919686434773344	34	28	6690	7411	1.15508721766997
GO:0042737	drug catabolic process	  5	0.960049771736903	1	1	4	6723	7435	0.421267102914932
GO:0042738	exogenous drug catabolic process	  9	0.882794860340315	1	3	6	6721	7433	0.702111838191553
GO:0042742	defense response to bacterium	 88	0.999999966639363	1	18	70	6706	7369	0.430841355253907
GO:0042743	hydrogen peroxide metabolic process	  5	0.77940058892516	1	2	3	6722	7436	0.842534205829863
GO:0042744	hydrogen peroxide catabolic process	 14	0.875453509540804	1	5	9	6719	7430	0.752262683776664
GO:0042752	regulation of circadian rhythm	 45	0.174202296951422	0.949543953868825	25	20	6699	7419	1.17018639698592
GO:0042753	positive regulation of circadian rhythm	  8	0.819878207576373	1	3	5	6721	7434	0.789875817965497
GO:0042754	negative regulation of circadian rhythm	  8	0.819878207576373	1	3	5	6721	7434	0.789875817965497
GO:0042755	eating behavior	 18	0.926471989195673	1	6	12	6718	7427	0.702111838191553
GO:0042760	very long-chain fatty acid catabolic process	  5	0.452745275304033	1	3	2	6721	7437	1.26380130874479
GO:0042761	very long-chain fatty acid biosynthetic process	  9	0.206720270758876	0.983668097955673	6	3	6718	7436	1.40422367638311
GO:0042765	GPI-anchor transamidase complex	  5	0.0241003244622537	0.495149842313607	5	0	6719	7439	2.10633551457466
GO:0042769	DNA damage response, detection of DNA damage	 32	0.0123151609101067	0.427208830906354	22	10	6702	7429	1.44810566627008
GO:0042770	signal transduction in response to DNA damage	 10	0.559603563591584	1	5	5	6719	7434	1.05316775728733
GO:0042771	intrinsic apoptotic signaling pathway in response to DNA damage by p53 class mediator	 27	0.900547220633958	1	10	17	6714	7422	0.780124264657281
GO:0042775	mitochondrial ATP synthesis coupled electron transport	  8	0.00257530804409448	0.243683246401858	8	0	6716	7439	2.10633551457466
GO:0042776	mitochondrial ATP synthesis coupled proton transport	 17	0.000585323700598568	0.129194878970953	15	2	6709	7437	1.8585313363894
GO:0042788	polysomal ribosome	  7	0.444912401367032	1	4	3	6720	7436	1.20362029404266
GO:0042789	mRNA transcription from RNA polymerase II promoter	 13	0.822979434145659	1	5	8	6719	7431	0.810129044067176
GO:0042791	5S class rRNA transcription from RNA polymerase III type 1 promoter	  5	0.77940058892516	1	2	3	6722	7436	0.842534205829863
GO:0042795	snRNA transcription from RNA polymerase II promoter	 65	0.0156366928237594	0.482647010581493	40	25	6684	7414	1.29620647050748
GO:0042796	snRNA transcription from RNA polymerase III promoter	  6	0.0874151689581943	0.807895728316903	5	1	6719	7438	1.75527959547888
GO:0042797	tRNA transcription from RNA polymerase III promoter	  5	0.77940058892516	1	2	3	6722	7436	0.842534205829863
GO:0042800	histone methyltransferase activity (H3-K4 specific)	 14	0.0625726545054608	0.771729405567349	10	4	6714	7435	1.50452536755333
GO:0042805	actinin binding	  9	0.69404490204849	1	4	5	6720	7434	0.936149117588737
GO:0042809	vitamin D receptor binding	 15	0.421118865258844	1	8	7	6716	7432	1.12337894110648
GO:0042813	Wnt-activated receptor activity	 18	0.687525801418504	1	8	10	6716	7429	0.936149117588737
GO:0042826	histone deacetylase binding	 94	0.856084121480938	1	40	54	6684	7385	0.896312984925386
GO:0042832	defense response to protozoan	 15	0.999074560034374	1	2	13	6722	7426	0.280844735276621
GO:0042834	peptidoglycan binding	  9	1	1	0	9	6724	7430	0
GO:0042866	pyruvate biosynthetic process	  6	0.979023167332401	1	1	5	6723	7434	0.351055919095776
GO:0042908	xenobiotic transport	  9	0.972243904416257	1	2	7	6722	7432	0.468074558794368
GO:0042921	glucocorticoid receptor signaling pathway	  8	0.113810689204897	0.88413902838582	6	2	6718	7437	1.57975163593099
GO:0042923	neuropeptide binding	 12	0.899474094191123	1	4	8	6720	7431	0.702111838191553
GO:0042953	lipoprotein transport	 11	0.850917330440019	1	4	7	6720	7432	0.765940187118057
GO:0042974	retinoic acid receptor binding	 16	0.706693964264422	1	7	9	6717	7430	0.921521787626413
GO:0042975	peroxisome proliferator activated receptor binding	  9	0.438074670071218	1	5	4	6719	7435	1.17018639698592
GO:0042982	amyloid precursor protein metabolic process	  9	0.067355898427907	0.780679208284898	7	2	6717	7437	1.63826095578029
GO:0042985	negative regulation of amyloid precursor protein biosynthetic process	  6	0.865182793759413	1	2	4	6722	7435	0.702111838191553
GO:0042987	amyloid precursor protein catabolic process	  6	0.0874151689581943	0.807895728316903	5	1	6719	7438	1.75527959547888
GO:0042993	positive regulation of transcription factor import into nucleus	 12	0.899474094191123	1	4	8	6720	7431	0.702111838191553
GO:0042994	cytoplasmic sequestering of transcription factor	 12	0.75380380293781	1	5	7	6719	7432	0.877639797739441
GO:0043001	Golgi to plasma membrane protein transport	 20	0.325733222000695	1	11	9	6713	7430	1.15848453301606
GO:0043008	ATP-dependent protein binding	  8	0.309544448231027	1	5	3	6719	7436	1.31645969660916
GO:0043010	camera-type eye development	 55	0.981116407959451	1	19	36	6705	7403	0.727643177762154
GO:0043011	myeloid dendritic cell differentiation	 14	0.956679005412873	1	4	10	6720	7429	0.601810147021331
GO:0043014	alpha-tubulin binding	 22	0.325498770721016	1	12	10	6712	7429	1.14891028067709
GO:0043015	gamma-tubulin binding	 23	0.140447795438852	0.919686434773344	14	9	6710	7430	1.2821172697411
GO:0043020	NADPH oxidase complex	  7	1	1	0	7	6724	7432	0
GO:0043021	ribonucleoprotein complex binding	 28	0.616649478927714	1	13	15	6711	7424	0.977941488909663
GO:0043022	ribosome binding	 45	0.261282040573043	1	24	21	6700	7418	1.12337894110648
GO:0043023	ribosomal large subunit binding	  8	0.580280354503036	1	4	4	6720	7435	1.05316775728733
GO:0043024	ribosomal small subunit binding	  9	0.206720270758876	0.983668097955673	6	3	6718	7436	1.40422367638311
GO:0043027	cysteine-type endopeptidase inhibitor activity involved in apoptotic process	 19	0.592680980401227	1	9	10	6715	7429	0.997737875324838
GO:0043029	T cell homeostasis	 26	0.62841636814953	1	12	14	6712	7425	0.972154852880611
GO:0043030	regulation of macrophage activation	  5	0.77940058892516	1	2	3	6722	7436	0.842534205829863
GO:0043031	negative regulation of macrophage activation	  7	0.919244306193629	1	2	5	6722	7434	0.601810147021331
GO:0043032	positive regulation of macrophage activation	 14	0.956679005412873	1	4	10	6720	7429	0.601810147021331
GO:0043034	costamere	 18	0.974269347793119	1	5	13	6719	7426	0.585093198492961
GO:0043039	tRNA aminoacylation	 11	0.665993939534306	1	5	6	6719	7433	0.957425233897572
GO:0043043	peptide biosynthetic process	  5	0.452745275304033	1	3	2	6721	7437	1.26380130874479
GO:0043044	ATP-dependent chromatin remodeling	 23	0.40318807961294	1	12	11	6712	7428	1.09895765977808
GO:0043046	DNA methylation involved in gamete generation	 12	0.320810094151237	1	7	5	6717	7434	1.22869571683522
GO:0043068	positive regulation of programmed cell death	  9	0.972243904416257	1	2	7	6722	7432	0.468074558794368
GO:0043069	negative regulation of programmed cell death	 13	0.643122793005253	1	6	7	6718	7432	0.972154852880611
GO:0043083	synaptic cleft	  9	0.438074670071218	1	5	4	6719	7435	1.17018639698592
GO:0043085	positive regulation of catalytic activity	 75	0.509098215018364	1	36	39	6688	7400	1.01104104699584
GO:0043086	negative regulation of catalytic activity	 73	0.693236260539133	1	33	40	6691	7399	0.95217906823238
GO:0043087	regulation of GTPase activity	 74	0.153997653641112	0.919686434773344	40	34	6684	7405	1.13855973760792
GO:0043097	pyrimidine nucleoside salvage	 10	0.925275888620553	1	3	7	6721	7432	0.631900654372397
GO:0043101	purine-containing compound salvage	 13	0.230372725000093	1	8	5	6716	7434	1.29620647050748
GO:0043113	receptor clustering	 22	0.796326194402031	1	9	13	6715	7426	0.861682710507815
GO:0043114	regulation of vascular permeability	 10	0.998406526036605	1	1	9	6723	7430	0.210633551457466
GO:0043116	negative regulation of vascular permeability	 11	0.850917330440019	1	4	7	6720	7432	0.765940187118057
GO:0043117	positive regulation of vascular permeability	  8	0.952366339066048	1	2	6	6722	7433	0.526583878643665
GO:0043122	regulation of I-kappaB kinase/NF-kappaB signaling	 11	0.953160347938253	1	3	8	6721	7431	0.574455140338543
GO:0043124	negative regulation of I-kappaB kinase/NF-kappaB signaling	 33	0.985542043337194	1	10	23	6714	7416	0.638283489265048
GO:0043129	surfactant homeostasis	  6	0.865182793759413	1	2	4	6722	7435	0.702111838191553
GO:0043130	ubiquitin binding	 61	0.0464170241890774	0.646585116783694	36	25	6688	7414	1.24308325450308
GO:0043138	3	  6	0.607836179256654	1	3	3	6721	7436	1.05316775728733
GO:0043140	ATP-dependent 3	  6	0.297654371351411	1	4	2	6720	7437	1.40422367638311
GO:0043142	single-stranded DNA-dependent ATPase activity	 10	0.133503266897558	0.919686434773344	7	3	6717	7436	1.47443486020226
GO:0043149	stress fiber assembly	 13	0.230372725000093	1	8	5	6716	7434	1.29620647050748
GO:0043153	entrainment of circadian clock by photoperiod	 16	0.94165410331218	1	5	11	6719	7428	0.658229848304581
GO:0043154	negative regulation of cysteine-type endopeptidase activity involved in apoptotic process	 65	0.909421519483441	1	26	39	6698	7400	0.842534205829863
GO:0043162	ubiquitin-dependent protein catabolic process via the multivesicular body sorting pathway	 13	0.426320358160906	1	7	6	6717	7433	1.13418066169405
GO:0043169	cation binding	 13	0.230372725000093	1	8	5	6716	7434	1.29620647050748
GO:0043171	peptide catabolic process	 14	0.875453509540804	1	5	9	6719	7430	0.752262683776664
GO:0043184	vascular endothelial growth factor receptor 2 binding	  5	0.960049771736903	1	1	4	6723	7435	0.421267102914932
GO:0043186	P granule	  8	0.580280354503036	1	4	4	6720	7435	1.05316775728733
GO:0043190	ATP-binding cassette (ABC) transporter complex	  6	0.297654371351411	1	4	2	6720	7437	1.40422367638311
GO:0043194	axon initial segment	 12	0.012434352666713	0.427208830906354	10	2	6714	7437	1.75527959547888
GO:0043195	terminal bouton	 57	0.0434687392586992	0.646585116783694	34	23	6690	7416	1.25641065781646
GO:0043196	varicosity	  7	0.730029012673872	1	3	4	6721	7435	0.902715220531996
GO:0043198	dendritic shaft	 36	0.806389293048998	1	15	21	6709	7418	0.877639797739441
GO:0043200	response to amino acid	 29	0.154605460192393	0.919686434773344	17	12	6707	7427	1.23474840509549
GO:0043202	lysosomal lumen	 79	0.913044518007006	1	32	47	6692	7392	0.853199195777077
GO:0043203	axon hillock	  7	0.98898631085553	1	1	6	6723	7433	0.300905073510665
GO:0043204	perikaryon	 92	0.276944698389657	1	47	45	6677	7394	1.07606270853271
GO:0043218	compact myelin	  5	0.452745275304033	1	3	2	6721	7437	1.26380130874479
GO:0043220	Schmidt-Lanterman incisure	 10	0.559603563591584	1	5	5	6719	7434	1.05316775728733
GO:0043225	ATPase-coupled anion transmembrane transporter activity	 10	0.559603563591584	1	5	5	6719	7434	1.05316775728733
GO:0043229	intracellular organelle	  8	0.113810689204897	0.88413902838582	6	2	6718	7437	1.57975163593099
GO:0043236	laminin binding	 20	0.813860390499775	1	8	12	6716	7427	0.842534205829863
GO:0043237	laminin-1 binding	  6	0.607836179256654	1	3	3	6721	7436	1.05316775728733
GO:0043240	Fanconi anaemia nuclear complex	 11	0.665993939534306	1	5	6	6719	7433	0.957425233897572
GO:0043248	proteasome assembly	 11	0.0838548499097086	0.807895728316903	8	3	6716	7436	1.53188037423611
GO:0043249	erythrocyte maturation	 10	0.559603563591584	1	5	5	6719	7434	1.05316775728733
GO:0043252	sodium-independent organic anion transport	 17	0.960992303738273	1	5	12	6719	7427	0.619510445463135
GO:0043254	regulation of protein complex assembly	 12	0.148657926965624	0.919686434773344	8	4	6716	7435	1.40422367638311
GO:0043267	negative regulation of potassium ion transport	  8	0.580280354503036	1	4	4	6720	7435	1.05316775728733
GO:0043268	positive regulation of potassium ion transport	 10	0.00700161837131091	0.354502993326374	9	1	6715	7438	1.89570196311719
GO:0043270	positive regulation of ion transport	  6	1	1	0	6	6724	7433	0
GO:0043274	phospholipase binding	 11	0.431935112460319	1	6	5	6718	7434	1.14891028067709
GO:0043276	anoikis	 10	0.316545776550851	1	6	4	6718	7435	1.26380130874479
GO:0043277	apoptotic cell clearance	 16	0.982365044000861	1	4	12	6720	7427	0.526583878643665
GO:0043278	response to morphine	 24	0.481410334966146	1	12	12	6712	7427	1.05316775728733
GO:0043279	response to alkaloid	  5	0.452745275304033	1	3	2	6721	7437	1.26380130874479
GO:0043280	positive regulation of cysteine-type endopeptidase activity involved in apoptotic process	 40	0.560614403487468	1	19	21	6705	7418	1.00050936942296
GO:0043281	regulation of cysteine-type endopeptidase activity involved in apoptotic process	 11	0.850917330440019	1	4	7	6720	7432	0.765940187118057
GO:0043292	contractile fiber	 14	0.998346203775137	1	2	12	6722	7427	0.300905073510665
GO:0043295	glutathione binding	  9	0.882794860340315	1	3	6	6721	7433	0.702111838191553
GO:0043296	apical junction complex	 13	0.933471720877997	1	4	9	6720	7430	0.648103235253741
GO:0043297	apical junction assembly	  7	0.919244306193629	1	2	5	6722	7434	0.601810147021331
GO:0043303	mast cell degranulation	 12	0.899474094191123	1	4	8	6720	7431	0.702111838191553
GO:0043304	regulation of mast cell degranulation	  9	0.69404490204849	1	4	5	6720	7434	0.936149117588737
GO:0043305	negative regulation of mast cell degranulation	  6	0.979023167332401	1	1	5	6723	7434	0.351055919095776
GO:0043306	positive regulation of mast cell degranulation	 10	0.998406526036605	1	1	9	6723	7430	0.210633551457466
GO:0043325	phosphatidylinositol-3,4-bisphosphate binding	 18	0.687525801418504	1	8	10	6716	7429	0.936149117588737
GO:0043330	response to exogenous dsRNA	 21	0.993100479805263	1	5	16	6719	7423	0.501508455851109
GO:0043388	positive regulation of DNA binding	 21	0.57968055192832	1	10	11	6714	7428	1.00301691170222
GO:0043392	negative regulation of DNA binding	 28	0.750594068387264	1	12	16	6712	7423	0.902715220531996
GO:0043393	regulation of protein binding	 20	0.0888797275608513	0.807895728316903	13	7	6711	7432	1.36911808447353
GO:0043394	proteoglycan binding	 12	0.75380380293781	1	5	7	6719	7432	0.877639797739441
GO:0043395	heparan sulfate proteoglycan binding	 15	0.798298186583662	1	6	9	6718	7430	0.842534205829863
GO:0043401	steroid hormone mediated signaling pathway	 57	0.978605996348222	1	20	37	6704	7402	0.739065092833213
GO:0043403	skeletal muscle tissue regeneration	 14	0.875453509540804	1	5	9	6719	7430	0.752262683776664
GO:0043405	regulation of MAP kinase activity	  6	0.297654371351411	1	4	2	6720	7437	1.40422367638311
GO:0043406	positive regulation of MAP kinase activity	 50	0.999823385322296	1	12	38	6712	7401	0.505520523497918
GO:0043407	negative regulation of MAP kinase activity	 32	0.992187676419535	1	9	23	6715	7416	0.592406863474123
GO:0043408	regulation of MAPK cascade	 35	0.919397122807978	1	13	22	6711	7417	0.78235319112773
GO:0043409	negative regulation of MAPK cascade	 16	0.517377397284026	1	8	8	6716	7431	1.05316775728733
GO:0043410	positive regulation of MAPK cascade	 79	0.993976461872687	1	27	52	6697	7387	0.719886821436909
GO:0043422	protein kinase B binding	 12	0.320810094151237	1	7	5	6717	7434	1.22869571683522
GO:0043425	bHLH transcription factor binding	 21	0.976677947067874	1	6	15	6718	7424	0.601810147021331
GO:0043426	MRF binding	  5	0.960049771736903	1	1	4	6723	7435	0.421267102914932
GO:0043433	negative regulation of sequence-specific DNA binding transcription factor activity	 55	0.964068791712138	1	20	35	6704	7404	0.765940187118057
GO:0043434	response to peptide hormone	 47	0.86797491029657	1	19	28	6705	7411	0.851497335679117
GO:0043457	regulation of cellular respiration	  7	0.919244306193629	1	2	5	6722	7434	0.601810147021331
GO:0043462	regulation of ATPase activity	  7	0.444912401367032	1	4	3	6720	7436	1.20362029404266
GO:0043473	pigmentation	 33	0.161412016275142	0.922445700930811	19	14	6705	7425	1.21273862960359
GO:0043484	regulation of RNA splicing	 28	0.00285126500989527	0.244538441062453	21	7	6703	7432	1.57975163593099
GO:0043486	histone exchange	  7	0.919244306193629	1	2	5	6722	7434	0.601810147021331
GO:0043488	regulation of mRNA stability	 92	0.111381007225828	0.88413902838582	50	42	6674	7397	1.14474756226884
GO:0043491	protein kinase B signaling	 30	0.737235950138567	1	13	17	6711	7422	0.912745389649018
GO:0043495	protein membrane anchor	  9	0.882794860340315	1	3	6	6721	7433	0.702111838191553
GO:0043496	regulation of protein homodimerization activity	  7	0.730029012673872	1	3	4	6721	7435	0.902715220531996
GO:0043497	regulation of protein heterodimerization activity	  8	0.580280354503036	1	4	4	6720	7435	1.05316775728733
GO:0043507	positive regulation of JUN kinase activity	 31	0.877080826063238	1	12	19	6712	7420	0.815355683061158
GO:0043508	negative regulation of JUN kinase activity	 12	0.899474094191123	1	4	8	6720	7431	0.702111838191553
GO:0043517	positive regulation of DNA damage response, signal transduction by p53 class mediator	  9	0.69404490204849	1	4	5	6720	7434	0.936149117588737
GO:0043518	negative regulation of DNA damage response, signal transduction by p53 class mediator	 12	0.971055765853963	1	3	9	6721	7430	0.526583878643665
GO:0043522	leucine zipper domain binding	  9	0.438074670071218	1	5	4	6719	7435	1.17018639698592
GO:0043523	regulation of neuron apoptotic process	 18	0.325568860476231	1	10	8	6714	7431	1.17018639698592
GO:0043525	positive regulation of neuron apoptotic process	 41	0.494590306023443	1	20	21	6704	7418	1.02748073881691
GO:0043531	ADP binding	 30	0.0267851253080875	0.513633698598941	20	10	6704	7429	1.40422367638311
GO:0043533	inositol 1,3,4,5 tetrakisphosphate binding	  5	0.77940058892516	1	2	3	6722	7436	0.842534205829863
GO:0043534	blood vessel endothelial cell migration	  8	0.819878207576373	1	3	5	6721	7434	0.789875817965497
GO:0043535	regulation of blood vessel endothelial cell migration	  5	0.960049771736903	1	1	4	6723	7435	0.421267102914932
GO:0043536	positive regulation of blood vessel endothelial cell migration	 19	0.949176156916864	1	6	13	6718	7426	0.665158583549892
GO:0043537	negative regulation of blood vessel endothelial cell migration	 11	0.999163575349816	1	1	10	6723	7429	0.191485046779514
GO:0043539	protein serine/threonine kinase activator activity	 18	0.687525801418504	1	8	10	6716	7429	0.936149117588737
GO:0043542	endothelial cell migration	 25	0.912607021347774	1	9	16	6715	7423	0.758280785246877
GO:0043546	molybdopterin cofactor binding	  6	0.607836179256654	1	3	3	6721	7436	1.05316775728733
GO:0043548	phosphatidylinositol 3-kinase binding	 19	0.248077880408704	1	11	8	6713	7431	1.2194574031748
GO:0043549	regulation of kinase activity	  5	0.157494903089267	0.919686434773344	4	1	6720	7438	1.68506841165973
GO:0043550	regulation of lipid kinase activity	  5	0.157494903089267	0.919686434773344	4	1	6720	7438	1.68506841165973
GO:0043551	regulation of phosphatidylinositol 3-kinase activity	  6	0.865182793759413	1	2	4	6722	7435	0.702111838191553
GO:0043552	positive regulation of phosphatidylinositol 3-kinase activity	 27	0.993722653510536	1	7	20	6717	7419	0.546086985260096
GO:0043559	insulin binding	  5	0.0241003244622537	0.495149842313607	5	0	6719	7439	2.10633551457466
GO:0043560	insulin receptor substrate binding	 12	0.148657926965624	0.919686434773344	8	4	6716	7435	1.40422367638311
GO:0043567	regulation of insulin-like growth factor receptor signaling pathway	  6	1	1	0	6	6724	7433	0
GO:0043568	positive regulation of insulin-like growth factor receptor signaling pathway	 12	0.899474094191123	1	4	8	6720	7431	0.702111838191553
GO:0043569	negative regulation of insulin-like growth factor receptor signaling pathway	  7	0.919244306193629	1	2	5	6722	7434	0.601810147021331
GO:0043576	regulation of respiratory gaseous exchange	  8	0.580280354503036	1	4	4	6720	7435	1.05316775728733
GO:0043583	ear development	 10	0.983985908365184	1	2	8	6722	7431	0.421267102914932
GO:0043584	nose development	  5	0.452745275304033	1	3	2	6721	7437	1.26380130874479
GO:0043586	tongue development	 10	0.925275888620553	1	3	7	6721	7432	0.631900654372397
GO:0043588	skin development	 37	0.978436787719667	1	12	25	6712	7414	0.683135842564754
GO:0043589	skin morphogenesis	  8	0.952366339066048	1	2	6	6722	7433	0.526583878643665
GO:0043596	nuclear replication fork	  7	0.187210848839696	0.949543953868825	5	2	6719	7437	1.50452536755333
GO:0043615	astrocyte cell migration	  5	1	1	0	5	6724	7434	0
GO:0043616	keratinocyte proliferation	 10	0.998406526036605	1	1	9	6723	7430	0.210633551457466
GO:0043619	regulation of transcription from RNA polymerase II promoter in response to oxidative stress	  6	1	1	0	6	6724	7433	0
GO:0043620	regulation of DNA-templated transcription in response to stress	  6	0.979023167332401	1	1	5	6723	7434	0.351055919095776
GO:0043621	protein self-association	 51	0.683914232498544	1	23	28	6701	7411	0.949916016376807
GO:0043623	cellular protein complex assembly	 19	0.756503853067433	1	8	11	6716	7428	0.886878111399856
GO:0043627	response to estrogen	 50	0.996126707293628	1	15	35	6709	7404	0.631900654372397
GO:0043647	inositol phosphate metabolic process	 42	0.430327614785135	1	21	21	6703	7418	1.05316775728733
GO:0043651	linoleic acid metabolic process	 11	0.953160347938253	1	3	8	6721	7431	0.574455140338543
GO:0043652	engulfment of apoptotic cell	  5	0.77940058892516	1	2	3	6722	7436	0.842534205829863
GO:0043653	mitochondrial fragmentation involved in apoptotic process	  8	0.113810689204897	0.88413902838582	6	2	6718	7437	1.57975163593099
GO:0043654	recognition of apoptotic cell	  7	0.98898631085553	1	1	6	6723	7433	0.300905073510665
GO:0043657	host cell	 53	0.259455447035684	1	28	25	6696	7414	1.11278102656774
GO:0043666	regulation of phosphoprotein phosphatase activity	  7	0.187210848839696	0.949543953868825	5	2	6719	7437	1.50452536755333
GO:0043679	axon terminus	 49	0.692449613722238	1	22	27	6702	7412	0.945701659604948
GO:0043691	reverse cholesterol transport	 12	0.971055765853963	1	3	9	6721	7430	0.526583878643665
GO:0043813	phosphatidylinositol-3,5-bisphosphate 5-phosphatase activity	  5	0.157494903089267	0.919686434773344	4	1	6720	7438	1.68506841165973
GO:0043922	negative regulation by host of viral transcription	  9	0.882794860340315	1	3	6	6721	7433	0.702111838191553
GO:0043923	positive regulation by host of viral transcription	 14	0.160610520833599	0.919686434773344	9	5	6715	7434	1.35407283079799
GO:0043928	exonucleolytic nuclear-transcribed mRNA catabolic process involved in deadenylation-dependent decay	 31	0.00693793578020524	0.354502993326374	22	9	6702	7430	1.49481875227879
GO:0043931	ossification involved in bone maturation	  7	0.919244306193629	1	2	5	6722	7434	0.601810147021331
GO:0043949	regulation of cAMP-mediated signaling	  5	0.452745275304033	1	3	2	6721	7437	1.26380130874479
GO:0043950	positive regulation of cAMP-mediated signaling	  7	0.919244306193629	1	2	5	6722	7434	0.601810147021331
GO:0043951	negative regulation of cAMP-mediated signaling	  7	0.0474968970055936	0.646585116783694	6	1	6718	7438	1.80543044106399
GO:0043966	histone H3 acetylation	 37	0.507552451933799	1	18	19	6706	7420	1.02470376384713
GO:0043967	histone H4 acetylation	 28	0.323270654016595	1	15	13	6709	7426	1.128394025665
GO:0043968	histone H2A acetylation	 15	0.0393086686268318	0.625040317669623	11	4	6713	7435	1.54464604402142
GO:0043981	histone H4-K5 acetylation	 13	0.00687971396051248	0.354502993326374	11	2	6713	7437	1.78228389694779
GO:0043982	histone H4-K8 acetylation	 13	0.00687971396051248	0.354502993326374	11	2	6713	7437	1.78228389694779
GO:0043983	histone H4-K12 acetylation	  6	0.0874151689581943	0.807895728316903	5	1	6719	7438	1.75527959547888
GO:0043984	histone H4-K16 acetylation	 12	0.012434352666713	0.427208830906354	10	2	6714	7437	1.75527959547888
GO:0043985	histone H4-R3 methylation	  6	0.865182793759413	1	2	4	6722	7435	0.702111838191553
GO:0043995	histone acetyltransferase activity (H4-K5 specific)	  8	0.025392299605826	0.495149842313607	7	1	6717	7438	1.84304357525283
GO:0043996	histone acetyltransferase activity (H4-K8 specific)	  8	0.025392299605826	0.495149842313607	7	1	6717	7438	1.84304357525283
GO:0044030	regulation of DNA methylation	 13	0.933471720877997	1	4	9	6720	7430	0.648103235253741
GO:0044070	regulation of anion transport	 10	0.133503266897558	0.919686434773344	7	3	6717	7436	1.47443486020226
GO:0044130	negative regulation of growth of symbiont in host	 11	0.990836032904502	1	2	9	6722	7430	0.382970093559029
GO:0044183	protein binding involved in protein folding	 24	0.194475510371151	0.972714597800941	14	10	6710	7429	1.22869571683522
GO:0044224	juxtaparanode region of axon	 10	0.559603563591584	1	5	5	6719	7434	1.05316775728733
GO:0044232	organelle membrane contact site	  5	0.452745275304033	1	3	2	6721	7437	1.26380130874479
GO:0044233	ER-mitochondrion membrane contact site	  9	0.438074670071218	1	5	4	6719	7435	1.17018639698592
GO:0044237	cellular metabolic process	 10	0.559603563591584	1	5	5	6719	7434	1.05316775728733
GO:0044255	cellular lipid metabolic process	 13	0.426320358160906	1	7	6	6717	7433	1.13418066169405
GO:0044257	cellular protein catabolic process	 14	0.728526098434397	1	6	8	6718	7431	0.902715220531996
GO:0044281	small molecule metabolic process	  8	0.309544448231027	1	5	3	6719	7436	1.31645969660916
GO:0044291	cell-cell contact zone	 18	0.325568860476231	1	10	8	6714	7431	1.17018639698592
GO:0044294	dendritic growth cone	  5	0.77940058892516	1	2	3	6722	7436	0.842534205829863
GO:0044295	axonal growth cone	 18	0.506938913103874	1	9	9	6715	7430	1.05316775728733
GO:0044297	cell body	 75	0.509098215018364	1	36	39	6688	7400	1.01104104699584
GO:0044300	cerebellar mossy fiber	  5	0.77940058892516	1	2	3	6722	7436	0.842534205829863
GO:0044306	neuron projection terminus	 18	0.0300950583180779	0.549711001936538	13	5	6711	7434	1.5212423160817
GO:0044309	neuron spine	  6	1	1	0	6	6724	7433	0
GO:0044319	wound healing, spreading of cells	 12	0.899474094191123	1	4	8	6720	7431	0.702111838191553
GO:0044320	cellular response to leptin stimulus	  9	0.438074670071218	1	5	4	6719	7435	1.17018639698592
GO:0044321	response to leptin	 10	0.559603563591584	1	5	5	6719	7434	1.05316775728733
GO:0044322	endoplasmic reticulum quality control compartment	 20	0.0117131731557092	0.427208830906354	15	5	6709	7434	1.57975163593099
GO:0044327	dendritic spine head	  7	0.0474968970055936	0.646585116783694	6	1	6718	7438	1.80543044106399
GO:0044341	sodium-dependent phosphate transport	  5	0.452745275304033	1	3	2	6721	7437	1.26380130874479
GO:0044342	type B pancreatic cell proliferation	  8	0.994217735396885	1	1	7	6723	7432	0.263291939321832
GO:0044344	cellular response to fibroblast growth factor stimulus	 29	0.800246571563356	1	12	17	6712	7422	0.871587109479169
GO:0044351	macropinocytosis	  6	0.865182793759413	1	2	4	6722	7435	0.702111838191553
GO:0044354	macropinosome	  6	0.607836179256654	1	3	3	6721	7436	1.05316775728733
GO:0044387	negative regulation of protein kinase activity by regulation of protein phosphorylation	  7	0.730029012673872	1	3	4	6721	7435	0.902715220531996
GO:0044388	small protein activating enzyme binding	  5	0.960049771736903	1	1	4	6723	7435	0.421267102914932
GO:0044389	ubiquitin-like protein ligase binding	  8	0.309544448231027	1	5	3	6719	7436	1.31645969660916
GO:0044458	motile cilium assembly	 19	0.756503853067433	1	8	11	6716	7428	0.886878111399856
GO:0044539	long-chain fatty acid import	  7	0.444912401367032	1	4	3	6720	7436	1.20362029404266
GO:0044548	S100 protein binding	 12	0.994792086314609	1	2	10	6722	7429	0.351055919095776
GO:0044597	daunorubicin metabolic process	  7	0.98898631085553	1	1	6	6723	7433	0.300905073510665
GO:0044598	doxorubicin metabolic process	  7	0.98898631085553	1	1	6	6723	7433	0.300905073510665
GO:0044613	nuclear pore central transport channel	  5	0.77940058892516	1	2	3	6722	7436	0.842534205829863
GO:0044615	nuclear pore nuclear basket	  6	0.865182793759413	1	2	4	6722	7435	0.702111838191553
GO:0044666	MLL3/4 complex	  8	0.309544448231027	1	5	3	6719	7436	1.31645969660916
GO:0044754	autolysosome	  8	0.113810689204897	0.88413902838582	6	2	6718	7437	1.57975163593099
GO:0044770	cell cycle phase transition	  6	0.607836179256654	1	3	3	6721	7436	1.05316775728733
GO:0044782	cilium organization	  8	0.113810689204897	0.88413902838582	6	2	6718	7437	1.57975163593099
GO:0044791	positive regulation by host of viral release from host cell	  5	0.77940058892516	1	2	3	6722	7436	0.842534205829863
GO:0044794	positive regulation by host of viral process	  6	0.979023167332401	1	1	5	6723	7434	0.351055919095776
GO:0044798	nuclear transcription factor complex	 11	0.850917330440019	1	4	7	6720	7432	0.765940187118057
GO:0044804	autophagy of nucleus	 14	0.160610520833599	0.919686434773344	9	5	6715	7434	1.35407283079799
GO:0044806	G-quadruplex DNA unwinding	  6	0.607836179256654	1	3	3	6721	7436	1.05316775728733
GO:0044828	negative regulation by host of viral genome replication	  5	0.452745275304033	1	3	2	6721	7437	1.26380130874479
GO:0044829	positive regulation by host of viral genome replication	  6	0.607836179256654	1	3	3	6721	7436	1.05316775728733
GO:0044849	estrous cycle	 13	0.982330979346752	1	3	10	6721	7429	0.486077426440306
GO:0044853	plasma membrane raft	 15	0.914031171019375	1	5	10	6719	7429	0.702111838191553
GO:0044877	macromolecular complex binding	 10	0.78367246101976	1	4	6	6720	7433	0.842534205829863
GO:0045008	depyrimidination	  7	0.0474968970055936	0.646585116783694	6	1	6718	7438	1.80543044106399
GO:0045010	actin nucleation	 11	0.431935112460319	1	6	5	6718	7434	1.14891028067709
GO:0045019	negative regulation of nitric oxide biosynthetic process	 11	0.953160347938253	1	3	8	6721	7431	0.574455140338543
GO:0045022	early endosome to late endosome transport	 18	0.687525801418504	1	8	10	6716	7429	0.936149117588737
GO:0045026	plasma membrane fusion	  6	0.865182793759413	1	2	4	6722	7435	0.702111838191553
GO:0045028	G-protein coupled purinergic nucleotide receptor activity	 10	0.925275888620553	1	3	7	6721	7432	0.631900654372397
GO:0045046	protein import into peroxisome membrane	  6	0.297654371351411	1	4	2	6720	7437	1.40422367638311
GO:0045047	protein targeting to ER	  9	0.438074670071218	1	5	4	6719	7435	1.17018639698592
GO:0045055	regulated exocytosis	 14	0.0183006792268162	0.495149842313607	11	3	6713	7436	1.65497790430866
GO:0045056	transcytosis	 13	0.230372725000093	1	8	5	6716	7434	1.29620647050748
GO:0045059	positive thymic T cell selection	  8	0.952366339066048	1	2	6	6722	7433	0.526583878643665
GO:0045060	negative thymic T cell selection	 12	0.75380380293781	1	5	7	6719	7432	0.877639797739441
GO:0045063	T-helper 1 cell differentiation	  5	0.77940058892516	1	2	3	6722	7436	0.842534205829863
GO:0045070	positive regulation of viral genome replication	 26	0.474259103737385	1	13	13	6711	7426	1.05316775728733
GO:0045071	negative regulation of viral genome replication	 37	0.9910373833468	1	11	26	6713	7413	0.626207855684358
GO:0045078	positive regulation of interferon-gamma biosynthetic process	  8	0.994217735396885	1	1	7	6723	7432	0.263291939321832
GO:0045080	positive regulation of chemokine biosynthetic process	  7	1	1	0	7	6724	7432	0
GO:0045084	positive regulation of interleukin-12 biosynthetic process	  5	0.960049771736903	1	1	4	6723	7435	0.421267102914932
GO:0045086	positive regulation of interleukin-2 biosynthetic process	  9	0.69404490204849	1	4	5	6720	7434	0.936149117588737
GO:0045088	regulation of innate immune response	 13	0.822979434145659	1	5	8	6719	7431	0.810129044067176
GO:0045089	positive regulation of innate immune response	 19	0.756503853067433	1	8	11	6716	7428	0.886878111399856
GO:0045095	keratin filament	 35	0.99928552976371	1	8	27	6716	7412	0.481448117617065
GO:0045104	intermediate filament cytoskeleton organization	 15	0.237875362689918	1	9	6	6715	7433	1.26380130874479
GO:0045109	intermediate filament organization	 13	0.982330979346752	1	3	10	6721	7429	0.486077426440306
GO:0045111	intermediate filament cytoskeleton	 43	0.720084586280627	1	19	24	6705	7415	0.930706390160895
GO:0045116	protein neddylation	 12	0.012434352666713	0.427208830906354	10	2	6714	7437	1.75527959547888
GO:0045120	pronucleus	  5	0.77940058892516	1	2	3	6722	7436	0.842534205829863
GO:0045124	regulation of bone resorption	  8	0.952366339066048	1	2	6	6722	7433	0.526583878643665
GO:0045132	meiotic chromosome segregation	  5	0.157494903089267	0.919686434773344	4	1	6720	7438	1.68506841165973
GO:0045141	meiotic telomere clustering	  7	0.730029012673872	1	3	4	6721	7435	0.902715220531996
GO:0045162	clustering of voltage-gated sodium channels	  7	0.187210848839696	0.949543953868825	5	2	6719	7437	1.50452536755333
GO:0045165	cell fate commitment	 51	0.999629545683643	1	13	38	6711	7401	0.536909052734717
GO:0045171	intercellular bridge	 40	0.0401507445605401	0.629755700009341	25	15	6699	7424	1.31645969660916
GO:0045176	apical protein localization	  8	0.819878207576373	1	3	5	6721	7434	0.789875817965497
GO:0045177	apical part of cell	 79	0.751025705768999	1	35	44	6689	7395	0.933186620381178
GO:0045178	basal part of cell	 12	0.75380380293781	1	5	7	6719	7432	0.877639797739441
GO:0045179	apical cortex	  7	0.919244306193629	1	2	5	6722	7434	0.601810147021331
GO:0045180	basal cortex	  5	0.157494903089267	0.919686434773344	4	1	6720	7438	1.68506841165973
GO:0045182	translation regulator activity	  8	0.309544448231027	1	5	3	6719	7436	1.31645969660916
GO:0045184	establishment of protein localization	 35	0.38156969113121	1	18	17	6706	7422	1.0832582646384
GO:0045190	isotype switching	 13	0.0975861781940815	0.843214701401555	9	4	6715	7435	1.45823227932092
GO:0045197	establishment or maintenance of epithelial cell apical/basal polarity	 11	0.665993939534306	1	5	6	6719	7433	0.957425233897572
GO:0045198	establishment of epithelial cell apical/basal polarity	  7	0.98898631085553	1	1	6	6723	7433	0.300905073510665
GO:0045199	maintenance of epithelial cell apical/basal polarity	 10	0.316545776550851	1	6	4	6718	7435	1.26380130874479
GO:0045214	sarcomere organization	 28	0.855143171976428	1	11	17	6713	7422	0.82748895215433
GO:0045216	cell-cell junction organization	 16	0.94165410331218	1	5	11	6719	7428	0.658229848304581
GO:0045236	CXCR chemokine receptor binding	  7	0.444912401367032	1	4	3	6720	7436	1.20362029404266
GO:0045252	oxoglutarate dehydrogenase complex	  5	0.0241003244622537	0.495149842313607	5	0	6719	7439	2.10633551457466
GO:0045254	pyruvate dehydrogenase complex	  5	0.0241003244622537	0.495149842313607	5	0	6719	7439	2.10633551457466
GO:0045261	proton-transporting ATP synthase complex, catalytic core F(1)	  5	0.157494903089267	0.919686434773344	4	1	6720	7438	1.68506841165973
GO:0045263	proton-transporting ATP synthase complex, coupling factor F(o)	  9	0.0134026999423743	0.442059337527911	8	1	6716	7438	1.87229823517747
GO:0045292	mRNA cis splicing, via spliceosome	  8	0.819878207576373	1	3	5	6721	7434	0.789875817965497
GO:0045294	alpha-catenin binding	 10	0.925275888620553	1	3	7	6721	7432	0.631900654372397
GO:0045295	gamma-catenin binding	  8	0.309544448231027	1	5	3	6719	7436	1.31645969660916
GO:0045332	phospholipid translocation	 19	0.248077880408704	1	11	8	6713	7431	1.2194574031748
GO:0045333	cellular respiration	 21	0.25155850170495	1	12	9	6712	7430	1.20362029404266
GO:0045334	clathrin-coated endocytic vesicle	 12	0.320810094151237	1	7	5	6717	7434	1.22869571683522
GO:0045335	phagocytic vesicle	 44	0.425925500476264	1	22	22	6702	7417	1.05316775728733
GO:0045345	positive regulation of MHC class I biosynthetic process	  5	0.452745275304033	1	3	2	6721	7437	1.26380130874479
GO:0045359	positive regulation of interferon-beta biosynthetic process	  6	0.607836179256654	1	3	3	6721	7436	1.05316775728733
GO:0045410	positive regulation of interleukin-6 biosynthetic process	  5	0.960049771736903	1	1	4	6723	7435	0.421267102914932
GO:0045416	positive regulation of interleukin-8 biosynthetic process	  7	0.444912401367032	1	4	3	6720	7436	1.20362029404266
GO:0045429	positive regulation of nitric oxide biosynthetic process	 37	0.910685535190972	1	14	23	6710	7416	0.796991816325546
GO:0045444	fat cell differentiation	 63	0.122928881455775	0.919686434773344	35	28	6689	7411	1.17018639698592
GO:0045445	myoblast differentiation	 18	0.325568860476231	1	10	8	6714	7431	1.17018639698592
GO:0045446	endothelial cell differentiation	 10	0.559603563591584	1	5	5	6719	7434	1.05316775728733
GO:0045453	bone resorption	 20	0.9653537478209	1	6	14	6718	7425	0.631900654372397
GO:0045454	cell redox homeostasis	 58	0.302031515663194	1	30	28	6694	7411	1.08948388684896
GO:0045471	response to ethanol	 88	0.820114477766824	1	38	50	6686	7389	0.909553972202693
GO:0045475	locomotor rhythm	  8	0.819878207576373	1	3	5	6721	7434	0.789875817965497
GO:0045494	photoreceptor cell maintenance	 24	0.481410334966146	1	12	12	6712	7427	1.05316775728733
GO:0045499	chemorepellent activity	  8	0.580280354503036	1	4	4	6720	7435	1.05316775728733
GO:0045503	dynein light chain binding	 19	0.592680980401227	1	9	10	6715	7429	0.997737875324838
GO:0045504	dynein heavy chain binding	 12	0.320810094151237	1	7	5	6717	7434	1.22869571683522
GO:0045505	dynein intermediate chain binding	 19	0.411669949440149	1	10	9	6714	7430	1.10859763924982
GO:0045540	regulation of cholesterol biosynthetic process	 32	0.00449374253934093	0.308784308774713	23	9	6701	7430	1.51392865110054
GO:0045541	negative regulation of cholesterol biosynthetic process	  5	0.960049771736903	1	1	4	6723	7435	0.421267102914932
GO:0045545	syndecan binding	  6	0.865182793759413	1	2	4	6722	7435	0.702111838191553
GO:0045576	mast cell activation	  8	0.952366339066048	1	2	6	6722	7433	0.526583878643665
GO:0045577	regulation of B cell differentiation	  7	0.730029012673872	1	3	4	6721	7435	0.902715220531996
GO:0045579	positive regulation of B cell differentiation	 10	0.559603563591584	1	5	5	6719	7434	1.05316775728733
GO:0045580	regulation of T cell differentiation	  9	0.882794860340315	1	3	6	6721	7433	0.702111838191553
GO:0045581	negative regulation of T cell differentiation	  5	0.960049771736903	1	1	4	6723	7435	0.421267102914932
GO:0045582	positive regulation of T cell differentiation	 10	0.925275888620553	1	3	7	6721	7432	0.631900654372397
GO:0045589	regulation of regulatory T cell differentiation	 11	0.990836032904502	1	2	9	6722	7430	0.382970093559029
GO:0045591	positive regulation of regulatory T cell differentiation	  9	0.996964464269463	1	1	8	6723	7431	0.234037279397184
GO:0045595	regulation of cell differentiation	 33	0.522004835191274	1	16	17	6708	7422	1.02125358282408
GO:0045596	negative regulation of cell differentiation	 34	0.945955639398543	1	12	22	6712	7417	0.743412534555762
GO:0045597	positive regulation of cell differentiation	 41	0.9993329976672	1	10	31	6714	7408	0.513740369408453
GO:0045598	regulation of fat cell differentiation	 13	0.643122793005253	1	6	7	6718	7432	0.972154852880611
GO:0045599	negative regulation of fat cell differentiation	 38	0.439698594040043	1	19	19	6705	7420	1.05316775728733
GO:0045600	positive regulation of fat cell differentiation	 43	0.999710855537025	1	10	33	6714	7406	0.489845468505734
GO:0045602	negative regulation of endothelial cell differentiation	  6	0.607836179256654	1	3	3	6721	7436	1.05316775728733
GO:0045603	positive regulation of endothelial cell differentiation	 10	0.925275888620553	1	3	7	6721	7432	0.631900654372397
GO:0045606	positive regulation of epidermal cell differentiation	  6	1	1	0	6	6724	7433	0
GO:0045607	regulation of auditory receptor cell differentiation	  5	0.77940058892516	1	2	3	6722	7436	0.842534205829863
GO:0045616	regulation of keratinocyte differentiation	 13	0.997057742126947	1	2	11	6722	7428	0.32405161762687
GO:0045618	positive regulation of keratinocyte differentiation	 10	0.78367246101976	1	4	6	6720	7433	0.842534205829863
GO:0045627	positive regulation of T-helper 1 cell differentiation	  5	1	1	0	5	6724	7434	0
GO:0045630	positive regulation of T-helper 2 cell differentiation	  8	1	1	0	8	6724	7431	0
GO:0045637	regulation of myeloid cell differentiation	 11	0.850917330440019	1	4	7	6720	7432	0.765940187118057
GO:0045638	negative regulation of myeloid cell differentiation	 19	0.592680980401227	1	9	10	6715	7429	0.997737875324838
GO:0045646	regulation of erythrocyte differentiation	  6	0.607836179256654	1	3	3	6721	7436	1.05316775728733
GO:0045647	negative regulation of erythrocyte differentiation	  6	0.0874151689581943	0.807895728316903	5	1	6719	7438	1.75527959547888
GO:0045648	positive regulation of erythrocyte differentiation	 23	0.140447795438852	0.919686434773344	14	9	6710	7430	1.2821172697411
GO:0045650	negative regulation of macrophage differentiation	  6	0.865182793759413	1	2	4	6722	7435	0.702111838191553
GO:0045651	positive regulation of macrophage differentiation	 12	0.994792086314609	1	2	10	6722	7429	0.351055919095776
GO:0045652	regulation of megakaryocyte differentiation	 41	0.372250359182329	1	21	20	6703	7419	1.07885477575775
GO:0045653	negative regulation of megakaryocyte differentiation	  7	0.919244306193629	1	2	5	6722	7434	0.601810147021331
GO:0045654	positive regulation of megakaryocyte differentiation	  6	1	1	0	6	6724	7433	0
GO:0045656	negative regulation of monocyte differentiation	  5	0.452745275304033	1	3	2	6721	7437	1.26380130874479
GO:0045657	positive regulation of monocyte differentiation	  8	0.819878207576373	1	3	5	6721	7434	0.789875817965497
GO:0045662	negative regulation of myoblast differentiation	 19	0.983231201677496	1	5	14	6719	7425	0.55429881962491
GO:0045663	positive regulation of myoblast differentiation	 16	0.853260719975205	1	6	10	6718	7429	0.789875817965497
GO:0045664	regulation of neuron differentiation	 21	0.937043249703464	1	7	14	6717	7425	0.702111838191553
GO:0045665	negative regulation of neuron differentiation	 54	0.620920803681269	1	25	29	6699	7410	0.975155330821601
GO:0045666	positive regulation of neuron differentiation	 72	0.966172961528117	1	27	45	6697	7394	0.789875817965497
GO:0045667	regulation of osteoblast differentiation	 12	0.5430601307694	1	6	6	6718	7433	1.05316775728733
GO:0045668	negative regulation of osteoblast differentiation	 36	0.318430467659902	1	19	17	6705	7422	1.11167707713663
GO:0045669	positive regulation of osteoblast differentiation	 55	0.936280072035094	1	21	34	6703	7405	0.80423719647396
GO:0045670	regulation of osteoclast differentiation	 12	0.320810094151237	1	7	5	6717	7434	1.22869571683522
GO:0045671	negative regulation of osteoclast differentiation	 21	0.25155850170495	1	12	9	6712	7430	1.20362029404266
GO:0045672	positive regulation of osteoclast differentiation	 13	0.822979434145659	1	5	8	6719	7431	0.810129044067176
GO:0045717	negative regulation of fatty acid biosynthetic process	 12	0.899474094191123	1	4	8	6720	7431	0.702111838191553
GO:0045719	negative regulation of glycogen biosynthetic process	  6	0.0874151689581943	0.807895728316903	5	1	6719	7438	1.75527959547888
GO:0045721	negative regulation of gluconeogenesis	 11	0.665993939534306	1	5	6	6719	7433	0.957425233897572
GO:0045722	positive regulation of gluconeogenesis	  7	0.0474968970055936	0.646585116783694	6	1	6718	7438	1.80543044106399
GO:0045723	positive regulation of fatty acid biosynthetic process	 10	0.983985908365184	1	2	8	6722	7431	0.421267102914932
GO:0045724	positive regulation of cilium assembly	 12	0.320810094151237	1	7	5	6717	7434	1.22869571683522
GO:0045725	positive regulation of glycogen biosynthetic process	 13	0.0975861781940815	0.843214701401555	9	4	6715	7435	1.45823227932092
GO:0045727	positive regulation of translation	 54	0.217071591623781	1	29	25	6695	7414	1.13118018375306
GO:0045730	respiratory burst	  9	0.972243904416257	1	2	7	6722	7432	0.468074558794368
GO:0045732	positive regulation of protein catabolic process	 51	0.0687253531297482	0.794955387304422	30	21	6694	7418	1.23902089092627
GO:0045736	negative regulation of cyclin-dependent protein serine/threonine kinase activity	 20	0.497606676879603	1	10	10	6714	7429	1.05316775728733
GO:0045737	positive regulation of cyclin-dependent protein serine/threonine kinase activity	 20	0.0888797275608513	0.807895728316903	13	7	6711	7432	1.36911808447353
GO:0045739	positive regulation of DNA repair	 25	0.25641203321621	1	14	11	6710	7428	1.17954788816181
GO:0045740	positive regulation of DNA replication	 33	0.260933554151229	1	18	15	6706	7424	1.14891028067709
GO:0045741	positive regulation of epidermal growth factor-activated receptor activity	  7	0.730029012673872	1	3	4	6721	7435	0.902715220531996
GO:0045742	positive regulation of epidermal growth factor receptor signaling pathway	 22	0.655120963592744	1	10	12	6714	7427	0.957425233897572
GO:0045743	positive regulation of fibroblast growth factor receptor signaling pathway	  5	0.0241003244622537	0.495149842313607	5	0	6719	7439	2.10633551457466
GO:0045744	negative regulation of G-protein coupled receptor protein signaling pathway	 10	0.925275888620553	1	3	7	6721	7432	0.631900654372397
GO:0045745	positive regulation of G-protein coupled receptor protein signaling pathway	  8	0.819878207576373	1	3	5	6721	7434	0.789875817965497
GO:0045746	negative regulation of Notch signaling pathway	 24	0.993335783917261	1	6	18	6718	7421	0.526583878643665
GO:0045747	positive regulation of Notch signaling pathway	 31	0.877080826063238	1	12	19	6712	7420	0.815355683061158
GO:0045760	positive regulation of action potential	  5	0.960049771736903	1	1	4	6723	7435	0.421267102914932
GO:0045762	positive regulation of adenylate cyclase activity	  9	0.69404490204849	1	4	5	6720	7434	0.936149117588737
GO:0045765	regulation of angiogenesis	 30	0.605736885713723	1	14	16	6710	7423	0.982956573468174
GO:0045766	positive regulation of angiogenesis	 99	0.99923861438062	1	32	67	6692	7372	0.680835721882718
GO:0045773	positive regulation of axon extension	 29	0.800246571563356	1	12	17	6712	7422	0.871587109479169
GO:0045776	negative regulation of blood pressure	 21	0.738560418161868	1	9	12	6715	7427	0.902715220531996
GO:0045777	positive regulation of blood pressure	 16	0.996207313649143	1	3	13	6721	7426	0.394937908982748
GO:0045778	positive regulation of ossification	 15	0.914031171019375	1	5	10	6719	7429	0.702111838191553
GO:0045779	negative regulation of bone resorption	 11	0.850917330440019	1	4	7	6720	7432	0.765940187118057
GO:0045780	positive regulation of bone resorption	 12	0.75380380293781	1	5	7	6719	7432	0.877639797739441
GO:0045785	positive regulation of cell adhesion	 44	0.908412996093135	1	17	27	6707	7412	0.813811448812936
GO:0045786	negative regulation of cell cycle	 34	0.996406066094079	1	9	25	6715	7414	0.557559400916821
GO:0045787	positive regulation of cell cycle	 33	0.522004835191274	1	16	17	6708	7422	1.02125358282408
GO:0045792	negative regulation of cell size	  9	0.438074670071218	1	5	4	6719	7435	1.17018639698592
GO:0045793	positive regulation of cell size	  7	0.444912401367032	1	4	3	6720	7436	1.20362029404266
GO:0045794	negative regulation of cell volume	  5	0.452745275304033	1	3	2	6721	7437	1.26380130874479
GO:0045806	negative regulation of endocytosis	  9	0.69404490204849	1	4	5	6720	7434	0.936149117588737
GO:0045807	positive regulation of endocytosis	 21	0.738560418161868	1	9	12	6715	7427	0.902715220531996
GO:0045814	negative regulation of gene expression, epigenetic	 23	0.140447795438852	0.919686434773344	14	9	6710	7430	1.2821172697411
GO:0045815	positive regulation of gene expression, epigenetic	 37	0.0973421652165049	0.843214701401555	22	15	6702	7424	1.25241571136872
GO:0045820	negative regulation of glycolytic process	 11	0.850917330440019	1	4	7	6720	7432	0.765940187118057
GO:0045821	positive regulation of glycolytic process	 16	0.517377397284026	1	8	8	6716	7431	1.05316775728733
GO:0045822	negative regulation of heart contraction	  7	0.187210848839696	0.949543953868825	5	2	6719	7437	1.50452536755333
GO:0045823	positive regulation of heart contraction	  5	0.77940058892516	1	2	3	6722	7436	0.842534205829863
GO:0045824	negative regulation of innate immune response	 10	0.78367246101976	1	4	6	6720	7433	0.842534205829863
GO:0045830	positive regulation of isotype switching	  8	0.309544448231027	1	5	3	6719	7436	1.31645969660916
GO:0045835	negative regulation of meiotic nuclear division	  6	0.865182793759413	1	2	4	6722	7435	0.702111838191553
GO:0045839	negative regulation of mitotic nuclear division	  5	0.452745275304033	1	3	2	6721	7437	1.26380130874479
GO:0045840	positive regulation of mitotic nuclear division	 20	0.911428444807446	1	7	13	6717	7426	0.73721743010113
GO:0045843	negative regulation of striated muscle tissue development	  6	0.865182793759413	1	2	4	6722	7435	0.702111838191553
GO:0045859	regulation of protein kinase activity	 37	0.166731939115621	0.949543953868825	21	16	6703	7423	1.19548772448832
GO:0045860	positive regulation of protein kinase activity	 53	0.178792350210497	0.949543953868825	29	24	6695	7415	1.15252320608802
GO:0045861	negative regulation of proteolysis	 21	0.993100479805263	1	5	16	6719	7423	0.501508455851109
GO:0045862	positive regulation of proteolysis	 17	0.776294265732228	1	7	10	6717	7429	0.867314623648389
GO:0045879	negative regulation of smoothened signaling pathway	 18	0.926471989195673	1	6	12	6718	7427	0.702111838191553
GO:0045880	positive regulation of smoothened signaling pathway	 22	0.896697486794484	1	8	14	6716	7425	0.765940187118057
GO:0045899	positive regulation of RNA polymerase II transcriptional preinitiation complex assembly	  9	0.69404490204849	1	4	5	6720	7434	0.936149117588737
GO:0045907	positive regulation of vasoconstriction	 29	0.999854975387824	1	5	24	6719	7415	0.36316129561632
GO:0045910	negative regulation of DNA recombination	  5	0.77940058892516	1	2	3	6722	7436	0.842534205829863
GO:0045921	positive regulation of exocytosis	 22	0.0147211815904588	0.464573006924516	16	6	6708	7433	1.53188037423611
GO:0045926	negative regulation of growth	 15	0.914031171019375	1	5	10	6719	7429	0.702111838191553
GO:0045927	positive regulation of growth	  6	0.865182793759413	1	2	4	6722	7435	0.702111838191553
GO:0045930	negative regulation of mitotic cell cycle	 24	0.780026211443039	1	10	14	6714	7425	0.877639797739441
GO:0045931	positive regulation of mitotic cell cycle	 25	0.14581109956432	0.919686434773344	15	10	6709	7429	1.26380130874479
GO:0045943	positive regulation of transcription from RNA polymerase I promoter	 11	0.665993939534306	1	5	6	6719	7433	0.957425233897572
GO:0045945	positive regulation of transcription from RNA polymerase III promoter	 11	0.431935112460319	1	6	5	6718	7434	1.14891028067709
GO:0045947	negative regulation of translational initiation	 13	0.643122793005253	1	6	7	6718	7432	0.972154852880611
GO:0045948	positive regulation of translational initiation	 13	0.0975861781940815	0.843214701401555	9	4	6715	7435	1.45823227932092
GO:0045954	positive regulation of natural killer cell mediated cytotoxicity	  9	0.69404490204849	1	4	5	6720	7434	0.936149117588737
GO:0045955	negative regulation of calcium ion-dependent exocytosis	  7	0.444912401367032	1	4	3	6720	7436	1.20362029404266
GO:0045956	positive regulation of calcium ion-dependent exocytosis	 16	0.0724287706601472	0.807895728316903	11	5	6713	7434	1.44810566627008
GO:0045986	negative regulation of smooth muscle contraction	  5	0.960049771736903	1	1	4	6723	7435	0.421267102914932
GO:0045987	positive regulation of smooth muscle contraction	 21	0.937043249703464	1	7	14	6717	7425	0.702111838191553
GO:0045995	regulation of embryonic development	 14	0.728526098434397	1	6	8	6718	7431	0.902715220531996
GO:0046007	negative regulation of activated T cell proliferation	  9	0.972243904416257	1	2	7	6722	7432	0.468074558794368
GO:0046034	ATP metabolic process	 32	0.0123151609101067	0.427208830906354	22	10	6702	7429	1.44810566627008
GO:0046037	GMP metabolic process	 16	0.324860333233664	1	9	7	6715	7432	1.18481372694825
GO:0046039	GTP metabolic process	 12	0.320810094151237	1	7	5	6717	7434	1.22869571683522
GO:0046069	cGMP catabolic process	  6	0.865182793759413	1	2	4	6722	7435	0.702111838191553
GO:0046135	pyrimidine nucleoside catabolic process	  7	0.919244306193629	1	2	5	6722	7434	0.601810147021331
GO:0046321	positive regulation of fatty acid oxidation	  6	0.865182793759413	1	2	4	6722	7435	0.702111838191553
GO:0046322	negative regulation of fatty acid oxidation	  5	0.960049771736903	1	1	4	6723	7435	0.421267102914932
GO:0046323	glucose import	 12	0.320810094151237	1	7	5	6717	7434	1.22869571683522
GO:0046324	regulation of glucose import	  8	0.309544448231027	1	5	3	6719	7436	1.31645969660916
GO:0046325	negative regulation of glucose import	  9	0.067355898427907	0.780679208284898	7	2	6717	7437	1.63826095578029
GO:0046326	positive regulation of glucose import	 26	0.198303125650341	0.983668097955673	15	11	6709	7428	1.21519356610076
GO:0046328	regulation of JNK cascade	 17	0.118839522247653	0.899006189270582	11	6	6713	7433	1.3629229800189
GO:0046329	negative regulation of JNK cascade	 23	0.140447795438852	0.919686434773344	14	9	6710	7430	1.2821172697411
GO:0046330	positive regulation of JNK cascade	 62	0.994820320341148	1	20	42	6704	7397	0.679463069217632
GO:0046332	SMAD binding	 45	0.261282040573043	1	24	21	6700	7418	1.12337894110648
GO:0046339	diacylglycerol metabolic process	  7	0.0474968970055936	0.646585116783694	6	1	6718	7438	1.80543044106399
GO:0046415	urate metabolic process	  8	0.952366339066048	1	2	6	6722	7433	0.526583878643665
GO:0046426	negative regulation of JAK-STAT cascade	 38	0.875639738775612	1	15	23	6709	7416	0.831448229437365
GO:0046427	positive regulation of JAK-STAT cascade	 15	0.914031171019375	1	5	10	6719	7429	0.702111838191553
GO:0046470	phosphatidylcholine metabolic process	  8	0.952366339066048	1	2	6	6722	7433	0.526583878643665
GO:0046474	glycerophospholipid biosynthetic process	  8	0.309544448231027	1	5	3	6719	7436	1.31645969660916
GO:0046475	glycerophospholipid catabolic process	  7	0.187210848839696	0.949543953868825	5	2	6719	7437	1.50452536755333
GO:0046486	glycerolipid metabolic process	  6	0.0874151689581943	0.807895728316903	5	1	6719	7438	1.75527959547888
GO:0046487	glyoxylate metabolic process	  6	0.979023167332401	1	1	5	6723	7434	0.351055919095776
GO:0046488	phosphatidylinositol metabolic process	 21	0.738560418161868	1	9	12	6715	7427	0.902715220531996
GO:0046500	S-adenosylmethionine metabolic process	  6	0.297654371351411	1	4	2	6720	7437	1.40422367638311
GO:0046512	sphingosine biosynthetic process	  6	0.297654371351411	1	4	2	6720	7437	1.40422367638311
GO:0046513	ceramide biosynthetic process	 23	0.722173726826204	1	10	13	6714	7426	0.915798049815069
GO:0046533	negative regulation of photoreceptor cell differentiation	  5	0.77940058892516	1	2	3	6722	7436	0.842534205829863
GO:0046540	U4/U6 x U5 tri-snRNP complex	 22	0.325498770721016	1	12	10	6712	7429	1.14891028067709
GO:0046541	saliva secretion	  5	0.960049771736903	1	1	4	6723	7435	0.421267102914932
GO:0046548	retinal rod cell development	  8	0.309544448231027	1	5	3	6719	7436	1.31645969660916
GO:0046549	retinal cone cell development	  6	0.607836179256654	1	3	3	6721	7436	1.05316775728733
GO:0046578	regulation of Ras protein signal transduction	  6	0.0874151689581943	0.807895728316903	5	1	6719	7438	1.75527959547888
GO:0046579	positive regulation of Ras protein signal transduction	 18	0.687525801418504	1	8	10	6716	7429	0.936149117588737
GO:0046580	negative regulation of Ras protein signal transduction	 23	0.722173726826204	1	10	13	6714	7426	0.915798049815069
GO:0046581	intercellular canaliculus	  6	0.979023167332401	1	1	5	6723	7434	0.351055919095776
GO:0046597	negative regulation of viral entry into host cell	 14	0.98932697223781	1	3	11	6721	7428	0.451357610265998
GO:0046598	positive regulation of viral entry into host cell	  9	0.996964464269463	1	1	8	6723	7431	0.234037279397184
GO:0046599	regulation of centriole replication	  6	0.865182793759413	1	2	4	6722	7435	0.702111838191553
GO:0046600	negative regulation of centriole replication	  5	0.452745275304033	1	3	2	6721	7437	1.26380130874479
GO:0046618	drug export	  5	0.960049771736903	1	1	4	6723	7435	0.421267102914932
GO:0046620	regulation of organ growth	  9	0.0134026999423743	0.442059337527911	8	1	6716	7438	1.87229823517747
GO:0046621	negative regulation of organ growth	 10	0.133503266897558	0.919686434773344	7	3	6717	7436	1.47443486020226
GO:0046622	positive regulation of organ growth	  8	0.819878207576373	1	3	5	6721	7434	0.789875817965497
GO:0046626	regulation of insulin receptor signaling pathway	  9	0.438074670071218	1	5	4	6719	7435	1.17018639698592
GO:0046627	negative regulation of insulin receptor signaling pathway	 27	0.547450272919978	1	13	14	6711	7425	1.01416154405446
GO:0046628	positive regulation of insulin receptor signaling pathway	 11	0.220387996626296	1	7	4	6717	7435	1.3403953274566
GO:0046632	alpha-beta T cell differentiation	  6	0.297654371351411	1	4	2	6720	7437	1.40422367638311
GO:0046638	positive regulation of alpha-beta T cell differentiation	  9	0.882794860340315	1	3	6	6721	7433	0.702111838191553
GO:0046641	positive regulation of alpha-beta T cell proliferation	  7	0.98898631085553	1	1	6	6723	7433	0.300905073510665
GO:0046651	lymphocyte proliferation	  5	0.77940058892516	1	2	3	6722	7436	0.842534205829863
GO:0046653	tetrahydrofolate metabolic process	  6	0.865182793759413	1	2	4	6722	7435	0.702111838191553
GO:0046655	folic acid metabolic process	 11	0.220387996626296	1	7	4	6717	7435	1.3403953274566
GO:0046658	anchored component of plasma membrane	 26	0.997238836294189	1	6	20	6718	7419	0.486077426440306
GO:0046676	negative regulation of insulin secretion	 24	0.10185657048721	0.868413773784606	15	9	6709	7430	1.31645969660916
GO:0046677	response to antibiotic	 29	0.538368194874272	1	14	15	6710	7424	1.0168516277257
GO:0046685	response to arsenic-containing substance	 11	0.850917330440019	1	4	7	6720	7432	0.765940187118057
GO:0046686	response to cadmium ion	 23	0.722173726826204	1	10	13	6714	7426	0.915798049815069
GO:0046688	response to copper ion	 10	0.559603563591584	1	5	5	6719	7434	1.05316775728733
GO:0046689	response to mercury ion	  5	0.960049771736903	1	1	4	6723	7435	0.421267102914932
GO:0046696	lipopolysaccharide receptor complex	  6	0.607836179256654	1	3	3	6721	7436	1.05316775728733
GO:0046697	decidualization	 21	0.993100479805263	1	5	16	6719	7423	0.501508455851109
GO:0046703	natural killer cell lectin-like receptor binding	  5	1	1	0	5	6724	7434	0
GO:0046710	GDP metabolic process	 13	0.426320358160906	1	7	6	6717	7433	1.13418066169405
GO:0046716	muscle cell cellular homeostasis	 17	0.607264962167558	1	8	9	6716	7430	0.991216712741015
GO:0046718	viral entry into host cell	 72	0.911072765124869	1	29	43	6695	7396	0.848385137814793
GO:0046755	viral budding	  6	0.0874151689581943	0.807895728316903	5	1	6719	7438	1.75527959547888
GO:0046784	viral mRNA export from host cell nucleus	  6	0.607836179256654	1	3	3	6721	7436	1.05316775728733
GO:0046785	microtubule polymerization	  8	0.113810689204897	0.88413902838582	6	2	6718	7437	1.57975163593099
GO:0046790	virion binding	  8	0.819878207576373	1	3	5	6721	7434	0.789875817965497
GO:0046822	regulation of nucleocytoplasmic transport	  5	0.77940058892516	1	2	3	6722	7436	0.842534205829863
GO:0046825	regulation of protein export from nucleus	  5	0.0241003244622537	0.495149842313607	5	0	6719	7439	2.10633551457466
GO:0046826	negative regulation of protein export from nucleus	  7	0.187210848839696	0.949543953868825	5	2	6719	7437	1.50452536755333
GO:0046827	positive regulation of protein export from nucleus	 18	0.00881923479062879	0.410349233027118	14	4	6710	7435	1.63826095578029
GO:0046834	lipid phosphorylation	 11	0.0838548499097086	0.807895728316903	8	3	6716	7436	1.53188037423611
GO:0046835	carbohydrate phosphorylation	 23	0.843995637843635	1	9	14	6715	7425	0.824218244833562
GO:0046839	phospholipid dephosphorylation	 10	0.78367246101976	1	4	6	6720	7433	0.842534205829863
GO:0046847	filopodium assembly	 15	0.623867966210499	1	7	8	6717	7431	0.982956573468174
GO:0046849	bone remodeling	 11	0.990836032904502	1	2	9	6722	7430	0.382970093559029
GO:0046850	regulation of bone remodeling	  6	0.865182793759413	1	2	4	6722	7435	0.702111838191553
GO:0046854	phosphatidylinositol phosphorylation	 80	0.954129451028286	1	31	49	6693	7390	0.81620501189768
GO:0046855	inositol phosphate dephosphorylation	  9	0.206720270758876	0.983668097955673	6	3	6718	7436	1.40422367638311
GO:0046856	phosphatidylinositol dephosphorylation	 20	0.0117131731557092	0.427208830906354	15	5	6709	7434	1.57975163593099
GO:0046870	cadmium ion binding	  5	0.77940058892516	1	2	3	6722	7436	0.842534205829863
GO:0046873	metal ion transmembrane transporter activity	 13	0.426320358160906	1	7	6	6717	7433	1.13418066169405
GO:0046875	ephrin receptor binding	 29	0.680253022221135	1	13	16	6711	7423	0.944219368602433
GO:0046881	positive regulation of follicle-stimulating hormone secretion	  5	0.77940058892516	1	2	3	6722	7436	0.842534205829863
GO:0046883	regulation of hormone secretion	  5	0.960049771736903	1	1	4	6723	7435	0.421267102914932
GO:0046887	positive regulation of hormone secretion	 11	0.990836032904502	1	2	9	6722	7430	0.382970093559029
GO:0046888	negative regulation of hormone secretion	  9	0.972243904416257	1	2	7	6722	7432	0.468074558794368
GO:0046889	positive regulation of lipid biosynthetic process	 11	0.850917330440019	1	4	7	6720	7432	0.765940187118057
GO:0046902	regulation of mitochondrial membrane permeability	 12	0.320810094151237	1	7	5	6717	7434	1.22869571683522
GO:0046903	secretion	  8	0.309544448231027	1	5	3	6719	7436	1.31645969660916
GO:0046907	intracellular transport	 24	0.10185657048721	0.868413773784606	15	9	6709	7430	1.31645969660916
GO:0046914	transition metal ion binding	 13	0.643122793005253	1	6	7	6718	7432	0.972154852880611
GO:0046920	alpha-(1-	  6	0.865182793759413	1	2	4	6722	7435	0.702111838191553
GO:0046923	ER retention sequence binding	  5	0.452745275304033	1	3	2	6721	7437	1.26380130874479
GO:0046928	regulation of neurotransmitter secretion	 14	0.529251719099727	1	7	7	6717	7432	1.05316775728733
GO:0046929	negative regulation of neurotransmitter secretion	  6	0.0114373555630656	0.427208830906354	6	0	6718	7439	2.10633551457466
GO:0046930	pore complex	  7	0.444912401367032	1	4	3	6720	7436	1.20362029404266
GO:0046931	pore complex assembly	  6	0.607836179256654	1	3	3	6721	7436	1.05316775728733
GO:0046933	proton-transporting ATP synthase activity, rotational mechanism	 12	0.012434352666713	0.427208830906354	10	2	6714	7437	1.75527959547888
GO:0046934	phosphatidylinositol-4,5-bisphosphate 3-kinase activity	 51	0.98571213437226	1	17	34	6707	7405	0.702111838191553
GO:0046935	1-phosphatidylinositol-3-kinase regulator activity	  5	0.77940058892516	1	2	3	6722	7436	0.842534205829863
GO:0046939	nucleotide phosphorylation	  7	0.444912401367032	1	4	3	6720	7436	1.20362029404266
GO:0046949	fatty-acyl-CoA biosynthetic process	 10	0.133503266897558	0.919686434773344	7	3	6717	7436	1.47443486020226
GO:0046951	ketone body biosynthetic process	  8	0.309544448231027	1	5	3	6719	7436	1.31645969660916
GO:0046959	habituation	  5	0.77940058892516	1	2	3	6722	7436	0.842534205829863
GO:0046961	proton-transporting ATPase activity, rotational mechanism	 18	0.00196064838978763	0.222937212333575	15	3	6709	7436	1.75527959547888
GO:0046965	retinoid X receptor binding	 16	0.853260719975205	1	6	10	6718	7429	0.789875817965497
GO:0046966	thyroid hormone receptor binding	 28	0.201547233869993	0.983668097955673	16	12	6708	7427	1.20362029404266
GO:0046972	histone acetyltransferase activity (H4-K16 specific)	  8	0.025392299605826	0.495149842313607	7	1	6717	7438	1.84304357525283
GO:0046974	histone methyltransferase activity (H3-K9 specific)	  5	0.77940058892516	1	2	3	6722	7436	0.842534205829863
GO:0046975	histone methyltransferase activity (H3-K36 specific)	  5	0.157494903089267	0.919686434773344	4	1	6720	7438	1.68506841165973
GO:0047035	testosterone dehydrogenase (NAD+) activity	  5	0.960049771736903	1	1	4	6723	7435	0.421267102914932
GO:0047134	protein-disulfide reductase activity	  6	0.607836179256654	1	3	3	6721	7436	1.05316775728733
GO:0047144	2-acylglycerol-3-phosphate O-acyltransferase activity	  8	0.113810689204897	0.88413902838582	6	2	6718	7437	1.57975163593099
GO:0047184	1-acylglycerophosphocholine O-acyltransferase activity	  5	0.452745275304033	1	3	2	6721	7437	1.26380130874479
GO:0047238	glucuronosyl-N-acetylgalactosaminyl-proteoglycan 4-beta-N-acetylgalactosaminyltransferase activity	  5	0.77940058892516	1	2	3	6722	7436	0.842534205829863
GO:0047372	acylglycerol lipase activity	  8	0.309544448231027	1	5	3	6719	7436	1.31645969660916
GO:0047429	nucleoside-triphosphate diphosphatase activity	  6	0.0874151689581943	0.807895728316903	5	1	6719	7438	1.75527959547888
GO:0047485	protein N-terminus binding	 96	0.0779032849363625	0.807895728316903	53	43	6671	7396	1.16287273200476
GO:0047496	vesicle transport along microtubule	 11	0.431935112460319	1	6	5	6718	7434	1.14891028067709
GO:0047497	mitochondrion transport along microtubule	  8	0.309544448231027	1	5	3	6719	7436	1.31645969660916
GO:0047498	calcium-dependent phospholipase A2 activity	  6	0.979023167332401	1	1	5	6723	7434	0.351055919095776
GO:0047499	calcium-independent phospholipase A2 activity	  6	0.607836179256654	1	3	3	6721	7436	1.05316775728733
GO:0047555	3	 12	0.899474094191123	1	4	8	6720	7431	0.702111838191553
GO:0047617	acyl-CoA hydrolase activity	  8	0.025392299605826	0.495149842313607	7	1	6717	7438	1.84304357525283
GO:0048007	antigen processing and presentation, exogenous lipid antigen via MHC class Ib	  5	0.960049771736903	1	1	4	6723	7435	0.421267102914932
GO:0048008	platelet-derived growth factor receptor signaling pathway	 29	0.800246571563356	1	12	17	6712	7422	0.871587109479169
GO:0048009	insulin-like growth factor receptor signaling pathway	 14	0.0625726545054608	0.771729405567349	10	4	6714	7435	1.50452536755333
GO:0048010	vascular endothelial growth factor receptor signaling pathway	 66	0.674014944396179	1	30	36	6694	7403	0.957425233897572
GO:0048011	neurotrophin TRK receptor signaling pathway	 15	0.623867966210499	1	7	8	6717	7431	0.982956573468174
GO:0048012	hepatocyte growth factor receptor signaling pathway	  8	0.580280354503036	1	4	4	6720	7435	1.05316775728733
GO:0048013	ephrin receptor signaling pathway	 81	0.00679544372057626	0.354502993326374	50	31	6674	7408	1.30020710776213
GO:0048015	phosphatidylinositol-mediated signaling	 93	0.709205871817201	1	42	51	6682	7388	0.951248296904684
GO:0048016	inositol phosphate-mediated signaling	  9	0.882794860340315	1	3	6	6721	7433	0.702111838191553
GO:0048018	receptor ligand activity	 15	0.972187308828691	1	4	11	6720	7428	0.561689470553242
GO:0048020	CCR chemokine receptor binding	  9	0.996964464269463	1	1	8	6723	7431	0.234037279397184
GO:0048024	regulation of mRNA splicing, via spliceosome	 12	0.012434352666713	0.427208830906354	10	2	6714	7437	1.75527959547888
GO:0048025	negative regulation of mRNA splicing, via spliceosome	 20	0.0357139492882998	0.606296809682549	14	6	6710	7433	1.47443486020226
GO:0048026	positive regulation of mRNA splicing, via spliceosome	 16	0.517377397284026	1	8	8	6716	7431	1.05316775728733
GO:0048027	mRNA 5	 12	0.148657926965624	0.919686434773344	8	4	6716	7435	1.40422367638311
GO:0048029	monosaccharide binding	  7	0.444912401367032	1	4	3	6720	7436	1.20362029404266
GO:0048037	cofactor binding	 17	0.607264962167558	1	8	9	6716	7430	0.991216712741015
GO:0048038	quinone binding	  9	0.69404490204849	1	4	5	6720	7434	0.936149117588737
GO:0048039	ubiquinone binding	  5	0.452745275304033	1	3	2	6721	7437	1.26380130874479
GO:0048041	focal adhesion assembly	 22	0.189941610858229	0.956669265160296	13	9	6711	7430	1.24465280406684
GO:0048048	embryonic eye morphogenesis	  7	0.98898631085553	1	1	6	6723	7433	0.300905073510665
GO:0048066	developmental pigmentation	 12	0.0514533113817507	0.679607581911819	9	3	6715	7436	1.57975163593099
GO:0048070	regulation of developmental pigmentation	  6	0.607836179256654	1	3	3	6721	7436	1.05316775728733
GO:0048096	chromatin-mediated maintenance of transcription	  8	0.309544448231027	1	5	3	6719	7436	1.31645969660916
GO:0048102	autophagic cell death	  6	0.607836179256654	1	3	3	6721	7436	1.05316775728733
GO:0048103	somatic stem cell division	  8	0.952366339066048	1	2	6	6722	7433	0.526583878643665
GO:0048143	astrocyte activation	  5	0.157494903089267	0.919686434773344	4	1	6720	7438	1.68506841165973
GO:0048146	positive regulation of fibroblast proliferation	 40	0.923587950498548	1	15	25	6709	7414	0.789875817965497
GO:0048147	negative regulation of fibroblast proliferation	 26	0.973206597001812	1	8	18	6716	7421	0.648103235253741
GO:0048148	behavioral response to cocaine	 13	0.822979434145659	1	5	8	6719	7431	0.810129044067176
GO:0048149	behavioral response to ethanol	  7	0.444912401367032	1	4	3	6720	7436	1.20362029404266
GO:0048156	tau protein binding	 10	0.316545776550851	1	6	4	6718	7435	1.26380130874479
GO:0048167	regulation of synaptic plasticity	 33	0.260933554151229	1	18	15	6706	7424	1.14891028067709
GO:0048168	regulation of neuronal synaptic plasticity	 17	0.0471138152487804	0.646585116783694	12	5	6712	7434	1.48682506911152
GO:0048169	regulation of long-term neuronal synaptic plasticity	 19	0.0543219716836929	0.703764658430297	13	6	6711	7433	1.44117693102477
GO:0048170	positive regulation of long-term neuronal synaptic plasticity	  5	0.77940058892516	1	2	3	6722	7436	0.842534205829863
GO:0048172	regulation of short-term neuronal synaptic plasticity	 14	0.0183006792268162	0.495149842313607	11	3	6713	7436	1.65497790430866
GO:0048185	activin binding	 11	0.665993939534306	1	5	6	6719	7433	0.957425233897572
GO:0048188	Set1C/COMPASS complex	 11	0.0838548499097086	0.807895728316903	8	3	6716	7436	1.53188037423611
GO:0048193	Golgi vesicle transport	 13	0.933471720877997	1	4	9	6720	7430	0.648103235253741
GO:0048208	COPII vesicle coating	 57	0.012317207846393	0.427208830906354	36	21	6688	7418	1.33031716709978
GO:0048227	plasma membrane to endosome transport	  7	0.187210848839696	0.949543953868825	5	2	6719	7437	1.50452536755333
GO:0048240	sperm capacitation	 12	0.5430601307694	1	6	6	6718	7433	1.05316775728733
GO:0048245	eosinophil chemotaxis	  6	0.979023167332401	1	1	5	6723	7434	0.351055919095776
GO:0048246	macrophage chemotaxis	  8	0.819878207576373	1	3	5	6721	7434	0.789875817965497
GO:0048247	lymphocyte chemotaxis	 13	0.999769586887007	1	1	12	6723	7427	0.162025808813435
GO:0048251	elastic fiber assembly	  6	0.607836179256654	1	3	3	6721	7436	1.05316775728733
GO:0048255	mRNA stabilization	 15	0.914031171019375	1	5	10	6719	7429	0.702111838191553
GO:0048260	positive regulation of receptor-mediated endocytosis	 17	0.416253886790052	1	9	8	6715	7431	1.11511880183364
GO:0048263	determination of dorsal identity	  5	0.77940058892516	1	2	3	6722	7436	0.842534205829863
GO:0048265	response to pain	 16	0.853260719975205	1	6	10	6718	7429	0.789875817965497
GO:0048266	behavioral response to pain	 11	0.953160347938253	1	3	8	6721	7431	0.574455140338543
GO:0048268	clathrin coat assembly	 17	6.21196383888486e-05	0.0448193190975543	16	1	6708	7438	1.98243342548203
GO:0048273	mitogen-activated protein kinase p38 binding	  6	0.297654371351411	1	4	2	6720	7437	1.40422367638311
GO:0048278	vesicle docking	 18	0.0811513291101853	0.807895728316903	12	6	6712	7433	1.40422367638311
GO:0048280	vesicle fusion with Golgi apparatus	  9	0.206720270758876	0.983668097955673	6	3	6718	7436	1.40422367638311
GO:0048286	lung alveolus development	 24	0.324965824259735	1	13	11	6711	7428	1.14093173706127
GO:0048304	positive regulation of isotype switching to IgG isotypes	  6	0.865182793759413	1	2	4	6722	7435	0.702111838191553
GO:0048306	calcium-dependent protein binding	 54	0.620920803681269	1	25	29	6699	7410	0.975155330821601
GO:0048312	intracellular distribution of mitochondria	  6	0.0874151689581943	0.807895728316903	5	1	6719	7438	1.75527959547888
GO:0048333	mesodermal cell differentiation	  9	0.69404490204849	1	4	5	6720	7434	0.936149117588737
GO:0048339	paraxial mesoderm development	  8	0.113810689204897	0.88413902838582	6	2	6718	7437	1.57975163593099
GO:0048341	paraxial mesoderm formation	  7	0.919244306193629	1	2	5	6722	7434	0.601810147021331
GO:0048365	Rac GTPase binding	 48	0.8932692922517	1	19	29	6705	7410	0.833757807852469
GO:0048384	retinoic acid receptor signaling pathway	 15	0.914031171019375	1	5	10	6719	7429	0.702111838191553
GO:0048387	negative regulation of retinoic acid receptor signaling pathway	  7	0.444912401367032	1	4	3	6720	7436	1.20362029404266
GO:0048406	nerve growth factor binding	  5	0.960049771736903	1	1	4	6723	7435	0.421267102914932
GO:0048407	platelet-derived growth factor binding	  9	0.996964464269463	1	1	8	6723	7431	0.234037279397184
GO:0048468	cell development	 40	0.99208079342912	1	12	28	6712	7411	0.631900654372397
GO:0048469	cell maturation	 28	0.998890460682561	1	6	22	6718	7417	0.451357610265998
GO:0048476	Holliday junction resolvase complex	  5	0.452745275304033	1	3	2	6721	7437	1.26380130874479
GO:0048477	oogenesis	 21	0.993100479805263	1	5	16	6719	7423	0.501508455851109
GO:0048478	replication fork protection	  5	0.960049771736903	1	1	4	6723	7435	0.421267102914932
GO:0048484	enteric nervous system development	 10	0.78367246101976	1	4	6	6720	7433	0.842534205829863
GO:0048485	sympathetic nervous system development	 13	0.999769586887007	1	1	12	6723	7427	0.162025808813435
GO:0048487	beta-tubulin binding	 34	0.0668797555442451	0.780679208284898	21	13	6703	7426	1.30097193547258
GO:0048488	synaptic vesicle endocytosis	 22	0.189941610858229	0.956669265160296	13	9	6711	7430	1.24465280406684
GO:0048489	synaptic vesicle transport	 10	0.316545776550851	1	6	4	6718	7435	1.26380130874479
GO:0048490	anterograde synaptic vesicle transport	 14	0.323388997222084	1	8	6	6716	7433	1.20362029404266
GO:0048495	Roundabout binding	  5	0.157494903089267	0.919686434773344	4	1	6720	7438	1.68506841165973
GO:0048500	signal recognition particle	  8	0.309544448231027	1	5	3	6719	7436	1.31645969660916
GO:0048505	regulation of timing of cell differentiation	  5	0.77940058892516	1	2	3	6722	7436	0.842534205829863
GO:0048512	circadian behavior	  7	0.98898631085553	1	1	6	6723	7433	0.300905073510665
GO:0048513	animal organ development	 12	0.5430601307694	1	6	6	6718	7433	1.05316775728733
GO:0048514	blood vessel morphogenesis	 25	0.828635555615045	1	10	15	6714	7424	0.842534205829863
GO:0048515	spermatid differentiation	  6	1	1	0	6	6724	7433	0
GO:0048524	positive regulation of viral process	  7	1	1	0	7	6724	7432	0
GO:0048535	lymph node development	 14	0.956679005412873	1	4	10	6720	7429	0.601810147021331
GO:0048536	spleen development	 28	0.201547233869993	0.983668097955673	16	12	6708	7427	1.20362029404266
GO:0048538	thymus development	 36	0.127348553929636	0.919686434773344	21	15	6703	7424	1.22869571683522
GO:0048545	response to steroid hormone	 30	0.998255623767406	1	7	23	6717	7416	0.491478286734087
GO:0048546	digestive tract morphogenesis	 15	0.972187308828691	1	4	11	6720	7428	0.561689470553242
GO:0048557	embryonic digestive tract morphogenesis	 14	0.98932697223781	1	3	11	6721	7428	0.451357610265998
GO:0048565	digestive tract development	 28	0.995871123915027	1	7	21	6717	7418	0.526583878643665
GO:0048566	embryonic digestive tract development	 17	0.997764322622395	1	3	14	6721	7425	0.371706267277881
GO:0048568	embryonic organ development	 34	0.712778465907433	1	15	19	6709	7420	0.929265668194702
GO:0048570	notochord morphogenesis	  5	1	1	0	5	6724	7434	0
GO:0048589	developmental growth	 25	0.557266861497771	1	12	13	6712	7426	1.01104104699584
GO:0048593	camera-type eye morphogenesis	 21	0.993100479805263	1	5	16	6719	7423	0.501508455851109
GO:0048596	embryonic camera-type eye morphogenesis	 12	0.320810094151237	1	7	5	6717	7434	1.22869571683522
GO:0048598	embryonic morphogenesis	 13	0.822979434145659	1	5	8	6719	7431	0.810129044067176
GO:0048599	oocyte development	  9	0.438074670071218	1	5	4	6719	7435	1.17018639698592
GO:0048608	reproductive structure development	  7	0.730029012673872	1	3	4	6721	7435	0.902715220531996
GO:0048617	embryonic foregut morphogenesis	  8	0.580280354503036	1	4	4	6720	7435	1.05316775728733
GO:0048642	negative regulation of skeletal muscle tissue development	  5	0.77940058892516	1	2	3	6722	7436	0.842534205829863
GO:0048643	positive regulation of skeletal muscle tissue development	  7	0.187210848839696	0.949543953868825	5	2	6719	7437	1.50452536755333
GO:0048644	muscle organ morphogenesis	  8	0.952366339066048	1	2	6	6722	7433	0.526583878643665
GO:0048646	anatomical structure formation involved in morphogenesis	 16	0.996207313649143	1	3	13	6721	7426	0.394937908982748
GO:0048660	regulation of smooth muscle cell proliferation	 10	0.559603563591584	1	5	5	6719	7434	1.05316775728733
GO:0048661	positive regulation of smooth muscle cell proliferation	 57	0.96026591584122	1	21	36	6703	7403	0.776018347474874
GO:0048662	negative regulation of smooth muscle cell proliferation	 24	0.993335783917261	1	6	18	6718	7421	0.526583878643665
GO:0048663	neuron fate commitment	 26	0.935947878741725	1	9	17	6715	7422	0.729116139660459
GO:0048664	neuron fate determination	  5	0.960049771736903	1	1	4	6723	7435	0.421267102914932
GO:0048665	neuron fate specification	 11	0.850917330440019	1	4	7	6720	7432	0.765940187118057
GO:0048666	neuron development	 54	0.513974193040956	1	26	28	6698	7411	1.01416154405446
GO:0048667	cell morphogenesis involved in neuron differentiation	  6	0.865182793759413	1	2	4	6722	7435	0.702111838191553
GO:0048668	collateral sprouting	  6	0.607836179256654	1	3	3	6721	7436	1.05316775728733
GO:0048671	negative regulation of collateral sprouting	  7	0.187210848839696	0.949543953868825	5	2	6719	7437	1.50452536755333
GO:0048672	positive regulation of collateral sprouting	  7	0.919244306193629	1	2	5	6722	7434	0.601810147021331
GO:0048675	axon extension	 19	0.0543219716836929	0.703764658430297	13	6	6711	7433	1.44117693102477
GO:0048678	response to axon injury	 26	0.935947878741725	1	9	17	6715	7422	0.729116139660459
GO:0048679	regulation of axon regeneration	  7	0.187210848839696	0.949543953868825	5	2	6719	7437	1.50452536755333
GO:0048681	negative regulation of axon regeneration	  9	0.69404490204849	1	4	5	6720	7434	0.936149117588737
GO:0048699	generation of neurons	 12	0.899474094191123	1	4	8	6720	7431	0.702111838191553
GO:0048701	embryonic cranial skeleton morphogenesis	 27	0.953648207795608	1	9	18	6715	7421	0.702111838191553
GO:0048702	embryonic neurocranium morphogenesis	  5	0.452745275304033	1	3	2	6721	7437	1.26380130874479
GO:0048703	embryonic viscerocranium morphogenesis	  9	0.69404490204849	1	4	5	6720	7434	0.936149117588737
GO:0048704	embryonic skeletal system morphogenesis	 38	0.999303638945244	1	9	29	6715	7410	0.498868937662419
GO:0048705	skeletal system morphogenesis	 34	0.124123412353081	0.919686434773344	20	14	6704	7425	1.23902089092627
GO:0048706	embryonic skeletal system development	 27	0.900547220633958	1	10	17	6714	7422	0.780124264657281
GO:0048708	astrocyte differentiation	  8	0.819878207576373	1	3	5	6721	7434	0.789875817965497
GO:0048709	oligodendrocyte differentiation	 28	0.750594068387264	1	12	16	6712	7423	0.902715220531996
GO:0048711	positive regulation of astrocyte differentiation	  9	0.69404490204849	1	4	5	6720	7434	0.936149117588737
GO:0048712	negative regulation of astrocyte differentiation	 12	0.320810094151237	1	7	5	6717	7434	1.22869571683522
GO:0048714	positive regulation of oligodendrocyte differentiation	 16	0.982365044000861	1	4	12	6720	7427	0.526583878643665
GO:0048715	negative regulation of oligodendrocyte differentiation	  8	0.819878207576373	1	3	5	6721	7434	0.789875817965497
GO:0048729	tissue morphogenesis	  7	0.919244306193629	1	2	5	6722	7434	0.601810147021331
GO:0048730	epidermis morphogenesis	  6	0.865182793759413	1	2	4	6722	7435	0.702111838191553
GO:0048733	sebaceous gland development	  6	0.297654371351411	1	4	2	6720	7437	1.40422367638311
GO:0048738	cardiac muscle tissue development	 15	0.623867966210499	1	7	8	6717	7431	0.982956573468174
GO:0048739	cardiac muscle fiber development	  6	0.607836179256654	1	3	3	6721	7436	1.05316775728733
GO:0048741	skeletal muscle fiber development	 19	0.995773796287996	1	4	15	6720	7424	0.443439055699928
GO:0048743	positive regulation of skeletal muscle fiber development	  6	0.979023167332401	1	1	5	6723	7434	0.351055919095776
GO:0048745	smooth muscle tissue development	 13	0.643122793005253	1	6	7	6718	7432	0.972154852880611
GO:0048747	muscle fiber development	 12	0.148657926965624	0.919686434773344	8	4	6716	7435	1.40422367638311
GO:0048752	semicircular canal morphogenesis	  5	0.77940058892516	1	2	3	6722	7436	0.842534205829863
GO:0048754	branching morphogenesis of an epithelial tube	 24	0.979115970268494	1	7	17	6717	7422	0.614347858417609
GO:0048762	mesenchymal cell differentiation	  7	0.444912401367032	1	4	3	6720	7436	1.20362029404266
GO:0048771	tissue remodeling	  8	0.952366339066048	1	2	6	6722	7433	0.526583878643665
GO:0048786	presynaptic active zone	 28	0.00285126500989527	0.244538441062453	21	7	6703	7432	1.57975163593099
GO:0048791	calcium ion-regulated exocytosis of neurotransmitter	 25	0.031210609259391	0.552600112408603	17	8	6707	7431	1.43230814991077
GO:0048793	pronephros development	  6	0.979023167332401	1	1	5	6723	7434	0.351055919095776
GO:0048806	genitalia development	  8	0.952366339066048	1	2	6	6722	7433	0.526583878643665
GO:0048812	neuron projection morphogenesis	 53	0.259455447035684	1	28	25	6696	7414	1.11278102656774
GO:0048813	dendrite morphogenesis	 34	0.0668797555442451	0.780679208284898	21	13	6703	7426	1.30097193547258
GO:0048814	regulation of dendrite morphogenesis	 17	0.776294265732228	1	7	10	6717	7429	0.867314623648389
GO:0048820	hair follicle maturation	  7	0.187210848839696	0.949543953868825	5	2	6719	7437	1.50452536755333
GO:0048821	erythrocyte development	 13	0.230372725000093	1	8	5	6716	7434	1.29620647050748
GO:0048839	inner ear development	 44	0.99813252872969	1	12	32	6712	7407	0.574455140338543
GO:0048841	regulation of axon extension involved in axon guidance	  5	0.77940058892516	1	2	3	6722	7436	0.842534205829863
GO:0048842	positive regulation of axon extension involved in axon guidance	  7	0.187210848839696	0.949543953868825	5	2	6719	7437	1.50452536755333
GO:0048843	negative regulation of axon extension involved in axon guidance	  7	0.444912401367032	1	4	3	6720	7436	1.20362029404266
GO:0048844	artery morphogenesis	 20	0.997419657119239	1	4	16	6720	7423	0.421267102914932
GO:0048845	venous blood vessel morphogenesis	  7	0.444912401367032	1	4	3	6720	7436	1.20362029404266
GO:0048846	axon extension involved in axon guidance	  7	0.444912401367032	1	4	3	6720	7436	1.20362029404266
GO:0048853	forebrain morphogenesis	  9	0.69404490204849	1	4	5	6720	7434	0.936149117588737
GO:0048854	brain morphogenesis	 19	0.411669949440149	1	10	9	6714	7430	1.10859763924982
GO:0048856	anatomical structure development	 16	0.982365044000861	1	4	12	6720	7427	0.526583878643665
GO:0048863	stem cell differentiation	 23	0.567952371389245	1	11	12	6713	7427	1.00737785479658
GO:0048870	cell motility	 21	0.023100093034779	0.495149842313607	15	6	6709	7433	1.50452536755333
GO:0048872	homeostasis of number of cells	 19	0.756503853067433	1	8	11	6716	7428	0.886878111399856
GO:0048873	homeostasis of number of cells within a tissue	 24	0.194475510371151	0.972714597800941	14	10	6710	7429	1.22869571683522
GO:0048935	peripheral nervous system neuron development	  8	0.952366339066048	1	2	6	6722	7433	0.526583878643665
GO:0050072	m7G(5	  7	0.187210848839696	0.949543953868825	5	2	6719	7437	1.50452536755333
GO:0050145	nucleoside phosphate kinase activity	  5	0.452745275304033	1	3	2	6721	7437	1.26380130874479
GO:0050291	sphingosine N-acyltransferase activity	  7	0.919244306193629	1	2	5	6722	7434	0.601810147021331
GO:0050321	tau-protein kinase activity	 12	0.148657926965624	0.919686434773344	8	4	6716	7435	1.40422367638311
GO:0050427	3	 13	0.822979434145659	1	5	8	6719	7431	0.810129044067176
GO:0050428	3	  5	0.452745275304033	1	3	2	6721	7437	1.26380130874479
GO:0050431	transforming growth factor beta binding	 14	0.98932697223781	1	3	11	6721	7428	0.451357610265998
GO:0050434	positive regulation of viral transcription	 24	0.10185657048721	0.868413773784606	15	9	6709	7430	1.31645969660916
GO:0050435	amyloid-beta metabolic process	 10	0.316545776550851	1	6	4	6718	7435	1.26380130874479
GO:0050482	arachidonic acid secretion	 17	0.999982528329648	1	1	16	6723	7423	0.123902089092627
GO:0050544	arachidonic acid binding	  5	0.960049771736903	1	1	4	6723	7435	0.421267102914932
GO:0050650	chondroitin sulfate proteoglycan biosynthetic process	  8	0.580280354503036	1	4	4	6720	7435	1.05316775728733
GO:0050656	3	  6	0.865182793759413	1	2	4	6722	7435	0.702111838191553
GO:0050658	RNA transport	  6	0.0874151689581943	0.807895728316903	5	1	6719	7438	1.75527959547888
GO:0050660	flavin adenine dinucleotide binding	 55	0.0724622858658453	0.807895728316903	32	23	6692	7416	1.22550429938889
GO:0050661	NADP binding	 30	0.461375405343472	1	15	15	6709	7424	1.05316775728733
GO:0050662	coenzyme binding	 11	0.0838548499097086	0.807895728316903	8	3	6716	7436	1.53188037423611
GO:0050663	cytokine secretion	  7	0.919244306193629	1	2	5	6722	7434	0.601810147021331
GO:0050665	hydrogen peroxide biosynthetic process	  7	0.98898631085553	1	1	6	6723	7433	0.300905073510665
GO:0050671	positive regulation of lymphocyte proliferation	  5	0.452745275304033	1	3	2	6721	7437	1.26380130874479
GO:0050672	negative regulation of lymphocyte proliferation	  5	1	1	0	5	6724	7434	0
GO:0050673	epithelial cell proliferation	 10	0.78367246101976	1	4	6	6720	7433	0.842534205829863
GO:0050678	regulation of epithelial cell proliferation	  9	0.882794860340315	1	3	6	6721	7433	0.702111838191553
GO:0050679	positive regulation of epithelial cell proliferation	 57	0.997836204646476	1	17	40	6707	7399	0.628205328908231
GO:0050680	negative regulation of epithelial cell proliferation	 54	0.620920803681269	1	25	29	6699	7410	0.975155330821601
GO:0050681	androgen receptor binding	 40	0.31562742638263	1	21	19	6703	7420	1.1058261451517
GO:0050684	regulation of mRNA processing	  9	0.206720270758876	0.983668097955673	6	3	6718	7436	1.40422367638311
GO:0050687	negative regulation of defense response to virus	  7	0.444912401367032	1	4	3	6720	7436	1.20362029404266
GO:0050688	regulation of defense response to virus	  6	0.607836179256654	1	3	3	6721	7436	1.05316775728733
GO:0050690	regulation of defense response to virus by virus	 24	0.194475510371151	0.972714597800941	14	10	6710	7429	1.22869571683522
GO:0050693	LBD domain binding	  6	0.0874151689581943	0.807895728316903	5	1	6719	7438	1.75527959547888
GO:0050699	WW domain binding	 22	0.189941610858229	0.956669265160296	13	9	6711	7430	1.24465280406684
GO:0050700	CARD domain binding	 12	0.999560983443925	1	1	11	6723	7428	0.175527959547888
GO:0050702	interleukin-1 beta secretion	  8	0.580280354503036	1	4	4	6720	7435	1.05316775728733
GO:0050707	regulation of cytokine secretion	 10	0.559603563591584	1	5	5	6719	7434	1.05316775728733
GO:0050708	regulation of protein secretion	 15	0.421118865258844	1	8	7	6716	7432	1.12337894110648
GO:0050709	negative regulation of protein secretion	 12	0.971055765853963	1	3	9	6721	7430	0.526583878643665
GO:0050710	negative regulation of cytokine secretion	 10	0.998406526036605	1	1	9	6723	7430	0.210633551457466
GO:0050713	negative regulation of interleukin-1 beta secretion	  6	0.979023167332401	1	1	5	6723	7434	0.351055919095776
GO:0050714	positive regulation of protein secretion	 30	0.322199322975026	1	16	14	6708	7425	1.12337894110648
GO:0050715	positive regulation of cytokine secretion	 20	0.911428444807446	1	7	13	6717	7426	0.73721743010113
GO:0050718	positive regulation of interleukin-1 beta secretion	 21	0.86019883501541	1	8	13	6716	7426	0.802413529361774
GO:0050727	regulation of inflammatory response	 53	0.983487534802406	1	18	35	6706	7404	0.715359231364978
GO:0050728	negative regulation of inflammatory response	 63	0.99831125669636	1	19	44	6705	7395	0.635244044078071
GO:0050729	positive regulation of inflammatory response	 45	0.99144093812355	1	14	31	6710	7408	0.655304382312116
GO:0050730	regulation of peptidyl-tyrosine phosphorylation	 14	0.529251719099727	1	7	7	6717	7432	1.05316775728733
GO:0050731	positive regulation of peptidyl-tyrosine phosphorylation	 76	0.960304507781117	1	29	47	6695	7392	0.803733288456119
GO:0050732	negative regulation of peptidyl-tyrosine phosphorylation	 11	0.850917330440019	1	4	7	6720	7432	0.765940187118057
GO:0050733	RS domain binding	  5	0.0241003244622537	0.495149842313607	5	0	6719	7439	2.10633551457466
GO:0050750	low-density lipoprotein particle receptor binding	 18	0.0811513291101853	0.807895728316903	12	6	6712	7433	1.40422367638311
GO:0050764	regulation of phagocytosis	  7	0.98898631085553	1	1	6	6723	7433	0.300905073510665
GO:0050765	negative regulation of phagocytosis	 12	0.5430601307694	1	6	6	6718	7433	1.05316775728733
GO:0050766	positive regulation of phagocytosis	 25	0.985872368040077	1	7	18	6717	7421	0.589773944080904
GO:0050767	regulation of neurogenesis	 23	0.40318807961294	1	12	11	6712	7428	1.09895765977808
GO:0050768	negative regulation of neurogenesis	 17	0.607264962167558	1	8	9	6716	7430	0.991216712741015
GO:0050769	positive regulation of neurogenesis	 21	0.134279084429805	0.919686434773344	13	8	6711	7431	1.30392198521288
GO:0050770	regulation of axonogenesis	 22	0.189941610858229	0.956669265160296	13	9	6711	7430	1.24465280406684
GO:0050771	negative regulation of axonogenesis	 20	0.0888797275608513	0.807895728316903	13	7	6711	7432	1.36911808447353
GO:0050772	positive regulation of axonogenesis	 25	0.14581109956432	0.919686434773344	15	10	6709	7429	1.26380130874479
GO:0050773	regulation of dendrite development	 11	0.850917330440019	1	4	7	6720	7432	0.765940187118057
GO:0050774	negative regulation of dendrite morphogenesis	  6	0.297654371351411	1	4	2	6720	7437	1.40422367638311
GO:0050775	positive regulation of dendrite morphogenesis	 18	0.506938913103874	1	9	9	6715	7430	1.05316775728733
GO:0050777	negative regulation of immune response	 14	0.956679005412873	1	4	10	6720	7429	0.601810147021331
GO:0050778	positive regulation of immune response	  6	1	1	0	6	6724	7433	0
GO:0050786	RAGE receptor binding	  9	0.972243904416257	1	2	7	6722	7432	0.468074558794368
GO:0050790	regulation of catalytic activity	 95	0.13293801429738	0.919686434773344	51	44	6673	7395	1.13076959203482
GO:0050795	regulation of behavior	  6	0.979023167332401	1	1	5	6723	7434	0.351055919095776
GO:0050796	regulation of insulin secretion	 58	0.787767459257481	1	25	33	6699	7406	0.907903239040801
GO:0050798	activated T cell proliferation	  5	0.77940058892516	1	2	3	6722	7436	0.842534205829863
GO:0050801	ion homeostasis	  5	0.77940058892516	1	2	3	6722	7436	0.842534205829863
GO:0050804	modulation of chemical synaptic transmission	 21	0.134279084429805	0.919686434773344	13	8	6711	7431	1.30392198521288
GO:0050805	negative regulation of synaptic transmission	  7	0.187210848839696	0.949543953868825	5	2	6719	7437	1.50452536755333
GO:0050806	positive regulation of synaptic transmission	 16	0.853260719975205	1	6	10	6718	7429	0.789875817965497
GO:0050807	regulation of synapse organization	  6	0.979023167332401	1	1	5	6723	7434	0.351055919095776
GO:0050808	synapse organization	 41	0.494590306023443	1	20	21	6704	7418	1.02748073881691
GO:0050810	regulation of steroid biosynthetic process	  7	0.730029012673872	1	3	4	6721	7435	0.902715220531996
GO:0050811	GABA receptor binding	 13	0.230372725000093	1	8	5	6716	7434	1.29620647050748
GO:0050819	negative regulation of coagulation	  5	1	1	0	5	6724	7434	0
GO:0050829	defense response to Gram-negative bacterium	 46	0.999920729730723	1	10	36	6714	7403	0.457899024907534
GO:0050830	defense response to Gram-positive bacterium	 53	0.999996694829205	1	10	43	6714	7396	0.397421795202766
GO:0050832	defense response to fungus	 16	0.94165410331218	1	5	11	6719	7428	0.658229848304581
GO:0050839	cell adhesion molecule binding	 57	0.989262087710742	1	19	38	6705	7401	0.702111838191553
GO:0050840	extracellular matrix binding	 21	0.738560418161868	1	9	12	6715	7427	0.902715220531996
GO:0050847	progesterone receptor signaling pathway	  5	0.960049771736903	1	1	4	6723	7435	0.421267102914932
GO:0050848	regulation of calcium-mediated signaling	 11	0.665993939534306	1	5	6	6719	7433	0.957425233897572
GO:0050850	positive regulation of calcium-mediated signaling	 15	0.972187308828691	1	4	11	6720	7428	0.561689470553242
GO:0050851	antigen receptor-mediated signaling pathway	  6	0.297654371351411	1	4	2	6720	7437	1.40422367638311
GO:0050853	B cell receptor signaling pathway	 36	0.999539586988889	1	8	28	6716	7411	0.468074558794368
GO:0050855	regulation of B cell receptor signaling pathway	  6	0.865182793759413	1	2	4	6722	7435	0.702111838191553
GO:0050856	regulation of T cell receptor signaling pathway	  5	0.77940058892516	1	2	3	6722	7436	0.842534205829863
GO:0050860	negative regulation of T cell receptor signaling pathway	 16	0.324860333233664	1	9	7	6715	7432	1.18481372694825
GO:0050861	positive regulation of B cell receptor signaling pathway	  6	0.607836179256654	1	3	3	6721	7436	1.05316775728733
GO:0050862	positive regulation of T cell receptor signaling pathway	 10	0.133503266897558	0.919686434773344	7	3	6717	7436	1.47443486020226
GO:0050863	regulation of T cell activation	  7	1	1	0	7	6724	7432	0
GO:0050868	negative regulation of T cell activation	 12	0.75380380293781	1	5	7	6719	7432	0.877639797739441
GO:0050869	negative regulation of B cell activation	  9	0.972243904416257	1	2	7	6722	7432	0.468074558794368
GO:0050870	positive regulation of T cell activation	 22	0.325498770721016	1	12	10	6712	7429	1.14891028067709
GO:0050871	positive regulation of B cell activation	 13	0.999769586887007	1	1	12	6723	7427	0.162025808813435
GO:0050872	white fat cell differentiation	 11	0.850917330440019	1	4	7	6720	7432	0.765940187118057
GO:0050873	brown fat cell differentiation	 27	0.998243459946661	1	6	21	6718	7418	0.468074558794368
GO:0050877	nervous system process	 10	0.925275888620553	1	3	7	6721	7432	0.631900654372397
GO:0050878	regulation of body fluid levels	  5	0.452745275304033	1	3	2	6721	7437	1.26380130874479
GO:0050880	regulation of blood vessel size	 16	0.982365044000861	1	4	12	6720	7427	0.526583878643665
GO:0050884	neuromuscular process controlling posture	 12	0.320810094151237	1	7	5	6717	7434	1.22869571683522
GO:0050885	neuromuscular process controlling balance	 38	0.439698594040043	1	19	19	6705	7420	1.05316775728733
GO:0050890	cognition	 34	0.449969687236123	1	17	17	6707	7422	1.05316775728733
GO:0050891	multicellular organismal water homeostasis	  8	1	1	0	8	6724	7431	0
GO:0050892	intestinal absorption	 14	0.998346203775137	1	2	12	6722	7427	0.300905073510665
GO:0050901	leukocyte tethering or rolling	 11	0.999163575349816	1	1	10	6723	7429	0.191485046779514
GO:0050905	neuromuscular process	 21	0.57968055192832	1	10	11	6714	7428	1.00301691170222
GO:0050907	detection of chemical stimulus involved in sensory perception	  5	0.960049771736903	1	1	4	6723	7435	0.421267102914932
GO:0050908	detection of light stimulus involved in visual perception	 10	0.925275888620553	1	3	7	6721	7432	0.631900654372397
GO:0050909	sensory perception of taste	 19	0.983231201677496	1	5	14	6719	7425	0.55429881962491
GO:0050910	detection of mechanical stimulus involved in sensory perception of sound	  7	0.919244306193629	1	2	5	6722	7434	0.601810147021331
GO:0050911	detection of chemical stimulus involved in sensory perception of smell	 38	0.999991711893089	1	6	32	6718	7407	0.332579291774946
GO:0050918	positive chemotaxis	 26	0.997238836294189	1	6	20	6718	7419	0.486077426440306
GO:0050919	negative chemotaxis	 29	0.391787364159249	1	15	14	6709	7425	1.08948388684896
GO:0050921	positive regulation of chemotaxis	 12	0.899474094191123	1	4	8	6720	7431	0.702111838191553
GO:0050927	positive regulation of positive chemotaxis	 10	0.925275888620553	1	3	7	6721	7432	0.631900654372397
GO:0050930	induction of positive chemotaxis	 11	0.850917330440019	1	4	7	6720	7432	0.765940187118057
GO:0050953	sensory perception of light stimulus	  7	0.444912401367032	1	4	3	6720	7436	1.20362029404266
GO:0050965	detection of temperature stimulus involved in sensory perception of pain	 15	0.914031171019375	1	5	10	6719	7429	0.702111838191553
GO:0050966	detection of mechanical stimulus involved in sensory perception of pain	  9	0.882794860340315	1	3	6	6721	7433	0.702111838191553
GO:0050982	detection of mechanical stimulus	 12	0.5430601307694	1	6	6	6718	7433	1.05316775728733
GO:0050995	negative regulation of lipid catabolic process	 11	0.431935112460319	1	6	5	6718	7434	1.14891028067709
GO:0050998	nitric-oxide synthase binding	 13	0.643122793005253	1	6	7	6718	7432	0.972154852880611
GO:0050999	regulation of nitric-oxide synthase activity	 20	0.497606676879603	1	10	10	6714	7429	1.05316775728733
GO:0051000	positive regulation of nitric-oxide synthase activity	 15	0.972187308828691	1	4	11	6720	7428	0.561689470553242
GO:0051001	negative regulation of nitric-oxide synthase activity	  7	0.98898631085553	1	1	6	6723	7433	0.300905073510665
GO:0051004	regulation of lipoprotein lipase activity	  9	0.882794860340315	1	3	6	6721	7433	0.702111838191553
GO:0051006	positive regulation of lipoprotein lipase activity	  7	0.98898631085553	1	1	6	6723	7433	0.300905073510665
GO:0051010	microtubule plus-end binding	 10	0.316545776550851	1	6	4	6718	7435	1.26380130874479
GO:0051011	microtubule minus-end binding	  7	0.187210848839696	0.949543953868825	5	2	6719	7437	1.50452536755333
GO:0051013	microtubule severing	  6	0.607836179256654	1	3	3	6721	7436	1.05316775728733
GO:0051014	actin filament severing	  6	0.865182793759413	1	2	4	6722	7435	0.702111838191553
GO:0051016	barbed-end actin filament capping	 12	0.5430601307694	1	6	6	6718	7433	1.05316775728733
GO:0051017	actin filament bundle assembly	 30	0.960143729583739	1	10	20	6714	7419	0.702111838191553
GO:0051018	protein kinase A binding	 17	0.243621618961318	1	10	7	6714	7432	1.23902089092627
GO:0051019	mitogen-activated protein kinase binding	 18	0.687525801418504	1	8	10	6716	7429	0.936149117588737
GO:0051020	GTPase binding	 33	0.161412016275142	0.922445700930811	19	14	6705	7425	1.21273862960359
GO:0051024	positive regulation of immunoglobulin secretion	  8	0.819878207576373	1	3	5	6721	7434	0.789875817965497
GO:0051028	mRNA transport	 90	0.00173162801328316	0.222937212333575	57	33	6667	7406	1.33401249256395
GO:0051044	positive regulation of membrane protein ectodomain proteolysis	 13	0.933471720877997	1	4	9	6720	7430	0.648103235253741
GO:0051045	negative regulation of membrane protein ectodomain proteolysis	  6	0.865182793759413	1	2	4	6722	7435	0.702111838191553
GO:0051057	positive regulation of small GTPase mediated signal transduction	  6	0.607836179256654	1	3	3	6721	7436	1.05316775728733
GO:0051059	NF-kappaB binding	 26	0.935947878741725	1	9	17	6715	7422	0.729116139660459
GO:0051081	nuclear envelope disassembly	  5	0.452745275304033	1	3	2	6721	7437	1.26380130874479
GO:0051082	unfolded protein binding	 91	0.0251137585293479	0.495149842313607	53	38	6671	7401	1.22676683815887
GO:0051084	de novo	  5	0.452745275304033	1	3	2	6721	7437	1.26380130874479
GO:0051085	chaperone mediated protein folding requiring cofactor	 10	0.559603563591584	1	5	5	6719	7434	1.05316775728733
GO:0051087	chaperone binding	 77	0.0345428447932269	0.599479186247127	45	32	6679	7407	1.23097530072545
GO:0051090	regulation of sequence-specific DNA binding transcription factor activity	 22	0.489152057931013	1	11	11	6713	7428	1.05316775728733
GO:0051091	positive regulation of sequence-specific DNA binding transcription factor activity	 95	0.962494688005775	1	37	58	6687	7381	0.820362253044867
GO:0051096	positive regulation of helicase activity	  6	0.297654371351411	1	4	2	6720	7437	1.40422367638311
GO:0051099	positive regulation of binding	  5	0.960049771736903	1	1	4	6723	7435	0.421267102914932
GO:0051103	DNA ligation involved in DNA repair	 10	0.316545776550851	1	6	4	6718	7435	1.26380130874479
GO:0051117	ATPase binding	 69	0.0172417344572251	0.495149842313607	42	27	6682	7412	1.2821172697411
GO:0051123	RNA polymerase II transcriptional preinitiation complex assembly	 16	0.517377397284026	1	8	8	6716	7431	1.05316775728733
GO:0051127	positive regulation of actin nucleation	  5	0.157494903089267	0.919686434773344	4	1	6720	7438	1.68506841165973
GO:0051131	chaperone-mediated protein complex assembly	 14	0.160610520833599	0.919686434773344	9	5	6715	7434	1.35407283079799
GO:0051145	smooth muscle cell differentiation	 12	0.899474094191123	1	4	8	6720	7431	0.702111838191553
GO:0051146	striated muscle cell differentiation	 11	0.665993939534306	1	5	6	6719	7433	0.957425233897572
GO:0051149	positive regulation of muscle cell differentiation	 24	0.481410334966146	1	12	12	6712	7427	1.05316775728733
GO:0051150	regulation of smooth muscle cell differentiation	  6	0.607836179256654	1	3	3	6721	7436	1.05316775728733
GO:0051151	negative regulation of smooth muscle cell differentiation	  8	0.819878207576373	1	3	5	6721	7434	0.789875817965497
GO:0051152	positive regulation of smooth muscle cell differentiation	  6	0.297654371351411	1	4	2	6720	7437	1.40422367638311
GO:0051155	positive regulation of striated muscle cell differentiation	  6	0.607836179256654	1	3	3	6721	7436	1.05316775728733
GO:0051156	glucose 6-phosphate metabolic process	  9	0.69404490204849	1	4	5	6720	7434	0.936149117588737
GO:0051168	nuclear export	 10	0.0390070262266277	0.625040317669623	8	2	6716	7437	1.68506841165973
GO:0051170	nuclear import	 18	0.506938913103874	1	9	9	6715	7430	1.05316775728733
GO:0051205	protein insertion into membrane	  6	0.297654371351411	1	4	2	6720	7437	1.40422367638311
GO:0051209	release of sequestered calcium ion into cytosol	 33	0.260933554151229	1	18	15	6706	7424	1.14891028067709
GO:0051213	dioxygenase activity	 71	0.975462369358705	1	26	45	6698	7394	0.771334132097762
GO:0051216	cartilage development	 68	0.999690513336795	1	19	49	6705	7390	0.588534923189978
GO:0051219	phosphoprotein binding	 35	0.514569683557429	1	17	18	6707	7421	1.02307724993626
GO:0051222	positive regulation of protein transport	  5	1	1	0	5	6724	7434	0
GO:0051223	regulation of protein transport	  6	0.297654371351411	1	4	2	6720	7437	1.40422367638311
GO:0051224	negative regulation of protein transport	  5	0.0241003244622537	0.495149842313607	5	0	6719	7439	2.10633551457466
GO:0051225	spindle assembly	 24	0.481410334966146	1	12	12	6712	7427	1.05316775728733
GO:0051233	spindle midzone	 17	0.607264962167558	1	8	9	6716	7430	0.991216712741015
GO:0051246	regulation of protein metabolic process	  9	0.972243904416257	1	2	7	6722	7432	0.468074558794368
GO:0051247	positive regulation of protein metabolic process	  7	0.444912401367032	1	4	3	6720	7436	1.20362029404266
GO:0051256	mitotic spindle midzone assembly	  6	0.607836179256654	1	3	3	6721	7436	1.05316775728733
GO:0051258	protein polymerization	  9	0.882794860340315	1	3	6	6721	7433	0.702111838191553
GO:0051259	protein oligomerization	 63	0.181944123750691	0.949543953868825	34	29	6690	7410	1.13675249992918
GO:0051262	protein tetramerization	 30	0.322199322975026	1	16	14	6708	7425	1.12337894110648
GO:0051271	negative regulation of cellular component movement	  5	0.960049771736903	1	1	4	6723	7435	0.421267102914932
GO:0051272	positive regulation of cellular component movement	  9	0.69404490204849	1	4	5	6720	7434	0.936149117588737
GO:0051276	chromosome organization	 24	0.194475510371151	0.972714597800941	14	10	6710	7429	1.22869571683522
GO:0051279	regulation of release of sequestered calcium ion into cytosol	 11	0.665993939534306	1	5	6	6719	7433	0.957425233897572
GO:0051281	positive regulation of release of sequestered calcium ion into cytosol	 21	0.57968055192832	1	10	11	6714	7428	1.00301691170222
GO:0051287	NAD binding	 35	0.0940410178590895	0.843214701401555	21	14	6703	7425	1.26380130874479
GO:0051289	protein homotetramerization	 67	0.431995636460854	1	33	34	6691	7405	1.03744883553677
GO:0051290	protein heterotetramerization	 22	0.896697486794484	1	8	14	6716	7425	0.765940187118057
GO:0051291	protein heterooligomerization	 63	0.078787750867512	0.807895728316903	36	27	6688	7412	1.20362029404266
GO:0051292	nuclear pore complex assembly	 10	0.559603563591584	1	5	5	6719	7434	1.05316775728733
GO:0051298	centrosome duplication	 17	0.118839522247653	0.899006189270582	11	6	6713	7433	1.3629229800189
GO:0051310	metaphase plate congression	  8	0.580280354503036	1	4	4	6720	7435	1.05316775728733
GO:0051315	attachment of mitotic spindle microtubules to kinetochore	  5	0.960049771736903	1	1	4	6723	7435	0.421267102914932
GO:0051321	meiotic cell cycle	 66	0.828162336905752	1	28	38	6696	7401	0.893596884971067
GO:0051344	negative regulation of cyclic-nucleotide phosphodiesterase activity	  5	0.960049771736903	1	1	4	6723	7435	0.421267102914932
GO:0051346	negative regulation of hydrolase activity	  7	0.919244306193629	1	2	5	6722	7434	0.601810147021331
GO:0051353	positive regulation of oxidoreductase activity	  6	0.865182793759413	1	2	4	6722	7435	0.702111838191553
GO:0051371	muscle alpha-actinin binding	 14	0.323388997222084	1	8	6	6716	7433	1.20362029404266
GO:0051373	FATZ binding	  5	0.960049771736903	1	1	4	6723	7435	0.421267102914932
GO:0051378	serotonin binding	  8	0.994217735396885	1	1	7	6723	7432	0.263291939321832
GO:0051379	epinephrine binding	  7	0.98898631085553	1	1	6	6723	7433	0.300905073510665
GO:0051382	kinetochore assembly	  6	0.865182793759413	1	2	4	6722	7435	0.702111838191553
GO:0051384	response to glucocorticoid	 55	0.998262232570397	1	16	39	6708	7400	0.612752149694446
GO:0051388	positive regulation of neurotrophin TRK receptor signaling pathway	  5	0.452745275304033	1	3	2	6721	7437	1.26380130874479
GO:0051393	alpha-actinin binding	 15	0.623867966210499	1	7	8	6717	7431	0.982956573468174
GO:0051400	BH domain binding	  5	0.960049771736903	1	1	4	6723	7435	0.421267102914932
GO:0051402	neuron apoptotic process	 34	0.0140542082563776	0.453189329920734	23	11	6701	7428	1.42487402456521
GO:0051403	stress-activated MAPK cascade	 22	0.189941610858229	0.956669265160296	13	9	6711	7430	1.24465280406684
GO:0051412	response to corticosterone	 11	0.953160347938253	1	3	8	6721	7431	0.574455140338543
GO:0051415	interphase microtubule nucleation by interphase microtubule organizing center	  6	0.0874151689581943	0.807895728316903	5	1	6719	7438	1.75527959547888
GO:0051428	peptide hormone receptor binding	  8	0.309544448231027	1	5	3	6719	7436	1.31645969660916
GO:0051436	negative regulation of ubiquitin-protein ligase activity involved in mitotic cell cycle	 59	0.348094871604032	1	30	29	6694	7410	1.0710180582583
GO:0051437	positive regulation of ubiquitin-protein ligase activity involved in regulation of mitotic cell cycle transition	 63	0.256015264804749	1	33	30	6691	7409	1.10331860287244
GO:0051438	regulation of ubiquitin-protein transferase activity	  5	0.157494903089267	0.919686434773344	4	1	6720	7438	1.68506841165973
GO:0051439	regulation of ubiquitin-protein ligase activity involved in mitotic cell cycle	 19	0.411669949440149	1	10	9	6714	7430	1.10859763924982
GO:0051443	positive regulation of ubiquitin-protein transferase activity	 18	0.687525801418504	1	8	10	6716	7429	0.936149117588737
GO:0051444	negative regulation of ubiquitin-protein transferase activity	  7	0.444912401367032	1	4	3	6720	7436	1.20362029404266
GO:0051451	myoblast migration	  9	0.882794860340315	1	3	6	6721	7433	0.702111838191553
GO:0051453	regulation of intracellular pH	 27	0.693189244333171	1	12	15	6712	7424	0.936149117588737
GO:0051457	maintenance of protein location in nucleus	 13	0.230372725000093	1	8	5	6716	7434	1.29620647050748
GO:0051480	regulation of cytosolic calcium ion concentration	 31	0.877080826063238	1	12	19	6712	7420	0.815355683061158
GO:0051481	negative regulation of cytosolic calcium ion concentration	  8	0.580280354503036	1	4	4	6720	7435	1.05316775728733
GO:0051482	positive regulation of cytosolic calcium ion concentration involved in phospholipase C-activating G-protein coupled signaling pathway	 23	0.989780830505069	1	6	17	6718	7422	0.549478829889041
GO:0051489	regulation of filopodium assembly	 11	0.220387996626296	1	7	4	6717	7435	1.3403953274566
GO:0051491	positive regulation of filopodium assembly	 26	0.62841636814953	1	12	14	6712	7425	0.972154852880611
GO:0051492	regulation of stress fiber assembly	 16	0.517377397284026	1	8	8	6716	7431	1.05316775728733
GO:0051493	regulation of cytoskeleton organization	 20	0.325733222000695	1	11	9	6713	7430	1.15848453301606
GO:0051496	positive regulation of stress fiber assembly	 41	0.494590306023443	1	20	21	6704	7418	1.02748073881691
GO:0051497	negative regulation of stress fiber assembly	 19	0.756503853067433	1	8	11	6716	7428	0.886878111399856
GO:0051533	positive regulation of NFAT protein import into nucleus	  5	0.77940058892516	1	2	3	6722	7436	0.842534205829863
GO:0051534	negative regulation of NFAT protein import into nucleus	  5	0.452745275304033	1	3	2	6721	7437	1.26380130874479
GO:0051536	iron-sulfur cluster binding	 50	0.41366085413375	1	25	25	6699	7414	1.05316775728733
GO:0051537	2 iron, 2 sulfur cluster binding	 19	0.411669949440149	1	10	9	6714	7430	1.10859763924982
GO:0051539	4 iron, 4 sulfur cluster binding	 31	0.529914677492654	1	15	16	6709	7423	1.01919460382645
GO:0051549	positive regulation of keratinocyte migration	  5	0.157494903089267	0.919686434773344	4	1	6720	7438	1.68506841165973
GO:0051560	mitochondrial calcium ion homeostasis	 14	0.323388997222084	1	8	6	6716	7433	1.20362029404266
GO:0051561	positive regulation of mitochondrial calcium ion concentration	 10	0.316545776550851	1	6	4	6718	7435	1.26380130874479
GO:0051568	histone H3-K4 methylation	 16	0.170220385600338	0.949543953868825	10	6	6714	7433	1.31645969660916
GO:0051569	regulation of histone H3-K4 methylation	  7	0.444912401367032	1	4	3	6720	7436	1.20362029404266
GO:0051571	positive regulation of histone H3-K4 methylation	 13	0.0975861781940815	0.843214701401555	9	4	6715	7435	1.45823227932092
GO:0051574	positive regulation of histone H3-K9 methylation	  6	0.297654371351411	1	4	2	6720	7437	1.40422367638311
GO:0051591	response to cAMP	 37	0.978436787719667	1	12	25	6712	7414	0.683135842564754
GO:0051592	response to calcium ion	 50	0.525913184706037	1	24	26	6700	7413	1.01104104699584
GO:0051593	response to folic acid	  9	0.438074670071218	1	5	4	6719	7435	1.17018639698592
GO:0051597	response to methylmercury	  8	0.819878207576373	1	3	5	6721	7434	0.789875817965497
GO:0051601	exocyst localization	  8	0.952366339066048	1	2	6	6722	7433	0.526583878643665
GO:0051602	response to electrical stimulus	 25	0.961742375998708	1	8	17	6716	7422	0.67402736466389
GO:0051603	proteolysis involved in cellular protein catabolic process	 43	0.884807792585161	1	17	26	6707	7413	0.832737296459748
GO:0051604	protein maturation	 16	0.706693964264422	1	7	9	6717	7430	0.921521787626413
GO:0051639	actin filament network formation	 10	0.78367246101976	1	4	6	6720	7433	0.842534205829863
GO:0051642	centrosome localization	 15	0.109100626262719	0.88413902838582	10	5	6714	7434	1.40422367638311
GO:0051646	mitochondrion localization	  7	0.444912401367032	1	4	3	6720	7436	1.20362029404266
GO:0051647	nucleus localization	  6	0.297654371351411	1	4	2	6720	7437	1.40422367638311
GO:0051660	establishment of centrosome localization	  5	0.77940058892516	1	2	3	6722	7436	0.842534205829863
GO:0051661	maintenance of centrosome location	  5	0.452745275304033	1	3	2	6721	7437	1.26380130874479
GO:0051683	establishment of Golgi localization	  8	0.113810689204897	0.88413902838582	6	2	6718	7437	1.57975163593099
GO:0051693	actin filament capping	 17	0.895242422289557	1	6	11	6718	7428	0.743412534555762
GO:0051694	pointed-end actin filament capping	  5	0.157494903089267	0.919686434773344	4	1	6720	7438	1.68506841165973
GO:0051702	interaction with symbiont	  5	0.0241003244622537	0.495149842313607	5	0	6719	7439	2.10633551457466
GO:0051721	protein phosphatase 2A binding	 26	0.324205758709722	1	14	12	6710	7427	1.13418066169405
GO:0051764	actin crosslink formation	 12	0.971055765853963	1	3	9	6721	7430	0.526583878643665
GO:0051770	positive regulation of nitric-oxide synthase biosynthetic process	 12	0.75380380293781	1	5	7	6719	7432	0.877639797739441
GO:0051775	response to redox state	 10	0.316545776550851	1	6	4	6718	7435	1.26380130874479
GO:0051781	positive regulation of cell division	 37	0.9910373833468	1	11	26	6713	7413	0.626207855684358
GO:0051782	negative regulation of cell division	  8	0.580280354503036	1	4	4	6720	7435	1.05316775728733
GO:0051787	misfolded protein binding	 11	0.431935112460319	1	6	5	6718	7434	1.14891028067709
GO:0051798	positive regulation of hair follicle development	  5	0.960049771736903	1	1	4	6723	7435	0.421267102914932
GO:0051864	histone demethylase activity (H3-K36 specific)	  9	0.438074670071218	1	5	4	6719	7435	1.17018639698592
GO:0051865	protein autoubiquitination	 48	0.000302105736235446	0.1162502873034	35	13	6689	7426	1.53586964604402
GO:0051879	Hsp90 protein binding	 32	0.120555485329501	0.909602955976315	19	13	6705	7426	1.2506367117787
GO:0051880	G-quadruplex DNA binding	  6	0.607836179256654	1	3	3	6721	7436	1.05316775728733
GO:0051881	regulation of mitochondrial membrane potential	 27	0.150496283020169	0.919686434773344	16	11	6708	7428	1.24819882345165
GO:0051893	regulation of focal adhesion assembly	 17	0.776294265732228	1	7	10	6717	7429	0.867314623648389
GO:0051894	positive regulation of focal adhesion assembly	 21	0.57968055192832	1	10	11	6714	7428	1.00301691170222
GO:0051895	negative regulation of focal adhesion assembly	 14	0.875453509540804	1	5	9	6719	7430	0.752262683776664
GO:0051896	regulation of protein kinase B signaling	  9	0.067355898427907	0.780679208284898	7	2	6717	7437	1.63826095578029
GO:0051897	positive regulation of protein kinase B signaling	 73	0.88752512602834	1	30	43	6694	7396	0.865617334756709
GO:0051898	negative regulation of protein kinase B signaling	 31	0.529914677492654	1	15	16	6709	7423	1.01919460382645
GO:0051899	membrane depolarization	 20	0.813860390499775	1	8	12	6716	7427	0.842534205829863
GO:0051901	positive regulation of mitochondrial depolarization	 10	0.316545776550851	1	6	4	6718	7435	1.26380130874479
GO:0051902	negative regulation of mitochondrial depolarization	  5	0.960049771736903	1	1	4	6723	7435	0.421267102914932
GO:0051918	negative regulation of fibrinolysis	  7	0.98898631085553	1	1	6	6723	7433	0.300905073510665
GO:0051920	peroxiredoxin activity	  8	0.309544448231027	1	5	3	6719	7436	1.31645969660916
GO:0051923	sulfation	  5	0.77940058892516	1	2	3	6722	7436	0.842534205829863
GO:0051924	regulation of calcium ion transport	 23	0.843995637843635	1	9	14	6715	7425	0.824218244833562
GO:0051926	negative regulation of calcium ion transport	 11	0.999163575349816	1	1	10	6723	7429	0.191485046779514
GO:0051928	positive regulation of calcium ion transport	 18	0.687525801418504	1	8	10	6716	7429	0.936149117588737
GO:0051930	regulation of sensory perception of pain	 19	0.756503853067433	1	8	11	6716	7428	0.886878111399856
GO:0051932	synaptic transmission, GABAergic	  6	0.0874151689581943	0.807895728316903	5	1	6719	7438	1.75527959547888
GO:0051959	dynein light intermediate chain binding	 24	0.10185657048721	0.868413773784606	15	9	6709	7430	1.31645969660916
GO:0051963	regulation of synapse assembly	  7	0.730029012673872	1	3	4	6721	7435	0.902715220531996
GO:0051964	negative regulation of synapse assembly	  6	0.607836179256654	1	3	3	6721	7436	1.05316775728733
GO:0051965	positive regulation of synapse assembly	 59	0.820326104375612	1	25	34	6699	7405	0.892515048548584
GO:0051966	regulation of synaptic transmission, glutamatergic	 21	0.25155850170495	1	12	9	6712	7430	1.20362029404266
GO:0051967	negative regulation of synaptic transmission, glutamatergic	  7	0.187210848839696	0.949543953868825	5	2	6719	7437	1.50452536755333
GO:0051968	positive regulation of synaptic transmission, glutamatergic	 17	0.416253886790052	1	9	8	6715	7431	1.11511880183364
GO:0051973	positive regulation of telomerase activity	 32	0.0296522687950593	0.549711001936538	21	11	6703	7428	1.38228268143962
GO:0051974	negative regulation of telomerase activity	  9	0.972243904416257	1	2	7	6722	7432	0.468074558794368
GO:0051983	regulation of chromosome segregation	  7	0.730029012673872	1	3	4	6721	7435	0.902715220531996
GO:0051988	regulation of attachment of spindle microtubules to kinetochore	  6	0.297654371351411	1	4	2	6720	7437	1.40422367638311
GO:0052548	regulation of endopeptidase activity	  6	0.607836179256654	1	3	3	6721	7436	1.05316775728733
GO:0052629	phosphatidylinositol-3,5-bisphosphate 3-phosphatase activity	 11	0.0221890923454724	0.495149842313607	9	2	6715	7437	1.72336542101563
GO:0052658	inositol-1,4,5-trisphosphate 5-phosphatase activity	  6	0.297654371351411	1	4	2	6720	7437	1.40422367638311
GO:0052659	inositol-1,3,4,5-tetrakisphosphate 5-phosphatase activity	  9	0.206720270758876	0.983668097955673	6	3	6718	7436	1.40422367638311
GO:0052689	carboxylic ester hydrolase activity	 35	0.0940410178590895	0.843214701401555	21	14	6703	7425	1.26380130874479
GO:0052723	inositol hexakisphosphate 1-kinase activity	  5	0.452745275304033	1	3	2	6721	7437	1.26380130874479
GO:0052724	inositol hexakisphosphate 3-kinase activity	  5	0.452745275304033	1	3	2	6721	7437	1.26380130874479
GO:0052811	1-phosphatidylinositol-3-phosphate 4-kinase activity	  5	0.77940058892516	1	2	3	6722	7436	0.842534205829863
GO:0055001	muscle cell development	  6	0.865182793759413	1	2	4	6722	7435	0.702111838191553
GO:0055003	cardiac myofibril assembly	  8	0.994217735396885	1	1	7	6723	7432	0.263291939321832
GO:0055007	cardiac muscle cell differentiation	 21	0.0609416617953418	0.764685373658072	14	7	6710	7432	1.40422367638311
GO:0055008	cardiac muscle tissue morphogenesis	  8	0.994217735396885	1	1	7	6723	7432	0.263291939321832
GO:0055010	ventricular cardiac muscle tissue morphogenesis	 21	0.57968055192832	1	10	11	6714	7428	1.00301691170222
GO:0055012	ventricular cardiac muscle cell differentiation	  5	0.77940058892516	1	2	3	6722	7436	0.842534205829863
GO:0055013	cardiac muscle cell development	  6	0.297654371351411	1	4	2	6720	7437	1.40422367638311
GO:0055015	ventricular cardiac muscle cell development	  7	0.444912401367032	1	4	3	6720	7436	1.20362029404266
GO:0055037	recycling endosome	 99	0.181723812556344	0.949543953868825	52	47	6672	7392	1.10635804805942
GO:0055038	recycling endosome membrane	 53	0.115997910195912	0.893784829666214	30	23	6694	7416	1.1922653856083
GO:0055056	D-glucose transmembrane transporter activity	  7	0.98898631085553	1	1	6	6723	7433	0.300905073510665
GO:0055072	iron ion homeostasis	 39	0.83346403531844	1	16	23	6708	7416	0.864137647004988
GO:0055074	calcium ion homeostasis	 22	0.995635782668442	1	5	17	6719	7422	0.478712616948786
GO:0055075	potassium ion homeostasis	  6	0.865182793759413	1	2	4	6722	7435	0.702111838191553
GO:0055078	sodium ion homeostasis	  6	1	1	0	6	6724	7433	0
GO:0055088	lipid homeostasis	 23	0.997262158269379	1	5	18	6719	7421	0.457899024907534
GO:0055089	fatty acid homeostasis	  9	0.206720270758876	0.983668097955673	6	3	6718	7436	1.40422367638311
GO:0055091	phospholipid homeostasis	  7	0.444912401367032	1	4	3	6720	7436	1.20362029404266
GO:0055093	response to hyperoxia	 11	0.953160347938253	1	3	8	6721	7431	0.574455140338543
GO:0055117	regulation of cardiac muscle contraction	 16	0.517377397284026	1	8	8	6716	7431	1.05316775728733
GO:0055118	negative regulation of cardiac muscle contraction	  5	0.77940058892516	1	2	3	6722	7436	0.842534205829863
GO:0055119	relaxation of cardiac muscle	 11	0.665993939534306	1	5	6	6719	7433	0.957425233897572
GO:0055123	digestive system development	  7	0.444912401367032	1	4	3	6720	7436	1.20362029404266
GO:0055131	C3HC4-type RING finger domain binding	  5	0.77940058892516	1	2	3	6722	7436	0.842534205829863
GO:0060008	Sertoli cell differentiation	  5	0.960049771736903	1	1	4	6723	7435	0.421267102914932
GO:0060009	Sertoli cell development	  9	0.438074670071218	1	5	4	6719	7435	1.17018639698592
GO:0060013	righting reflex	  8	0.309544448231027	1	5	3	6719	7436	1.31645969660916
GO:0060019	radial glial cell differentiation	  5	0.77940058892516	1	2	3	6722	7436	0.842534205829863
GO:0060020	Bergmann glial cell differentiation	  8	0.819878207576373	1	3	5	6721	7434	0.789875817965497
GO:0060021	palate development	 71	0.931031786457603	1	28	43	6696	7396	0.830667526874513
GO:0060022	hard palate development	  5	0.452745275304033	1	3	2	6721	7437	1.26380130874479
GO:0060029	convergent extension involved in organogenesis	  5	0.960049771736903	1	1	4	6723	7435	0.421267102914932
GO:0060037	pharyngeal system development	 12	0.999560983443925	1	1	11	6723	7428	0.175527959547888
GO:0060038	cardiac muscle cell proliferation	 13	0.230372725000093	1	8	5	6716	7434	1.29620647050748
GO:0060039	pericardium development	  7	0.444912401367032	1	4	3	6720	7436	1.20362029404266
GO:0060041	retina development in camera-type eye	 54	0.803859340446664	1	23	31	6701	7408	0.897142904355873
GO:0060042	retina morphogenesis in camera-type eye	  8	0.580280354503036	1	4	4	6720	7435	1.05316775728733
GO:0060044	negative regulation of cardiac muscle cell proliferation	 11	0.220387996626296	1	7	4	6717	7435	1.3403953274566
GO:0060045	positive regulation of cardiac muscle cell proliferation	 18	0.687525801418504	1	8	10	6716	7429	0.936149117588737
GO:0060047	heart contraction	  9	0.206720270758876	0.983668097955673	6	3	6718	7436	1.40422367638311
GO:0060048	cardiac muscle contraction	 37	0.507552451933799	1	18	19	6706	7420	1.02470376384713
GO:0060052	neurofilament cytoskeleton organization	  6	0.297654371351411	1	4	2	6720	7437	1.40422367638311
GO:0060054	positive regulation of epithelial cell proliferation involved in wound healing	  5	0.960049771736903	1	1	4	6723	7435	0.421267102914932
GO:0060055	angiogenesis involved in wound healing	 10	0.925275888620553	1	3	7	6721	7432	0.631900654372397
GO:0060059	embryonic retina morphogenesis in camera-type eye	  6	0.0874151689581943	0.807895728316903	5	1	6719	7438	1.75527959547888
GO:0060065	uterus development	 13	0.822979434145659	1	5	8	6719	7431	0.810129044067176
GO:0060068	vagina development	  9	0.69404490204849	1	4	5	6720	7434	0.936149117588737
GO:0060070	canonical Wnt signaling pathway	 71	0.841958714800958	1	30	41	6694	7398	0.890000921651264
GO:0060071	Wnt signaling pathway, planar cell polarity pathway	 84	0.360778414894559	1	42	42	6682	7397	1.05316775728733
GO:0060074	synapse maturation	  7	0.187210848839696	0.949543953868825	5	2	6719	7437	1.50452536755333
GO:0060075	regulation of resting membrane potential	  7	0.444912401367032	1	4	3	6720	7436	1.20362029404266
GO:0060076	excitatory synapse	 24	0.780026211443039	1	10	14	6714	7425	0.877639797739441
GO:0060077	inhibitory synapse	 11	0.220387996626296	1	7	4	6717	7435	1.3403953274566
GO:0060078	regulation of postsynaptic membrane potential	 40	0.960285503133921	1	14	26	6710	7413	0.73721743010113
GO:0060079	excitatory postsynaptic potential	 54	0.620920803681269	1	25	29	6699	7410	0.975155330821601
GO:0060080	inhibitory postsynaptic potential	  6	0.607836179256654	1	3	3	6721	7436	1.05316775728733
GO:0060081	membrane hyperpolarization	  9	0.882794860340315	1	3	6	6721	7433	0.702111838191553
GO:0060087	relaxation of vascular smooth muscle	  6	0.607836179256654	1	3	3	6721	7436	1.05316775728733
GO:0060088	auditory receptor cell stereocilium organization	  9	0.882794860340315	1	3	6	6721	7433	0.702111838191553
GO:0060091	kinocilium	  5	0.960049771736903	1	1	4	6723	7435	0.421267102914932
GO:0060100	positive regulation of phagocytosis, engulfment	  7	0.730029012673872	1	3	4	6721	7435	0.902715220531996
GO:0060117	auditory receptor cell development	  5	0.452745275304033	1	3	2	6721	7437	1.26380130874479
GO:0060119	inner ear receptor cell development	  7	0.444912401367032	1	4	3	6720	7436	1.20362029404266
GO:0060122	inner ear receptor stereocilium organization	 18	0.325568860476231	1	10	8	6714	7431	1.17018639698592
GO:0060124	positive regulation of growth hormone secretion	  8	0.580280354503036	1	4	4	6720	7435	1.05316775728733
GO:0060134	prepulse inhibition	  8	0.580280354503036	1	4	4	6720	7435	1.05316775728733
GO:0060135	maternal process involved in female pregnancy	 18	0.993133250054207	1	4	14	6720	7425	0.468074558794368
GO:0060136	embryonic process involved in female pregnancy	  6	0.297654371351411	1	4	2	6720	7437	1.40422367638311
GO:0060137	maternal process involved in parturition	  8	0.819878207576373	1	3	5	6721	7434	0.789875817965497
GO:0060155	platelet dense granule organization	  5	0.157494903089267	0.919686434773344	4	1	6720	7438	1.68506841165973
GO:0060157	urinary bladder development	  5	0.77940058892516	1	2	3	6722	7436	0.842534205829863
GO:0060158	phospholipase C-activating dopamine receptor signaling pathway	  7	0.730029012673872	1	3	4	6721	7435	0.902715220531996
GO:0060170	ciliary membrane	 42	0.671020490139043	1	19	23	6705	7416	0.952866066117107
GO:0060173	limb development	 35	0.261382282184478	1	19	16	6705	7423	1.14343927934053
GO:0060174	limb bud formation	  8	0.580280354503036	1	4	4	6720	7435	1.05316775728733
GO:0060179	male mating behavior	  6	0.607836179256654	1	3	3	6721	7436	1.05316775728733
GO:0060213	positive regulation of nuclear-transcribed mRNA poly(A) tail shortening	 11	0.220387996626296	1	7	4	6717	7435	1.3403953274566
GO:0060216	definitive hemopoiesis	 15	0.623867966210499	1	7	8	6717	7431	0.982956573468174
GO:0060218	hematopoietic stem cell differentiation	  9	0.69404490204849	1	4	5	6720	7434	0.936149117588737
GO:0060219	camera-type eye photoreceptor cell differentiation	  5	0.77940058892516	1	2	3	6722	7436	0.842534205829863
GO:0060231	mesenchymal to epithelial transition	  7	0.919244306193629	1	2	5	6722	7434	0.601810147021331
GO:0060236	regulation of mitotic spindle organization	 14	0.323388997222084	1	8	6	6716	7433	1.20362029404266
GO:0060252	positive regulation of glial cell proliferation	  9	0.438074670071218	1	5	4	6719	7435	1.17018639698592
GO:0060253	negative regulation of glial cell proliferation	  8	0.819878207576373	1	3	5	6721	7434	0.789875817965497
GO:0060259	regulation of feeding behavior	  5	0.77940058892516	1	2	3	6722	7436	0.842534205829863
GO:0060261	positive regulation of transcription initiation from RNA polymerase II promoter	  8	0.952366339066048	1	2	6	6722	7433	0.526583878643665
GO:0060272	embryonic skeletal joint morphogenesis	  7	1	1	0	7	6724	7432	0
GO:0060285	cilium-dependent cell motility	  7	0.0474968970055936	0.646585116783694	6	1	6718	7438	1.80543044106399
GO:0060287	epithelial cilium movement involved in determination of left/right asymmetry	  7	0.187210848839696	0.949543953868825	5	2	6719	7437	1.50452536755333
GO:0060290	transdifferentiation	  5	0.452745275304033	1	3	2	6721	7437	1.26380130874479
GO:0060291	long-term synaptic potentiation	 41	0.61763521493367	1	19	22	6705	7417	0.976106701876061
GO:0060292	long term synaptic depression	 16	0.706693964264422	1	7	9	6717	7430	0.921521787626413
GO:0060294	cilium movement involved in cell motility	  5	0.77940058892516	1	2	3	6722	7436	0.842534205829863
GO:0060296	regulation of cilium beat frequency involved in ciliary motility	  5	0.157494903089267	0.919686434773344	4	1	6720	7438	1.68506841165973
GO:0060306	regulation of membrane repolarization	  9	0.438074670071218	1	5	4	6719	7435	1.17018639698592
GO:0060307	regulation of ventricular cardiac muscle cell membrane repolarization	 13	0.643122793005253	1	6	7	6718	7432	0.972154852880611
GO:0060314	regulation of ryanodine-sensitive calcium-release channel activity	 15	0.421118865258844	1	8	7	6716	7432	1.12337894110648
GO:0060315	negative regulation of ryanodine-sensitive calcium-release channel activity	  8	0.580280354503036	1	4	4	6720	7435	1.05316775728733
GO:0060317	cardiac epithelial to mesenchymal transition	 11	0.665993939534306	1	5	6	6719	7433	0.957425233897572
GO:0060322	head development	 15	0.798298186583662	1	6	9	6718	7430	0.842534205829863
GO:0060323	head morphogenesis	  8	0.113810689204897	0.88413902838582	6	2	6718	7437	1.57975163593099
GO:0060324	face development	 17	0.607264962167558	1	8	9	6716	7430	0.991216712741015
GO:0060325	face morphogenesis	 27	0.693189244333171	1	12	15	6712	7424	0.936149117588737
GO:0060326	cell chemotaxis	 48	0.996896276829402	1	14	34	6710	7405	0.614347858417609
GO:0060333	interferon-gamma-mediated signaling pathway	 54	0.994270992215587	1	17	37	6707	7402	0.663105624958689
GO:0060334	regulation of interferon-gamma-mediated signaling pathway	 12	0.148657926965624	0.919686434773344	8	4	6716	7435	1.40422367638311
GO:0060337	type I interferon signaling pathway	 48	0.9996034921251	1	12	36	6712	7403	0.526583878643665
GO:0060338	regulation of type I interferon-mediated signaling pathway	 16	0.170220385600338	0.949543953868825	10	6	6714	7433	1.31645969660916
GO:0060339	negative regulation of type I interferon-mediated signaling pathway	  5	0.0241003244622537	0.495149842313607	5	0	6719	7439	2.10633551457466
GO:0060340	positive regulation of type I interferon-mediated signaling pathway	  8	0.952366339066048	1	2	6	6722	7433	0.526583878643665
GO:0060346	bone trabecula formation	  7	0.730029012673872	1	3	4	6721	7435	0.902715220531996
GO:0060347	heart trabecula formation	 13	0.426320358160906	1	7	6	6717	7433	1.13418066169405
GO:0060348	bone development	 48	0.532249794220985	1	23	25	6701	7414	1.00928576740036
GO:0060349	bone morphogenesis	 22	0.896697486794484	1	8	14	6716	7425	0.765940187118057
GO:0060363	cranial suture morphogenesis	  6	0.865182793759413	1	2	4	6722	7435	0.702111838191553
GO:0060371	regulation of atrial cardiac muscle cell membrane depolarization	  7	0.444912401367032	1	4	3	6720	7436	1.20362029404266
GO:0060372	regulation of atrial cardiac muscle cell membrane repolarization	  5	0.960049771736903	1	1	4	6723	7435	0.421267102914932
GO:0060373	regulation of ventricular cardiac muscle cell membrane depolarization	  6	0.979023167332401	1	1	5	6723	7434	0.351055919095776
GO:0060384	innervation	 17	0.416253886790052	1	9	8	6715	7431	1.11511880183364
GO:0060389	pathway-restricted SMAD protein phosphorylation	 11	0.990836032904502	1	2	9	6722	7430	0.382970093559029
GO:0060391	positive regulation of SMAD protein import into nucleus	 10	0.559603563591584	1	5	5	6719	7434	1.05316775728733
GO:0060394	negative regulation of pathway-restricted SMAD protein phosphorylation	  9	0.206720270758876	0.983668097955673	6	3	6718	7436	1.40422367638311
GO:0060395	SMAD protein signal transduction	 49	0.951618735895902	1	18	31	6706	7408	0.77375590331314
GO:0060396	growth hormone receptor signaling pathway	  8	0.309544448231027	1	5	3	6719	7436	1.31645969660916
GO:0060397	JAK-STAT cascade involved in growth hormone signaling pathway	 12	0.320810094151237	1	7	5	6717	7434	1.22869571683522
GO:0060402	calcium ion transport into cytosol	 13	0.822979434145659	1	5	8	6719	7431	0.810129044067176
GO:0060411	cardiac septum morphogenesis	 10	0.78367246101976	1	4	6	6720	7433	0.842534205829863
GO:0060412	ventricular septum morphogenesis	 27	0.814070309852114	1	11	16	6713	7423	0.858136691123009
GO:0060413	atrial septum morphogenesis	  8	0.819878207576373	1	3	5	6721	7434	0.789875817965497
GO:0060415	muscle tissue morphogenesis	  5	1	1	0	5	6724	7434	0
GO:0060416	response to growth hormone	 11	0.850917330440019	1	4	7	6720	7432	0.765940187118057
GO:0060425	lung morphogenesis	 18	0.993133250054207	1	4	14	6720	7425	0.468074558794368
GO:0060426	lung vasculature development	  5	0.960049771736903	1	1	4	6723	7435	0.421267102914932
GO:0060428	lung epithelium development	  6	0.979023167332401	1	1	5	6723	7434	0.351055919095776
GO:0060429	epithelium development	  7	1	1	0	7	6724	7432	0
GO:0060440	trachea formation	  6	0.607836179256654	1	3	3	6721	7436	1.05316775728733
GO:0060441	epithelial tube branching involved in lung morphogenesis	 13	0.822979434145659	1	5	8	6719	7431	0.810129044067176
GO:0060442	branching involved in prostate gland morphogenesis	  5	0.452745275304033	1	3	2	6721	7437	1.26380130874479
GO:0060444	branching involved in mammary gland duct morphogenesis	 11	0.999163575349816	1	1	10	6723	7429	0.191485046779514
GO:0060445	branching involved in salivary gland morphogenesis	 10	0.983985908365184	1	2	8	6722	7431	0.421267102914932
GO:0060449	bud elongation involved in lung branching	  5	0.960049771736903	1	1	4	6723	7435	0.421267102914932
GO:0060452	positive regulation of cardiac muscle contraction	  6	0.979023167332401	1	1	5	6723	7434	0.351055919095776
GO:0060463	lung lobe morphogenesis	  6	0.979023167332401	1	1	5	6723	7434	0.351055919095776
GO:0060484	lung-associated mesenchyme development	  8	0.819878207576373	1	3	5	6721	7434	0.789875817965497
GO:0060485	mesenchyme development	  5	0.960049771736903	1	1	4	6723	7435	0.421267102914932
GO:0060487	lung epithelial cell differentiation	  7	0.730029012673872	1	3	4	6721	7435	0.902715220531996
GO:0060509	Type I pneumocyte differentiation	  5	0.157494903089267	0.919686434773344	4	1	6720	7438	1.68506841165973
GO:0060527	prostate epithelial cord arborization involved in prostate glandular acinus morphogenesis	  5	0.157494903089267	0.919686434773344	4	1	6720	7438	1.68506841165973
GO:0060536	cartilage morphogenesis	  6	1	1	0	6	6724	7433	0
GO:0060539	diaphragm development	  6	0.979023167332401	1	1	5	6723	7434	0.351055919095776
GO:0060544	regulation of necroptotic process	 11	0.850917330440019	1	4	7	6720	7432	0.765940187118057
GO:0060546	negative regulation of necroptotic process	 10	0.78367246101976	1	4	6	6720	7433	0.842534205829863
GO:0060548	negative regulation of cell death	 61	0.985868143994293	1	21	40	6703	7399	0.725131898460128
GO:0060561	apoptotic process involved in morphogenesis	  6	0.865182793759413	1	2	4	6722	7435	0.702111838191553
GO:0060563	neuroepithelial cell differentiation	  9	0.972243904416257	1	2	7	6722	7432	0.468074558794368
GO:0060576	intestinal epithelial cell development	  6	0.865182793759413	1	2	4	6722	7435	0.702111838191553
GO:0060586	multicellular organismal iron ion homeostasis	  7	0.730029012673872	1	3	4	6721	7435	0.902715220531996
GO:0060591	chondroblast differentiation	  5	1	1	0	5	6724	7434	0
GO:0060603	mammary gland duct morphogenesis	  6	0.979023167332401	1	1	5	6723	7434	0.351055919095776
GO:0060612	adipose tissue development	 19	0.877279625799761	1	7	12	6717	7427	0.776018347474874
GO:0060613	fat pad development	  5	0.157494903089267	0.919686434773344	4	1	6720	7438	1.68506841165973
GO:0060627	regulation of vesicle-mediated transport	  9	0.438074670071218	1	5	4	6719	7435	1.17018639698592
GO:0060628	regulation of ER to Golgi vesicle-mediated transport	  5	0.452745275304033	1	3	2	6721	7437	1.26380130874479
GO:0060644	mammary gland epithelial cell differentiation	 11	0.953160347938253	1	3	8	6721	7431	0.574455140338543
GO:0060664	epithelial cell proliferation involved in salivary gland morphogenesis	  5	0.77940058892516	1	2	3	6722	7436	0.842534205829863
GO:0060670	branching involved in labyrinthine layer morphogenesis	  7	0.919244306193629	1	2	5	6722	7434	0.601810147021331
GO:0060674	placenta blood vessel development	 11	0.0838548499097086	0.807895728316903	8	3	6716	7436	1.53188037423611
GO:0060684	epithelial-mesenchymal cell signaling	  5	0.960049771736903	1	1	4	6723	7435	0.421267102914932
GO:0060687	regulation of branching involved in prostate gland morphogenesis	  6	0.297654371351411	1	4	2	6720	7437	1.40422367638311
GO:0060706	cell differentiation involved in embryonic placenta development	  5	0.77940058892516	1	2	3	6722	7436	0.842534205829863
GO:0060707	trophoblast giant cell differentiation	 10	0.925275888620553	1	3	7	6721	7432	0.631900654372397
GO:0060710	chorio-allantoic fusion	  7	0.919244306193629	1	2	5	6722	7434	0.601810147021331
GO:0060711	labyrinthine layer development	  8	0.113810689204897	0.88413902838582	6	2	6718	7437	1.57975163593099
GO:0060716	labyrinthine layer blood vessel development	 16	0.517377397284026	1	8	8	6716	7431	1.05316775728733
GO:0060732	positive regulation of inositol phosphate biosynthetic process	  5	0.77940058892516	1	2	3	6722	7436	0.842534205829863
GO:0060736	prostate gland growth	  6	0.607836179256654	1	3	3	6721	7436	1.05316775728733
GO:0060740	prostate gland epithelium morphogenesis	  6	0.607836179256654	1	3	3	6721	7436	1.05316775728733
GO:0060749	mammary gland alveolus development	 12	0.899474094191123	1	4	8	6720	7431	0.702111838191553
GO:0060754	positive regulation of mast cell chemotaxis	  5	0.452745275304033	1	3	2	6721	7437	1.26380130874479
GO:0060760	positive regulation of response to cytokine stimulus	  6	0.607836179256654	1	3	3	6721	7436	1.05316775728733
GO:0060761	negative regulation of response to cytokine stimulus	  5	0.960049771736903	1	1	4	6723	7435	0.421267102914932
GO:0060765	regulation of androgen receptor signaling pathway	 10	0.316545776550851	1	6	4	6718	7435	1.26380130874479
GO:0060766	negative regulation of androgen receptor signaling pathway	 11	0.431935112460319	1	6	5	6718	7434	1.14891028067709
GO:0060789	hair follicle placode formation	  6	0.0874151689581943	0.807895728316903	5	1	6719	7438	1.75527959547888
GO:0060828	regulation of canonical Wnt signaling pathway	 23	0.40318807961294	1	12	11	6712	7428	1.09895765977808
GO:0060831	smoothened signaling pathway involved in dorsal/ventral neural tube patterning	  7	0.187210848839696	0.949543953868825	5	2	6719	7437	1.50452536755333
GO:0060836	lymphatic endothelial cell differentiation	  5	0.452745275304033	1	3	2	6721	7437	1.26380130874479
GO:0060840	artery development	  8	0.580280354503036	1	4	4	6720	7435	1.05316775728733
GO:0060850	regulation of transcription involved in cell fate commitment	  5	0.77940058892516	1	2	3	6722	7436	0.842534205829863
GO:0060907	positive regulation of macrophage cytokine production	  5	0.77940058892516	1	2	3	6722	7436	0.842534205829863
GO:0060956	endocardial cell differentiation	  5	0.452745275304033	1	3	2	6721	7437	1.26380130874479
GO:0060964	regulation of gene silencing by miRNA	 55	0.0724622858658453	0.807895728316903	32	23	6692	7416	1.22550429938889
GO:0060972	left/right pattern formation	  7	0.444912401367032	1	4	3	6720	7436	1.20362029404266
GO:0060976	coronary vasculature development	 20	0.497606676879603	1	10	10	6714	7429	1.05316775728733
GO:0060982	coronary artery morphogenesis	  7	0.98898631085553	1	1	6	6723	7433	0.300905073510665
GO:0060992	response to fungicide	  7	0.730029012673872	1	3	4	6721	7435	0.902715220531996
GO:0060993	kidney morphogenesis	  9	0.972243904416257	1	2	7	6722	7432	0.468074558794368
GO:0060996	dendritic spine development	 14	0.160610520833599	0.919686434773344	9	5	6715	7434	1.35407283079799
GO:0060997	dendritic spine morphogenesis	 15	0.623867966210499	1	7	8	6717	7431	0.982956573468174
GO:0060998	regulation of dendritic spine development	  7	0.98898631085553	1	1	6	6723	7433	0.300905073510665
GO:0060999	positive regulation of dendritic spine development	 21	0.86019883501541	1	8	13	6716	7426	0.802413529361774
GO:0061001	regulation of dendritic spine morphogenesis	 14	0.0183006792268162	0.495149842313607	11	3	6713	7436	1.65497790430866
GO:0061002	negative regulation of dendritic spine morphogenesis	  7	0.187210848839696	0.949543953868825	5	2	6719	7437	1.50452536755333
GO:0061003	positive regulation of dendritic spine morphogenesis	 17	0.0471138152487804	0.646585116783694	12	5	6712	7434	1.48682506911152
GO:0061014	positive regulation of mRNA catabolic process	 13	0.643122793005253	1	6	7	6718	7432	0.972154852880611
GO:0061025	membrane fusion	 33	0.0456005431844514	0.646585116783694	21	12	6703	7427	1.3403953274566
GO:0061028	establishment of endothelial barrier	 15	0.623867966210499	1	7	8	6717	7431	0.982956573468174
GO:0061029	eyelid development in camera-type eye	 12	0.971055765853963	1	3	9	6721	7430	0.526583878643665
GO:0061036	positive regulation of cartilage development	 15	0.623867966210499	1	7	8	6717	7431	0.982956573468174
GO:0061037	negative regulation of cartilage development	  7	0.98898631085553	1	1	6	6723	7433	0.300905073510665
GO:0061038	uterus morphogenesis	  5	0.77940058892516	1	2	3	6722	7436	0.842534205829863
GO:0061042	vascular wound healing	  5	0.77940058892516	1	2	3	6722	7436	0.842534205829863
GO:0061045	negative regulation of wound healing	 12	0.320810094151237	1	7	5	6717	7434	1.22869571683522
GO:0061049	cell growth involved in cardiac muscle cell development	  7	0.444912401367032	1	4	3	6720	7436	1.20362029404266
GO:0061051	positive regulation of cell growth involved in cardiac muscle cell development	  7	0.730029012673872	1	3	4	6721	7435	0.902715220531996
GO:0061052	negative regulation of cell growth involved in cardiac muscle cell development	  6	0.297654371351411	1	4	2	6720	7437	1.40422367638311
GO:0061053	somite development	 15	0.914031171019375	1	5	10	6719	7429	0.702111838191553
GO:0061072	iris morphogenesis	  6	0.297654371351411	1	4	2	6720	7437	1.40422367638311
GO:0061077	chaperone-mediated protein folding	 42	0.0425188051553136	0.646585116783694	26	16	6698	7423	1.30392198521288
GO:0061088	regulation of sequestering of zinc ion	  9	0.438074670071218	1	5	4	6719	7435	1.17018639698592
GO:0061098	positive regulation of protein tyrosine kinase activity	 27	0.693189244333171	1	12	15	6712	7424	0.936149117588737
GO:0061099	negative regulation of protein tyrosine kinase activity	 12	0.148657926965624	0.919686434773344	8	4	6716	7435	1.40422367638311
GO:0061136	regulation of proteasomal protein catabolic process	 13	0.426320358160906	1	7	6	6717	7433	1.13418066169405
GO:0061154	endothelial tube morphogenesis	  5	0.452745275304033	1	3	2	6721	7437	1.26380130874479
GO:0061156	pulmonary artery morphogenesis	  5	0.452745275304033	1	3	2	6721	7437	1.26380130874479
GO:0061157	mRNA destabilization	  8	0.113810689204897	0.88413902838582	6	2	6718	7437	1.57975163593099
GO:0061158	3	 11	0.665993939534306	1	5	6	6719	7433	0.957425233897572
GO:0061178	regulation of insulin secretion involved in cellular response to glucose stimulus	 17	0.895242422289557	1	6	11	6718	7428	0.743412534555762
GO:0061179	negative regulation of insulin secretion involved in cellular response to glucose stimulus	  7	0.444912401367032	1	4	3	6720	7436	1.20362029404266
GO:0061180	mammary gland epithelium development	  8	0.952366339066048	1	2	6	6722	7433	0.526583878643665
GO:0061202	clathrin-sculpted gamma-aminobutyric acid transport vesicle membrane	  7	0.0474968970055936	0.646585116783694	6	1	6718	7438	1.80543044106399
GO:0061298	retina vasculature development in camera-type eye	  7	0.730029012673872	1	3	4	6721	7435	0.902715220531996
GO:0061299	retina vasculature morphogenesis in camera-type eye	  7	0.98898631085553	1	1	6	6723	7433	0.300905073510665
GO:0061303	cornea development in camera-type eye	  5	0.77940058892516	1	2	3	6722	7436	0.842534205829863
GO:0061312	BMP signaling pathway involved in heart development	  6	0.979023167332401	1	1	5	6723	7434	0.351055919095776
GO:0061314	Notch signaling involved in heart development	  9	0.69404490204849	1	4	5	6720	7434	0.936149117588737
GO:0061337	cardiac conduction	 41	0.494590306023443	1	20	21	6704	7418	1.02748073881691
GO:0061351	neural precursor cell proliferation	  8	0.819878207576373	1	3	5	6721	7434	0.789875817965497
GO:0061370	testosterone biosynthetic process	  6	0.865182793759413	1	2	4	6722	7435	0.702111838191553
GO:0061371	determination of heart left/right asymmetry	  7	0.919244306193629	1	2	5	6722	7434	0.601810147021331
GO:0061384	heart trabecula morphogenesis	  8	0.819878207576373	1	3	5	6721	7434	0.789875817965497
GO:0061418	regulation of transcription from RNA polymerase II promoter in response to hypoxia	 64	0.681062807539905	1	29	35	6695	7404	0.954433280041642
GO:0061436	establishment of skin barrier	 14	0.956679005412873	1	4	10	6720	7429	0.601810147021331
GO:0061458	reproductive system development	  6	0.607836179256654	1	3	3	6721	7436	1.05316775728733
GO:0061462	protein localization to lysosome	  8	0.819878207576373	1	3	5	6721	7434	0.789875817965497
GO:0061469	regulation of type B pancreatic cell proliferation	  6	0.865182793759413	1	2	4	6722	7435	0.702111838191553
GO:0061512	protein localization to cilium	 15	0.00204077897587989	0.222937212333575	13	2	6711	7437	1.82549077929804
GO:0061549	sympathetic ganglion development	  8	0.580280354503036	1	4	4	6720	7435	1.05316775728733
GO:0061564	axon development	 10	0.983985908365184	1	2	8	6722	7431	0.421267102914932
GO:0061578	Lys63-specific deubiquitinase activity	  8	0.309544448231027	1	5	3	6719	7436	1.31645969660916
GO:0061588	calcium activated phospholipid scrambling	  6	0.607836179256654	1	3	3	6721	7436	1.05316775728733
GO:0061590	calcium activated phosphatidylcholine scrambling	  5	0.77940058892516	1	2	3	6722	7436	0.842534205829863
GO:0061591	calcium activated galactosylceramide scrambling	  5	0.77940058892516	1	2	3	6722	7436	0.842534205829863
GO:0061617	MICOS complex	  6	0.0874151689581943	0.807895728316903	5	1	6719	7438	1.75527959547888
GO:0061621	canonical glycolysis	 22	0.0957434892101259	0.843214701401555	14	8	6710	7431	1.3403953274566
GO:0061624	fructose catabolic process to hydroxyacetone phosphate and glyceraldehyde-3-phosphate	  5	0.960049771736903	1	1	4	6723	7435	0.421267102914932
GO:0061626	pharyngeal arch artery morphogenesis	  6	0.865182793759413	1	2	4	6722	7435	0.702111838191553
GO:0061631	ubiquitin conjugating enzyme activity	 26	0.0508264286032431	0.679607581911819	17	9	6707	7430	1.3772193749142
GO:0061635	regulation of protein complex stability	  6	0.607836179256654	1	3	3	6721	7436	1.05316775728733
GO:0061665	SUMO ligase activity	  5	0.157494903089267	0.919686434773344	4	1	6720	7438	1.68506841165973
GO:0061700	GATOR2 complex	  9	0.206720270758876	0.983668097955673	6	3	6718	7436	1.40422367638311
GO:0061732	mitochondrial acetyl-CoA biosynthetic process from pyruvate	  6	0.0114373555630656	0.427208830906354	6	0	6718	7439	2.10633551457466
GO:0061734	parkin-mediated stimulation of mitophagy in response to mitochondrial depolarization	  5	0.77940058892516	1	2	3	6722	7436	0.842534205829863
GO:0061820	telomeric D-loop disassembly	  6	0.865182793759413	1	2	4	6722	7435	0.702111838191553
GO:0061844	antimicrobial humoral immune response mediated by antimicrobial peptide	 28	0.999759938702898	1	5	23	6719	7416	0.376131341888332
GO:0065004	protein-DNA complex assembly	  5	0.157494903089267	0.919686434773344	4	1	6720	7438	1.68506841165973
GO:0065009	regulation of molecular function	 50	0.0883671818938791	0.807895728316903	29	21	6695	7418	1.2216745984533
GO:0070006	metalloaminopeptidase activity	 18	0.832783288477324	1	7	11	6717	7428	0.819130477890145
GO:0070016	armadillo repeat domain binding	 10	0.133503266897558	0.919686434773344	7	3	6717	7436	1.47443486020226
GO:0070034	telomerase RNA binding	 22	0.325498770721016	1	12	10	6712	7429	1.14891028067709
GO:0070050	neuron cellular homeostasis	  7	0.187210848839696	0.949543953868825	5	2	6719	7437	1.50452536755333
GO:0070059	intrinsic apoptotic signaling pathway in response to endoplasmic reticulum stress	 26	0.973206597001812	1	8	18	6716	7421	0.648103235253741
GO:0070061	fructose binding	  5	0.452745275304033	1	3	2	6721	7437	1.26380130874479
GO:0070063	RNA polymerase binding	 13	0.0975861781940815	0.843214701401555	9	4	6715	7435	1.45823227932092
GO:0070064	proline-rich region binding	 18	0.178063825749389	0.949543953868825	11	7	6713	7432	1.28720503668451
GO:0070072	vacuolar proton-transporting V-type ATPase complex assembly	  9	0.067355898427907	0.780679208284898	7	2	6717	7437	1.63826095578029
GO:0070087	chromo shadow domain binding	  5	0.77940058892516	1	2	3	6722	7436	0.842534205829863
GO:0070097	delta-catenin binding	  5	0.960049771736903	1	1	4	6723	7435	0.421267102914932
GO:0070098	chemokine-mediated signaling pathway	 46	0.999980174802412	1	9	37	6715	7402	0.412109122416781
GO:0070100	negative regulation of chemokine-mediated signaling pathway	  5	0.77940058892516	1	2	3	6722	7436	0.842534205829863
GO:0070102	interleukin-6-mediated signaling pathway	  9	0.206720270758876	0.983668097955673	6	3	6718	7436	1.40422367638311
GO:0070125	mitochondrial translational elongation	 74	0.0018877846824865	0.222937212333575	48	26	6676	7413	1.36627168512951
GO:0070126	mitochondrial translational termination	 75	0.00284713425586595	0.244538441062453	48	27	6676	7412	1.34805472932778
GO:0070129	regulation of mitochondrial translation	  6	0.0874151689581943	0.807895728316903	5	1	6719	7438	1.75527959547888
GO:0070131	positive regulation of mitochondrial translation	  9	0.067355898427907	0.780679208284898	7	2	6717	7437	1.63826095578029
GO:0070166	enamel mineralization	 10	0.925275888620553	1	3	7	6721	7432	0.631900654372397
GO:0070181	small ribosomal subunit rRNA binding	  7	0.0474968970055936	0.646585116783694	6	1	6718	7438	1.80543044106399
GO:0070182	DNA polymerase binding	 14	0.529251719099727	1	7	7	6717	7432	1.05316775728733
GO:0070187	shelterin complex	  7	0.730029012673872	1	3	4	6721	7435	0.902715220531996
GO:0070197	meiotic attachment of telomere to nuclear envelope	  5	0.77940058892516	1	2	3	6722	7436	0.842534205829863
GO:0070198	protein localization to chromosome, telomeric region	 10	0.316545776550851	1	6	4	6718	7435	1.26380130874479
GO:0070200	establishment of protein localization to telomere	  5	0.77940058892516	1	2	3	6722	7436	0.842534205829863
GO:0070201	regulation of establishment of protein localization	  6	0.297654371351411	1	4	2	6720	7437	1.40422367638311
GO:0070206	protein trimerization	  6	0.865182793759413	1	2	4	6722	7435	0.702111838191553
GO:0070207	protein homotrimerization	 21	0.57968055192832	1	10	11	6714	7428	1.00301691170222
GO:0070208	protein heterotrimerization	 12	0.320810094151237	1	7	5	6717	7434	1.22869571683522
GO:0070231	T cell apoptotic process	  5	0.77940058892516	1	2	3	6722	7436	0.842534205829863
GO:0070242	thymocyte apoptotic process	  5	0.77940058892516	1	2	3	6722	7436	0.842534205829863
GO:0070244	negative regulation of thymocyte apoptotic process	  5	0.77940058892516	1	2	3	6722	7436	0.842534205829863
GO:0070245	positive regulation of thymocyte apoptotic process	  6	0.979023167332401	1	1	5	6723	7434	0.351055919095776
GO:0070257	positive regulation of mucus secretion	  5	0.77940058892516	1	2	3	6722	7436	0.842534205829863
GO:0070262	peptidyl-serine dephosphorylation	  8	0.113810689204897	0.88413902838582	6	2	6718	7437	1.57975163593099
GO:0070266	necroptotic process	 16	0.517377397284026	1	8	8	6716	7431	1.05316775728733
GO:0070268	cornification	 65	0.999999990338999	1	10	55	6714	7384	0.32405161762687
GO:0070273	phosphatidylinositol-4-phosphate binding	 17	0.243621618961318	1	10	7	6714	7432	1.23902089092627
GO:0070286	axonemal dynein complex assembly	  7	0.919244306193629	1	2	5	6722	7434	0.601810147021331
GO:0070290	N-acylphosphatidylethanolamine-specific phospholipase D activity	  5	0.452745275304033	1	3	2	6721	7437	1.26380130874479
GO:0070300	phosphatidic acid binding	 17	0.607264962167558	1	8	9	6716	7430	0.991216712741015
GO:0070301	cellular response to hydrogen peroxide	 56	0.303565338744358	1	29	27	6695	7412	1.09078089147616
GO:0070306	lens fiber cell differentiation	 13	0.643122793005253	1	6	7	6718	7432	0.972154852880611
GO:0070307	lens fiber cell development	  7	0.919244306193629	1	2	5	6722	7434	0.601810147021331
GO:0070324	thyroid hormone binding	  7	0.444912401367032	1	4	3	6720	7436	1.20362029404266
GO:0070327	thyroid hormone transport	  6	0.979023167332401	1	1	5	6723	7434	0.351055919095776
GO:0070328	triglyceride homeostasis	 16	0.996207313649143	1	3	13	6721	7426	0.394937908982748
GO:0070330	aromatase activity	 14	0.875453509540804	1	5	9	6719	7430	0.752262683776664
GO:0070345	negative regulation of fat cell proliferation	  5	0.960049771736903	1	1	4	6723	7435	0.421267102914932
GO:0070365	hepatocyte differentiation	  9	0.972243904416257	1	2	7	6722	7432	0.468074558794368
GO:0070371	ERK1 and ERK2 cascade	 21	0.937043249703464	1	7	14	6717	7425	0.702111838191553
GO:0070372	regulation of ERK1 and ERK2 cascade	 22	0.896697486794484	1	8	14	6716	7425	0.765940187118057
GO:0070373	negative regulation of ERK1 and ERK2 cascade	 52	0.409844864613595	1	26	26	6698	7413	1.05316775728733
GO:0070382	exocytic vesicle	 13	0.426320358160906	1	7	6	6717	7433	1.13418066169405
GO:0070389	chaperone cofactor-dependent protein refolding	  7	0.730029012673872	1	3	4	6721	7435	0.902715220531996
GO:0070402	NADPH binding	 13	0.426320358160906	1	7	6	6717	7433	1.13418066169405
GO:0070403	NAD+ binding	 12	0.148657926965624	0.919686434773344	8	4	6716	7435	1.40422367638311
GO:0070410	co-SMAD binding	 11	0.0838548499097086	0.807895728316903	8	3	6716	7436	1.53188037423611
GO:0070411	I-SMAD binding	 10	0.559603563591584	1	5	5	6719	7434	1.05316775728733
GO:0070412	R-SMAD binding	 21	0.25155850170495	1	12	9	6712	7430	1.20362029404266
GO:0070417	cellular response to cold	  7	0.444912401367032	1	4	3	6720	7436	1.20362029404266
GO:0070419	nonhomologous end joining complex	  7	0.187210848839696	0.949543953868825	5	2	6719	7437	1.50452536755333
GO:0070423	nucleotide-binding oligomerization domain containing signaling pathway	 21	0.25155850170495	1	12	9	6712	7430	1.20362029404266
GO:0070431	nucleotide-binding oligomerization domain containing 2 signaling pathway	  5	0.960049771736903	1	1	4	6723	7435	0.421267102914932
GO:0070445	regulation of oligodendrocyte progenitor proliferation	  5	0.77940058892516	1	2	3	6722	7436	0.842534205829863
GO:0070461	SAGA-type complex	  6	0.865182793759413	1	2	4	6722	7435	0.702111838191553
GO:0070469	respiratory chain	 41	0.000739893674866621	0.147264354873453	30	11	6694	7428	1.54122110822536
GO:0070474	positive regulation of uterine smooth muscle contraction	  7	0.919244306193629	1	2	5	6722	7434	0.601810147021331
GO:0070491	repressing transcription factor binding	 30	0.461375405343472	1	15	15	6709	7424	1.05316775728733
GO:0070492	oligosaccharide binding	  6	0.865182793759413	1	2	4	6722	7435	0.702111838191553
GO:0070493	thrombin-activated receptor signaling pathway	  5	0.157494903089267	0.919686434773344	4	1	6720	7438	1.68506841165973
GO:0070498	interleukin-1-mediated signaling pathway	 14	0.956679005412873	1	4	10	6720	7429	0.601810147021331
GO:0070507	regulation of microtubule cytoskeleton organization	 16	0.706693964264422	1	7	9	6717	7430	0.921521787626413
GO:0070508	cholesterol import	  5	0.960049771736903	1	1	4	6723	7435	0.421267102914932
GO:0070509	calcium ion import	 16	0.324860333233664	1	9	7	6715	7432	1.18481372694825
GO:0070513	death domain binding	  5	0.960049771736903	1	1	4	6723	7435	0.421267102914932
GO:0070527	platelet aggregation	 35	0.854689987251871	1	14	21	6710	7418	0.842534205829863
GO:0070528	protein kinase C signaling	 11	0.850917330440019	1	4	7	6720	7432	0.765940187118057
GO:0070530	K63-linked polyubiquitin modification-dependent protein binding	 17	0.243621618961318	1	10	7	6714	7432	1.23902089092627
GO:0070531	BRCA1-A complex	  6	0.0874151689581943	0.807895728316903	5	1	6719	7438	1.75527959547888
GO:0070534	protein K63-linked ubiquitination	 31	0.0865415017620523	0.807895728316903	19	12	6705	7427	1.2909798315135
GO:0070536	protein K63-linked deubiquitination	 21	0.023100093034779	0.495149842313607	15	6	6709	7433	1.50452536755333
GO:0070542	response to fatty acid	 14	0.875453509540804	1	5	9	6719	7430	0.752262683776664
GO:0070544	histone H3-K36 demethylation	  9	0.438074670071218	1	5	4	6719	7435	1.17018639698592
GO:0070555	response to interleukin-1	 32	0.905424112434511	1	12	20	6712	7419	0.789875817965497
GO:0070577	lysine-acetylated histone binding	 16	0.0242540767935066	0.495149842313607	12	4	6712	7435	1.57975163593099
GO:0070578	RISC-loading complex	  7	0.0474968970055936	0.646585116783694	6	1	6718	7438	1.80543044106399
GO:0070584	mitochondrion morphogenesis	 20	0.0117131731557092	0.427208830906354	15	5	6709	7434	1.57975163593099
GO:0070585	protein localization to mitochondrion	  6	0.297654371351411	1	4	2	6720	7437	1.40422367638311
GO:0070603	SWI/SNF superfamily-type complex	 16	0.324860333233664	1	9	7	6715	7432	1.18481372694825
GO:0070613	regulation of protein processing	  8	0.309544448231027	1	5	3	6719	7436	1.31645969660916
GO:0070628	proteasome binding	 10	0.316545776550851	1	6	4	6718	7435	1.26380130874479
GO:0070652	HAUS complex	  6	0.865182793759413	1	2	4	6722	7435	0.702111838191553
GO:0070670	response to interleukin-4	  5	0.157494903089267	0.919686434773344	4	1	6720	7438	1.68506841165973
GO:0070679	inositol 1,4,5 trisphosphate binding	  7	0.730029012673872	1	3	4	6721	7435	0.902715220531996
GO:0070695	FHF complex	  5	0.157494903089267	0.919686434773344	4	1	6720	7438	1.68506841165973
GO:0070700	BMP receptor binding	  8	0.994217735396885	1	1	7	6723	7432	0.263291939321832
GO:0070723	response to cholesterol	  7	0.98898631085553	1	1	6	6723	7433	0.300905073510665
GO:0070728	leucine binding	  5	0.0241003244622537	0.495149842313607	5	0	6719	7439	2.10633551457466
GO:0070740	tubulin-glutamic acid ligase activity	  7	0.187210848839696	0.949543953868825	5	2	6719	7437	1.50452536755333
GO:0070742	C2H2 zinc finger domain binding	 13	0.426320358160906	1	7	6	6717	7433	1.13418066169405
GO:0070765	gamma-secretase complex	  5	0.157494903089267	0.919686434773344	4	1	6720	7438	1.68506841165973
GO:0070776	MOZ/MORF histone acetyltransferase complex	  7	0.0474968970055936	0.646585116783694	6	1	6718	7438	1.80543044106399
GO:0070816	phosphorylation of RNA polymerase II C-terminal domain	  5	0.0241003244622537	0.495149842313607	5	0	6719	7439	2.10633551457466
GO:0070821	tertiary granule membrane	 60	0.779983763879623	1	26	34	6698	7405	0.912745389649018
GO:0070830	bicellular tight junction assembly	 26	0.474259103737385	1	13	13	6711	7426	1.05316775728733
GO:0070840	dynein complex binding	 20	0.0888797275608513	0.807895728316903	13	7	6711	7432	1.36911808447353
GO:0070847	core mediator complex	  6	0.297654371351411	1	4	2	6720	7437	1.40422367638311
GO:0070848	response to growth factor	 12	0.75380380293781	1	5	7	6719	7432	0.877639797739441
GO:0070852	cell body fiber	  7	0.919244306193629	1	2	5	6722	7434	0.601810147021331
GO:0070863	positive regulation of protein exit from endoplasmic reticulum	  5	0.452745275304033	1	3	2	6721	7437	1.26380130874479
GO:0070878	primary miRNA binding	  6	0.297654371351411	1	4	2	6720	7437	1.40422367638311
GO:0070883	pre-miRNA binding	  5	0.452745275304033	1	3	2	6721	7437	1.26380130874479
GO:0070886	positive regulation of calcineurin-NFAT signaling cascade	  9	0.438074670071218	1	5	4	6719	7435	1.17018639698592
GO:0070888	E-box binding	 30	0.998255623767406	1	7	23	6717	7416	0.491478286734087
GO:0070911	global genome nucleotide-excision repair	 29	0.00572559653094272	0.335064747230886	21	8	6703	7431	1.52527744158855
GO:0070914	UV-damage excision repair	 11	0.0221890923454724	0.495149842313607	9	2	6715	7437	1.72336542101563
GO:0070932	histone H3 deacetylation	 18	0.325568860476231	1	10	8	6714	7431	1.17018639698592
GO:0070933	histone H4 deacetylation	  9	0.206720270758876	0.983668097955673	6	3	6718	7436	1.40422367638311
GO:0070935	3	 11	0.220387996626296	1	7	4	6717	7435	1.3403953274566
GO:0070936	protein K48-linked ubiquitination	 43	8.47614399736656e-05	0.0543603368364442	33	10	6691	7429	1.61649004606892
GO:0070938	contractile ring	  5	0.452745275304033	1	3	2	6721	7437	1.26380130874479
GO:0070940	dephosphorylation of RNA polymerase II C-terminal domain	  5	0.452745275304033	1	3	2	6721	7437	1.26380130874479
GO:0070971	endoplasmic reticulum exit site	 12	0.0018650784524541	0.222937212333575	11	1	6713	7438	1.93080755502677
GO:0070972	protein localization to endoplasmic reticulum	  6	0.865182793759413	1	2	4	6722	7435	0.702111838191553
GO:0070979	protein K11-linked ubiquitination	 23	0.0272148481462567	0.518429384489088	16	7	6708	7432	1.46527687970411
GO:0070986	left/right axis specification	 11	0.431935112460319	1	6	5	6718	7434	1.14891028067709
GO:0070987	error-free translesion synthesis	 18	0.0300950583180779	0.549711001936538	13	5	6711	7434	1.5212423160817
GO:0070989	oxidative demethylation	  8	0.952366339066048	1	2	6	6722	7433	0.526583878643665
GO:0070997	neuron death	 10	0.133503266897558	0.919686434773344	7	3	6717	7436	1.47443486020226
GO:0071004	U2-type prespliceosome	 15	0.0106614103540833	0.427208830906354	12	3	6712	7436	1.68506841165973
GO:0071011	precatalytic spliceosome	 26	0.62841636814953	1	12	14	6712	7425	0.972154852880611
GO:0071013	catalytic step 2 spliceosome	 87	0.0911102159426685	0.825570119970302	48	39	6676	7400	1.16211614597223
GO:0071014	post-mRNA release spliceosomal complex	  5	0.77940058892516	1	2	3	6722	7436	0.842534205829863
GO:0071028	nuclear mRNA surveillance	  9	0.206720270758876	0.983668097955673	6	3	6718	7436	1.40422367638311
GO:0071035	nuclear polyadenylation-dependent rRNA catabolic process	  6	0.0874151689581943	0.807895728316903	5	1	6719	7438	1.75527959547888
GO:0071038	nuclear polyadenylation-dependent tRNA catabolic process	  5	0.157494903089267	0.919686434773344	4	1	6720	7438	1.68506841165973
GO:0071044	histone mRNA catabolic process	  9	0.206720270758876	0.983668097955673	6	3	6718	7436	1.40422367638311
GO:0071051	polyadenylation-dependent snoRNA 3	  5	0.157494903089267	0.919686434773344	4	1	6720	7438	1.68506841165973
GO:0071108	protein K48-linked deubiquitination	 25	0.031210609259391	0.552600112408603	17	8	6707	7431	1.43230814991077
GO:0071141	SMAD protein complex	  7	0.444912401367032	1	4	3	6720	7436	1.20362029404266
GO:0071157	negative regulation of cell cycle arrest	 17	0.895242422289557	1	6	11	6718	7428	0.743412534555762
GO:0071158	positive regulation of cell cycle arrest	 23	0.843995637843635	1	9	14	6715	7425	0.824218244833562
GO:0071168	protein localization to chromatin	  8	0.580280354503036	1	4	4	6720	7435	1.05316775728733
GO:0071169	establishment of protein localization to chromatin	  6	0.865182793759413	1	2	4	6722	7435	0.702111838191553
GO:0071203	WASH complex	  7	0.187210848839696	0.949543953868825	5	2	6719	7437	1.50452536755333
GO:0071204	histone pre-mRNA 3	  5	0.0241003244622537	0.495149842313607	5	0	6719	7439	2.10633551457466
GO:0071205	protein localization to juxtaparanode region of axon	  5	0.157494903089267	0.919686434773344	4	1	6720	7438	1.68506841165973
GO:0071218	cellular response to misfolded protein	  5	0.77940058892516	1	2	3	6722	7436	0.842534205829863
GO:0071219	cellular response to molecule of bacterial origin	  6	1	1	0	6	6724	7433	0
GO:0071223	cellular response to lipoteichoic acid	 10	0.925275888620553	1	3	7	6721	7432	0.631900654372397
GO:0071230	cellular response to amino acid stimulus	 47	0.0350149282652975	0.599479186247127	29	18	6695	7421	1.29965382814181
GO:0071233	cellular response to leucine	  7	0.0474968970055936	0.646585116783694	6	1	6718	7438	1.80543044106399
GO:0071236	cellular response to antibiotic	  8	0.819878207576373	1	3	5	6721	7434	0.789875817965497
GO:0071243	cellular response to arsenic-containing substance	  9	0.206720270758876	0.983668097955673	6	3	6718	7436	1.40422367638311
GO:0071248	cellular response to metal ion	  5	0.960049771736903	1	1	4	6723	7435	0.421267102914932
GO:0071253	connexin binding	  7	0.919244306193629	1	2	5	6722	7434	0.601810147021331
GO:0071257	cellular response to electrical stimulus	 12	0.75380380293781	1	5	7	6719	7432	0.877639797739441
GO:0071260	cellular response to mechanical stimulus	 66	0.974307531842255	1	24	42	6700	7397	0.765940187118057
GO:0071276	cellular response to cadmium ion	 28	0.323270654016595	1	15	13	6709	7426	1.128394025665
GO:0071277	cellular response to calcium ion	 52	0.812175933345065	1	22	30	6702	7409	0.891141948473894
GO:0071280	cellular response to copper ion	 11	0.431935112460319	1	6	5	6718	7434	1.14891028067709
GO:0071281	cellular response to iron ion	  6	0.607836179256654	1	3	3	6721	7436	1.05316775728733
GO:0071285	cellular response to lithium ion	 10	0.925275888620553	1	3	7	6721	7432	0.631900654372397
GO:0071286	cellular response to magnesium ion	  5	0.77940058892516	1	2	3	6722	7436	0.842534205829863
GO:0071294	cellular response to zinc ion	 14	0.956679005412873	1	4	10	6720	7429	0.601810147021331
GO:0071300	cellular response to retinoic acid	 61	0.998628599924314	1	18	43	6706	7396	0.621541627251538
GO:0071305	cellular response to vitamin D	  8	0.819878207576373	1	3	5	6721	7434	0.789875817965497
GO:0071310	cellular response to organic substance	 32	0.829842015444451	1	13	19	6711	7420	0.855698802795955
GO:0071312	cellular response to alkaloid	  6	0.297654371351411	1	4	2	6720	7437	1.40422367638311
GO:0071313	cellular response to caffeine	  7	0.919244306193629	1	2	5	6722	7434	0.601810147021331
GO:0071316	cellular response to nicotine	  7	1	1	0	7	6724	7432	0
GO:0071318	cellular response to ATP	 11	0.431935112460319	1	6	5	6718	7434	1.14891028067709
GO:0071320	cellular response to cAMP	 43	0.884807792585161	1	17	26	6707	7413	0.832737296459748
GO:0071321	cellular response to cGMP	  6	0.607836179256654	1	3	3	6721	7436	1.05316775728733
GO:0071333	cellular response to glucose stimulus	 47	0.86797491029657	1	19	28	6705	7411	0.851497335679117
GO:0071339	MLL1 complex	 25	0.14581109956432	0.919686434773344	15	10	6709	7429	1.26380130874479
GO:0071340	skeletal muscle acetylcholine-gated channel clustering	  8	0.309544448231027	1	5	3	6719	7436	1.31645969660916
GO:0071345	cellular response to cytokine stimulus	 24	0.780026211443039	1	10	14	6714	7425	0.877639797739441
GO:0071346	cellular response to interferon-gamma	 40	0.999924891888554	1	8	32	6716	7407	0.421267102914932
GO:0071347	cellular response to interleukin-1	 51	0.999883028288036	1	12	39	6712	7400	0.495608356370508
GO:0071353	cellular response to interleukin-4	 17	0.776294265732228	1	7	10	6717	7429	0.867314623648389
GO:0071354	cellular response to interleukin-6	 14	0.998346203775137	1	2	12	6722	7427	0.300905073510665
GO:0071356	cellular response to tumor necrosis factor	 90	0.995524714529527	1	31	59	6693	7380	0.725515566131271
GO:0071359	cellular response to dsRNA	  6	0.865182793759413	1	2	4	6722	7435	0.702111838191553
GO:0071360	cellular response to exogenous dsRNA	 14	0.875453509540804	1	5	9	6719	7430	0.752262683776664
GO:0071361	cellular response to ethanol	 12	0.971055765853963	1	3	9	6721	7430	0.526583878643665
GO:0071363	cellular response to growth factor stimulus	 53	0.46205780999747	1	26	27	6698	7412	1.03329666752719
GO:0071364	cellular response to epidermal growth factor stimulus	 36	0.318430467659902	1	19	17	6705	7422	1.11167707713663
GO:0071372	cellular response to follicle-stimulating hormone stimulus	 10	0.559603563591584	1	5	5	6719	7434	1.05316775728733
GO:0071374	cellular response to parathyroid hormone stimulus	  8	0.819878207576373	1	3	5	6721	7434	0.789875817965497
GO:0071375	cellular response to peptide hormone stimulus	 17	0.607264962167558	1	8	9	6716	7430	0.991216712741015
GO:0071377	cellular response to glucagon stimulus	 34	0.895363043887139	1	13	21	6711	7418	0.805363579102075
GO:0071380	cellular response to prostaglandin E stimulus	 18	0.687525801418504	1	8	10	6716	7429	0.936149117588737
GO:0071383	cellular response to steroid hormone stimulus	 11	0.0838548499097086	0.807895728316903	8	3	6716	7436	1.53188037423611
GO:0071385	cellular response to glucocorticoid stimulus	 16	0.94165410331218	1	5	11	6719	7428	0.658229848304581
GO:0071391	cellular response to estrogen stimulus	 12	0.75380380293781	1	5	7	6719	7432	0.877639797739441
GO:0071392	cellular response to estradiol stimulus	 30	0.204303825928321	0.983668097955673	17	13	6707	7426	1.19359012492564
GO:0071394	cellular response to testosterone stimulus	  7	0.444912401367032	1	4	3	6720	7436	1.20362029404266
GO:0071396	cellular response to lipid	  5	0.452745275304033	1	3	2	6721	7437	1.26380130874479
GO:0071397	cellular response to cholesterol	 11	0.665993939534306	1	5	6	6719	7433	0.957425233897572
GO:0071398	cellular response to fatty acid	 16	0.982365044000861	1	4	12	6720	7427	0.526583878643665
GO:0071404	cellular response to low-density lipoprotein particle stimulus	 10	0.983985908365184	1	2	8	6722	7431	0.421267102914932
GO:0071407	cellular response to organic cyclic compound	 69	0.987994008647195	1	24	45	6700	7394	0.732638439852055
GO:0071420	cellular response to histamine	  7	0.444912401367032	1	4	3	6720	7436	1.20362029404266
GO:0071421	manganese ion transmembrane transport	  5	0.452745275304033	1	3	2	6721	7437	1.26380130874479
GO:0071425	hematopoietic stem cell proliferation	 15	0.237875362689918	1	9	6	6715	7433	1.26380130874479
GO:0071435	potassium ion export	  5	0.77940058892516	1	2	3	6722	7436	0.842534205829863
GO:0071437	invadopodium	  9	0.69404490204849	1	4	5	6720	7434	0.936149117588737
GO:0071439	clathrin complex	  9	0.067355898427907	0.780679208284898	7	2	6717	7437	1.63826095578029
GO:0071447	cellular response to hydroperoxide	  7	0.98898631085553	1	1	6	6723	7433	0.300905073510665
GO:0071455	cellular response to hyperoxia	  7	0.919244306193629	1	2	5	6722	7434	0.601810147021331
GO:0071456	cellular response to hypoxia	 99	0.999637846099211	1	31	68	6693	7371	0.659559605573883
GO:0071458	integral component of cytoplasmic side of endoplasmic reticulum membrane	  6	0.0874151689581943	0.807895728316903	5	1	6719	7438	1.75527959547888
GO:0071467	cellular response to pH	  6	0.865182793759413	1	2	4	6722	7435	0.702111838191553
GO:0071468	cellular response to acidic pH	  7	0.730029012673872	1	3	4	6721	7435	0.902715220531996
GO:0071470	cellular response to osmotic stress	  6	0.865182793759413	1	2	4	6722	7435	0.702111838191553
GO:0071474	cellular hyperosmotic response	  7	0.919244306193629	1	2	5	6722	7434	0.601810147021331
GO:0071476	cellular hypotonic response	  6	0.297654371351411	1	4	2	6720	7437	1.40422367638311
GO:0071479	cellular response to ionizing radiation	 27	0.0350589432775214	0.599479186247127	18	9	6706	7430	1.40422367638311
GO:0071480	cellular response to gamma radiation	 22	0.489152057931013	1	11	11	6713	7428	1.05316775728733
GO:0071481	cellular response to X-ray	 10	0.316545776550851	1	6	4	6718	7435	1.26380130874479
GO:0071493	cellular response to UV-B	  5	0.960049771736903	1	1	4	6723	7435	0.421267102914932
GO:0071498	cellular response to fluid shear stress	 11	0.850917330440019	1	4	7	6720	7432	0.765940187118057
GO:0071499	cellular response to laminar fluid shear stress	  7	0.730029012673872	1	3	4	6721	7435	0.902715220531996
GO:0071526	semaphorin-plexin signaling pathway	 20	0.184541691833438	0.949543953868825	12	8	6712	7431	1.26380130874479
GO:0071532	ankyrin repeat binding	  5	1	1	0	5	6724	7434	0
GO:0071539	protein localization to centrosome	 16	0.517377397284026	1	8	8	6716	7431	1.05316775728733
GO:0071541	eukaryotic translation initiation factor 3 complex, eIF3m	  6	0.607836179256654	1	3	3	6721	7436	1.05316775728733
GO:0071542	dopaminergic neuron differentiation	 17	0.960992303738273	1	5	12	6719	7427	0.619510445463135
GO:0071548	response to dexamethasone	  8	0.952366339066048	1	2	6	6722	7433	0.526583878643665
GO:0071549	cellular response to dexamethasone stimulus	 30	0.605736885713723	1	14	16	6710	7423	0.982956573468174
GO:0071550	death-inducing signaling complex assembly	  8	0.994217735396885	1	1	7	6723	7432	0.263291939321832
GO:0071556	integral component of lumenal side of endoplasmic reticulum membrane	 19	0.592680980401227	1	9	10	6715	7429	0.997737875324838
GO:0071557	histone H3-K27 demethylation	  5	0.960049771736903	1	1	4	6723	7435	0.421267102914932
GO:0071558	histone demethylase activity (H3-K27 specific)	  5	0.960049771736903	1	1	4	6723	7435	0.421267102914932
GO:0071559	response to transforming growth factor beta	  8	0.309544448231027	1	5	3	6719	7436	1.31645969660916
GO:0071560	cellular response to transforming growth factor beta stimulus	 49	0.785353009460058	1	21	28	6703	7411	0.902715220531996
GO:0071564	npBAF complex	 12	0.320810094151237	1	7	5	6717	7434	1.22869571683522
GO:0071565	nBAF complex	 14	0.160610520833599	0.919686434773344	9	5	6715	7434	1.35407283079799
GO:0071577	zinc II ion transmembrane transport	 17	0.416253886790052	1	9	8	6715	7431	1.11511880183364
GO:0071578	zinc II ion transmembrane import	  6	0.607836179256654	1	3	3	6721	7436	1.05316775728733
GO:0071599	otic vesicle development	  5	0.77940058892516	1	2	3	6722	7436	0.842534205829863
GO:0071625	vocalization behavior	 14	0.875453509540804	1	5	9	6719	7430	0.752262683776664
GO:0071636	positive regulation of transforming growth factor beta production	  6	0.865182793759413	1	2	4	6722	7435	0.702111838191553
GO:0071638	negative regulation of monocyte chemotactic protein-1 production	  5	0.77940058892516	1	2	3	6722	7436	0.842534205829863
GO:0071679	commissural neuron axon guidance	  8	0.580280354503036	1	4	4	6720	7435	1.05316775728733
GO:0071682	endocytic vesicle lumen	 12	0.75380380293781	1	5	7	6719	7432	0.877639797739441
GO:0071688	striated muscle myosin thick filament assembly	  8	0.819878207576373	1	3	5	6721	7434	0.789875817965497
GO:0071704	organic substance metabolic process	  5	0.452745275304033	1	3	2	6721	7437	1.26380130874479
GO:0071711	basement membrane organization	  9	0.882794860340315	1	3	6	6721	7433	0.702111838191553
GO:0071712	ER-associated misfolded protein catabolic process	 10	0.133503266897558	0.919686434773344	7	3	6717	7436	1.47443486020226
GO:0071723	lipopeptide binding	  8	0.994217735396885	1	1	7	6723	7432	0.263291939321832
GO:0071732	cellular response to nitric oxide	 13	0.230372725000093	1	8	5	6716	7434	1.29620647050748
GO:0071773	cellular response to BMP stimulus	 28	0.966852873120196	1	9	19	6715	7420	0.677036415398997
GO:0071782	endoplasmic reticulum tubular network	 11	0.0838548499097086	0.807895728316903	8	3	6716	7436	1.53188037423611
GO:0071786	endoplasmic reticulum tubular network organization	  7	0.187210848839696	0.949543953868825	5	2	6719	7437	1.50452536755333
GO:0071787	endoplasmic reticulum tubular network formation	  5	0.157494903089267	0.919686434773344	4	1	6720	7438	1.68506841165973
GO:0071799	cellular response to prostaglandin D stimulus	  5	1	1	0	5	6724	7434	0
GO:0071803	positive regulation of podosome assembly	  9	0.69404490204849	1	4	5	6720	7434	0.936149117588737
GO:0071806	protein transmembrane transport	  6	0.607836179256654	1	3	3	6721	7436	1.05316775728733
GO:0071813	lipoprotein particle binding	  5	0.960049771736903	1	1	4	6723	7435	0.421267102914932
GO:0071817	MMXD complex	  5	0.157494903089267	0.919686434773344	4	1	6720	7438	1.68506841165973
GO:0071837	HMG box domain binding	 14	0.98932697223781	1	3	11	6721	7428	0.451357610265998
GO:0071850	mitotic cell cycle arrest	 13	0.0975861781940815	0.843214701401555	9	4	6715	7435	1.45823227932092
GO:0071870	cellular response to catecholamine stimulus	  7	0.187210848839696	0.949543953868825	5	2	6719	7437	1.50452536755333
GO:0071872	cellular response to epinephrine stimulus	 12	0.320810094151237	1	7	5	6717	7434	1.22869571683522
GO:0071875	adrenergic receptor signaling pathway	  7	0.98898631085553	1	1	6	6723	7433	0.300905073510665
GO:0071880	adenylate cyclase-activating adrenergic receptor signaling pathway	 12	0.994792086314609	1	2	10	6722	7429	0.351055919095776
GO:0071889	14-3-3 protein binding	 22	0.325498770721016	1	12	10	6712	7429	1.14891028067709
GO:0071897	DNA biosynthetic process	 28	0.467605035218744	1	14	14	6710	7425	1.05316775728733
GO:0071901	negative regulation of protein serine/threonine kinase activity	 24	0.882377293683992	1	9	15	6715	7424	0.789875817965497
GO:0071902	positive regulation of protein serine/threonine kinase activity	 35	0.514569683557429	1	17	18	6707	7421	1.02307724993626
GO:0071910	determination of liver left/right asymmetry	  5	0.452745275304033	1	3	2	6721	7437	1.26380130874479
GO:0071933	Arp2/3 complex binding	  8	0.309544448231027	1	5	3	6719	7436	1.31645969660916
GO:0071944	cell periphery	 49	0.859722651784109	1	20	29	6704	7410	0.859728781459044
GO:0071949	FAD binding	 21	0.0609416617953418	0.764685373658072	14	7	6710	7432	1.40422367638311
GO:0071985	multivesicular body sorting pathway	 10	0.0390070262266277	0.625040317669623	8	2	6716	7437	1.68506841165973
GO:0071986	Ragulator complex	  6	0.0874151689581943	0.807895728316903	5	1	6719	7438	1.75527959547888
GO:0072001	renal system development	 21	0.738560418161868	1	9	12	6715	7427	0.902715220531996
GO:0072006	nephron development	  7	0.919244306193629	1	2	5	6722	7434	0.601810147021331
GO:0072015	glomerular visceral epithelial cell development	  8	0.819878207576373	1	3	5	6721	7434	0.789875817965497
GO:0072075	metanephric mesenchyme development	  7	0.98898631085553	1	1	6	6723	7433	0.300905073510665
GO:0072089	stem cell proliferation	  9	0.882794860340315	1	3	6	6721	7433	0.702111838191553
GO:0072091	regulation of stem cell proliferation	  8	0.309544448231027	1	5	3	6719	7436	1.31645969660916
GO:0072112	glomerular visceral epithelial cell differentiation	  5	0.960049771736903	1	1	4	6723	7435	0.421267102914932
GO:0072164	mesonephric tubule development	  6	0.979023167332401	1	1	5	6723	7434	0.351055919095776
GO:0072177	mesonephric duct development	  5	0.960049771736903	1	1	4	6723	7435	0.421267102914932
GO:0072189	ureter development	  5	0.452745275304033	1	3	2	6721	7437	1.26380130874479
GO:0072201	negative regulation of mesenchymal cell proliferation	  6	0.865182793759413	1	2	4	6722	7435	0.702111838191553
GO:0072205	metanephric collecting duct development	  7	0.98898631085553	1	1	6	6723	7433	0.300905073510665
GO:0072307	regulation of metanephric nephron tubule epithelial cell differentiation	  5	0.960049771736903	1	1	4	6723	7435	0.421267102914932
GO:0072321	chaperone-mediated protein transport	  6	0.297654371351411	1	4	2	6720	7437	1.40422367638311
GO:0072332	intrinsic apoptotic signaling pathway by p53 class mediator	 28	0.616649478927714	1	13	15	6711	7424	0.977941488909663
GO:0072357	PTW/PP1 phosphatase complex	  7	0.444912401367032	1	4	3	6720	7436	1.20362029404266
GO:0072358	cardiovascular system development	 13	0.643122793005253	1	6	7	6718	7432	0.972154852880611
GO:0072383	plus-end-directed vesicle transport along microtubule	  7	0.0474968970055936	0.646585116783694	6	1	6718	7438	1.80543044106399
GO:0072384	organelle transport along microtubule	  5	0.157494903089267	0.919686434773344	4	1	6720	7438	1.68506841165973
GO:0072488	ammonium transmembrane transport	  9	0.996964464269463	1	1	8	6723	7431	0.234037279397184
GO:0072498	embryonic skeletal joint development	  5	0.960049771736903	1	1	4	6723	7435	0.421267102914932
GO:0072520	seminiferous tubule development	  8	0.309544448231027	1	5	3	6719	7436	1.31645969660916
GO:0072540	T-helper 17 cell lineage commitment	  5	0.960049771736903	1	1	4	6723	7435	0.421267102914932
GO:0072546	ER membrane protein complex	  9	0.206720270758876	0.983668097955673	6	3	6718	7436	1.40422367638311
GO:0072559	NLRP3 inflammasome complex	  6	1	1	0	6	6724	7433	0
GO:0072562	blood microparticle	 85	0.999995579006157	1	21	64	6703	7375	0.520388774189033
GO:0072577	endothelial cell apoptotic process	  7	0.444912401367032	1	4	3	6720	7436	1.20362029404266
GO:0072583	clathrin-dependent endocytosis	 22	0.00101061986321803	0.165233002219546	18	4	6706	7435	1.72336542101563
GO:0072584	caveolin-mediated endocytosis	  5	0.960049771736903	1	1	4	6723	7435	0.421267102914932
GO:0072593	reactive oxygen species metabolic process	 31	0.26026101790379	1	17	14	6707	7425	1.15508721766997
GO:0072655	establishment of protein localization to mitochondrion	  5	0.77940058892516	1	2	3	6722	7436	0.842534205829863
GO:0072656	maintenance of protein location in mitochondrion	  5	0.77940058892516	1	2	3	6722	7436	0.842534205829863
GO:0072657	protein localization to membrane	 11	0.0838548499097086	0.807895728316903	8	3	6716	7436	1.53188037423611
GO:0072669	tRNA-splicing ligase complex	  8	0.025392299605826	0.495149842313607	7	1	6717	7438	1.84304357525283
GO:0072673	lamellipodium morphogenesis	  6	0.979023167332401	1	1	5	6723	7434	0.351055919095776
GO:0072678	T cell migration	  6	0.979023167332401	1	1	5	6723	7434	0.351055919095776
GO:0072686	mitotic spindle	 47	0.175571950835433	0.949543953868825	26	21	6698	7418	1.165206880403
GO:0072711	cellular response to hydroxyurea	  7	0.919244306193629	1	2	5	6722	7434	0.601810147021331
GO:0072719	cellular response to cisplatin	  5	0.960049771736903	1	1	4	6723	7435	0.421267102914932
GO:0075522	IRES-dependent viral translational initiation	 10	0.133503266897558	0.919686434773344	7	3	6717	7436	1.47443486020226
GO:0075713	establishment of integrated proviral latency	  8	0.580280354503036	1	4	4	6720	7435	1.05316775728733
GO:0075733	intracellular transport of virus	 50	0.21651461544495	1	27	23	6697	7416	1.13742117787032
GO:0080008	Cul4-RING E3 ubiquitin ligase complex	 18	0.00881923479062879	0.410349233027118	14	4	6710	7435	1.63826095578029
GO:0080009	mRNA methylation	  6	0.297654371351411	1	4	2	6720	7437	1.40422367638311
GO:0080025	phosphatidylinositol-3,5-bisphosphate binding	 20	0.184541691833438	0.949543953868825	12	8	6712	7431	1.26380130874479
GO:0080111	DNA demethylation	 10	0.78367246101976	1	4	6	6720	7433	0.842534205829863
GO:0080182	histone H3-K4 trimethylation	 13	0.643122793005253	1	6	7	6718	7432	0.972154852880611
GO:0085020	protein K6-linked ubiquitination	  7	0.187210848839696	0.949543953868825	5	2	6719	7437	1.50452536755333
GO:0085029	extracellular matrix assembly	  6	0.607836179256654	1	3	3	6721	7436	1.05316775728733
GO:0086002	cardiac muscle cell action potential involved in contraction	 14	0.160610520833599	0.919686434773344	9	5	6715	7434	1.35407283079799
GO:0086004	regulation of cardiac muscle cell contraction	 11	0.665993939534306	1	5	6	6719	7433	0.957425233897572
GO:0086005	ventricular cardiac muscle cell action potential	 12	0.75380380293781	1	5	7	6719	7432	0.877639797739441
GO:0086006	voltage-gated sodium channel activity involved in cardiac muscle cell action potential	  5	0.157494903089267	0.919686434773344	4	1	6720	7438	1.68506841165973
GO:0086008	voltage-gated potassium channel activity involved in cardiac muscle cell action potential repolarization	  5	0.77940058892516	1	2	3	6722	7436	0.842534205829863
GO:0086009	membrane repolarization	  9	0.438074670071218	1	5	4	6719	7435	1.17018639698592
GO:0086010	membrane depolarization during action potential	 23	0.567952371389245	1	11	12	6713	7427	1.00737785479658
GO:0086012	membrane depolarization during cardiac muscle cell action potential	 12	0.320810094151237	1	7	5	6717	7434	1.22869571683522
GO:0086013	membrane repolarization during cardiac muscle cell action potential	  8	0.309544448231027	1	5	3	6719	7436	1.31645969660916
GO:0086014	atrial cardiac muscle cell action potential	  8	0.580280354503036	1	4	4	6720	7435	1.05316775728733
GO:0086015	SA node cell action potential	  6	0.607836179256654	1	3	3	6721	7436	1.05316775728733
GO:0086036	regulation of cardiac muscle cell membrane potential	  6	0.607836179256654	1	3	3	6721	7436	1.05316775728733
GO:0086045	membrane depolarization during AV node cell action potential	  5	0.77940058892516	1	2	3	6722	7436	0.842534205829863
GO:0086046	membrane depolarization during SA node cell action potential	  5	0.452745275304033	1	3	2	6721	7437	1.26380130874479
GO:0086064	cell communication by electrical coupling involved in cardiac conduction	 13	0.230372725000093	1	8	5	6716	7434	1.29620647050748
GO:0086073	bundle of His cell-Purkinje myocyte adhesion involved in cell communication	  6	1	1	0	6	6724	7433	0
GO:0086083	cell adhesive protein binding involved in bundle of His cell-Purkinje myocyte communication	  6	1	1	0	6	6724	7433	0
GO:0086091	regulation of heart rate by cardiac conduction	 33	0.656862706456246	1	15	18	6709	7421	0.957425233897572
GO:0089711	L-glutamate transmembrane transport	 13	0.0309498150207146	0.552600112408603	10	3	6714	7436	1.62025808813435
GO:0089720	caspase binding	  7	0.730029012673872	1	3	4	6721	7435	0.902715220531996
GO:0090009	primitive streak formation	 10	0.998406526036605	1	1	9	6723	7430	0.210633551457466
GO:0090023	positive regulation of neutrophil chemotaxis	 24	0.641180248362636	1	11	13	6713	7426	0.965403777513385
GO:0090026	positive regulation of monocyte chemotaxis	 15	0.972187308828691	1	4	11	6720	7428	0.561689470553242
GO:0090036	regulation of protein kinase C signaling	  7	0.187210848839696	0.949543953868825	5	2	6719	7437	1.50452536755333
GO:0090037	positive regulation of protein kinase C signaling	  7	0.98898631085553	1	1	6	6723	7433	0.300905073510665
GO:0090050	positive regulation of cell migration involved in sprouting angiogenesis	  7	0.98898631085553	1	1	6	6723	7433	0.300905073510665
GO:0090051	negative regulation of cell migration involved in sprouting angiogenesis	 12	0.5430601307694	1	6	6	6718	7433	1.05316775728733
GO:0090073	positive regulation of protein homodimerization activity	  7	0.187210848839696	0.949543953868825	5	2	6719	7437	1.50452536755333
GO:0090084	negative regulation of inclusion body assembly	 10	0.983985908365184	1	2	8	6722	7431	0.421267102914932
GO:0090091	positive regulation of extracellular matrix disassembly	  7	0.444912401367032	1	4	3	6720	7436	1.20362029404266
GO:0090102	cochlea development	 22	0.796326194402031	1	9	13	6715	7426	0.861682710507815
GO:0090103	cochlea morphogenesis	 20	0.989190352963028	1	5	15	6719	7424	0.526583878643665
GO:0090110	cargo loading into COPII-coated vesicle	 11	0.665993939534306	1	5	6	6719	7433	0.957425233897572
GO:0090129	positive regulation of synapse maturation	 10	0.925275888620553	1	3	7	6721	7432	0.631900654372397
GO:0090136	epithelial cell-cell adhesion	 10	0.78367246101976	1	4	6	6720	7433	0.842534205829863
GO:0090140	regulation of mitochondrial fission	  8	0.025392299605826	0.495149842313607	7	1	6717	7438	1.84304357525283
GO:0090141	positive regulation of mitochondrial fission	 13	0.00687971396051248	0.354502993326374	11	2	6713	7437	1.78228389694779
GO:0090150	establishment of protein localization to membrane	 10	0.00700161837131091	0.354502993326374	9	1	6715	7438	1.89570196311719
GO:0090160	Golgi to lysosome transport	  7	0.0474968970055936	0.646585116783694	6	1	6718	7438	1.80543044106399
GO:0090161	Golgi ribbon formation	  9	0.438074670071218	1	5	4	6719	7435	1.17018639698592
GO:0090162	establishment of epithelial cell polarity	 12	0.320810094151237	1	7	5	6717	7434	1.22869571683522
GO:0090166	Golgi disassembly	  5	0.77940058892516	1	2	3	6722	7436	0.842534205829863
GO:0090179	planar cell polarity pathway involved in neural tube closure	 11	0.953160347938253	1	3	8	6721	7431	0.574455140338543
GO:0090181	regulation of cholesterol metabolic process	 11	0.665993939534306	1	5	6	6719	7433	0.957425233897572
GO:0090188	negative regulation of pancreatic juice secretion	  5	0.452745275304033	1	3	2	6721	7437	1.26380130874479
GO:0090190	positive regulation of branching involved in ureteric bud morphogenesis	 18	0.974269347793119	1	5	13	6719	7426	0.585093198492961
GO:0090197	positive regulation of chemokine secretion	  9	1	1	0	9	6724	7430	0
GO:0090200	positive regulation of release of cytochrome c from mitochondria	 29	0.391787364159249	1	15	14	6709	7425	1.08948388684896
GO:0090201	negative regulation of release of cytochrome c from mitochondria	 16	0.324860333233664	1	9	7	6715	7432	1.18481372694825
GO:0090207	regulation of triglyceride metabolic process	  5	0.452745275304033	1	3	2	6721	7437	1.26380130874479
GO:0090267	positive regulation of mitotic cell cycle spindle assembly checkpoint	  6	0.607836179256654	1	3	3	6721	7436	1.05316775728733
GO:0090277	positive regulation of peptide hormone secretion	  7	0.98898631085553	1	1	6	6723	7433	0.300905073510665
GO:0090279	regulation of calcium ion import	  6	0.607836179256654	1	3	3	6721	7436	1.05316775728733
GO:0090280	positive regulation of calcium ion import	 11	0.953160347938253	1	3	8	6721	7431	0.574455140338543
GO:0090286	cytoskeletal anchoring at nuclear membrane	  6	0.297654371351411	1	4	2	6720	7437	1.40422367638311
GO:0090303	positive regulation of wound healing	 13	0.822979434145659	1	5	8	6719	7431	0.810129044067176
GO:0090305	nucleic acid phosphodiester bond hydrolysis	 96	0.210429308349574	0.998026267702333	50	46	6674	7393	1.0970497471743
GO:0090307	mitotic spindle assembly	 29	0.259321724550117	1	16	13	6708	7426	1.16211614597223
GO:0090314	positive regulation of protein targeting to membrane	 25	0.0725535511024713	0.807895728316903	16	9	6708	7430	1.34805472932778
GO:0090316	positive regulation of intracellular protein transport	 23	0.254283570903419	1	13	10	6711	7429	1.19053746475959
GO:0090330	regulation of platelet aggregation	  5	0.157494903089267	0.919686434773344	4	1	6720	7438	1.68506841165973
GO:0090331	negative regulation of platelet aggregation	 10	0.559603563591584	1	5	5	6719	7434	1.05316775728733
GO:0090336	positive regulation of brown fat cell differentiation	  7	0.919244306193629	1	2	5	6722	7434	0.601810147021331
GO:0090382	phagosome maturation	  6	0.607836179256654	1	3	3	6721	7436	1.05316775728733
GO:0090383	phagosome acidification	 22	0.0147211815904588	0.464573006924516	16	6	6708	7433	1.53188037423611
GO:0090385	phagosome-lysosome fusion	  6	0.979023167332401	1	1	5	6723	7434	0.351055919095776
GO:0090394	negative regulation of excitatory postsynaptic potential	  9	0.206720270758876	0.983668097955673	6	3	6718	7436	1.40422367638311
GO:0090398	cellular senescence	 20	0.670469046918919	1	9	11	6715	7428	0.947850981558596
GO:0090399	replicative senescence	 10	0.925275888620553	1	3	7	6721	7432	0.631900654372397
GO:0090501	RNA phosphodiester bond hydrolysis	 32	0.829842015444451	1	13	19	6711	7420	0.855698802795955
GO:0090502	RNA phosphodiester bond hydrolysis, endonucleolytic	 43	0.884807792585161	1	17	26	6707	7413	0.832737296459748
GO:0090503	RNA phosphodiester bond hydrolysis, exonucleolytic	 30	0.461375405343472	1	15	15	6709	7424	1.05316775728733
GO:0090527	actin filament reorganization	  6	0.0874151689581943	0.807895728316903	5	1	6719	7438	1.75527959547888
GO:0090543	Flemming body	  6	0.607836179256654	1	3	3	6721	7436	1.05316775728733
GO:0090557	establishment of endothelial intestinal barrier	  8	0.819878207576373	1	3	5	6721	7434	0.789875817965497
GO:0090575	RNA polymerase II transcription factor complex	 37	0.910685535190972	1	14	23	6710	7416	0.796991816325546
GO:0090630	activation of GTPase activity	 67	0.182637891340809	0.949543953868825	36	31	6688	7408	1.13176236604011
GO:0090647	modulation of age-related behavioral decline	  5	0.157494903089267	0.919686434773344	4	1	6720	7438	1.68506841165973
GO:0090650	cellular response to oxygen-glucose deprivation	  5	0.157494903089267	0.919686434773344	4	1	6720	7438	1.68506841165973
GO:0090656	t-circle formation	 10	0.78367246101976	1	4	6	6720	7433	0.842534205829863
GO:0090662	ATP hydrolysis coupled transmembrane transport	  7	0.444912401367032	1	4	3	6720	7436	1.20362029404266
GO:0090724	central region of growth cone	  5	0.77940058892516	1	2	3	6722	7436	0.842534205829863
GO:0097009	energy homeostasis	 13	0.230372725000093	1	8	5	6716	7434	1.29620647050748
GO:0097011	cellular response to granulocyte macrophage colony-stimulating factor stimulus	  7	0.730029012673872	1	3	4	6721	7435	0.902715220531996
GO:0097025	MPP7-DLG1-LIN7 complex	  5	0.157494903089267	0.919686434773344	4	1	6720	7438	1.68506841165973
GO:0097027	ubiquitin-protein transferase activator activity	  7	0.919244306193629	1	2	5	6722	7434	0.601810147021331
GO:0097028	dendritic cell differentiation	  9	0.067355898427907	0.780679208284898	7	2	6717	7437	1.63826095578029
GO:0097038	perinuclear endoplasmic reticulum	 10	0.133503266897558	0.919686434773344	7	3	6717	7436	1.47443486020226
GO:0097060	synaptic membrane	 19	0.127144513269886	0.919686434773344	12	7	6712	7432	1.33031716709978
GO:0097062	dendritic spine maintenance	  5	0.0241003244622537	0.495149842313607	5	0	6719	7439	2.10633551457466
GO:0097066	response to thyroid hormone	  5	1	1	0	5	6724	7434	0
GO:0097067	cellular response to thyroid hormone stimulus	 14	0.160610520833599	0.919686434773344	9	5	6715	7434	1.35407283079799
GO:0097084	vascular smooth muscle cell development	  5	0.77940058892516	1	2	3	6722	7436	0.842534205829863
GO:0097094	craniofacial suture morphogenesis	  8	0.819878207576373	1	3	5	6721	7434	0.789875817965497
GO:0097100	supercoiled DNA binding	  5	0.452745275304033	1	3	2	6721	7437	1.26380130874479
GO:0097104	postsynaptic membrane assembly	  8	0.819878207576373	1	3	5	6721	7434	0.789875817965497
GO:0097105	presynaptic membrane assembly	 10	0.559603563591584	1	5	5	6719	7434	1.05316775728733
GO:0097110	scaffold protein binding	 45	0.803783319763255	1	19	26	6705	7413	0.8893416617093
GO:0097114	NMDA glutamate receptor clustering	  5	0.960049771736903	1	1	4	6723	7435	0.421267102914932
GO:0097119	postsynaptic density protein 95 clustering	  6	0.865182793759413	1	2	4	6722	7435	0.702111838191553
GO:0097120	receptor localization to synapse	  9	0.69404490204849	1	4	5	6720	7434	0.936149117588737
GO:0097136	Bcl-2 family protein complex	  5	0.157494903089267	0.919686434773344	4	1	6720	7438	1.68506841165973
GO:0097150	neuronal stem cell population maintenance	 19	0.592680980401227	1	9	10	6715	7429	0.997737875324838
GO:0097151	positive regulation of inhibitory postsynaptic potential	  6	0.0874151689581943	0.807895728316903	5	1	6719	7438	1.75527959547888
GO:0097153	cysteine-type endopeptidase activity involved in apoptotic process	  8	1	1	0	8	6724	7431	0
GO:0097157	pre-mRNA intronic binding	  8	0.580280354503036	1	4	4	6720	7435	1.05316775728733
GO:0097165	nuclear stress granule	  5	0.157494903089267	0.919686434773344	4	1	6720	7438	1.68506841165973
GO:0097178	ruffle assembly	  8	0.952366339066048	1	2	6	6722	7433	0.526583878643665
GO:0097186	amelogenesis	  8	0.309544448231027	1	5	3	6719	7436	1.31645969660916
GO:0097190	apoptotic signaling pathway	 65	0.99794843419542	1	20	45	6704	7394	0.648103235253741
GO:0097191	extrinsic apoptotic signaling pathway	 37	0.843930287056752	1	15	22	6709	7417	0.853919803205942
GO:0097192	extrinsic apoptotic signaling pathway in absence of ligand	 29	0.800246571563356	1	12	17	6712	7422	0.871587109479169
GO:0097193	intrinsic apoptotic signaling pathway	 26	0.198303125650341	0.983668097955673	15	11	6709	7428	1.21519356610076
GO:0097194	execution phase of apoptosis	 30	0.461375405343472	1	15	15	6709	7424	1.05316775728733
GO:0097197	tetraspanin-enriched microdomain	  5	0.77940058892516	1	2	3	6722	7436	0.842534205829863
GO:0097200	cysteine-type endopeptidase activity involved in execution phase of apoptosis	  8	0.819878207576373	1	3	5	6721	7434	0.789875817965497
GO:0097202	activation of cysteine-type endopeptidase activity	 11	0.850917330440019	1	4	7	6720	7432	0.765940187118057
GO:0097208	alveolar lamellar body	  6	0.607836179256654	1	3	3	6721	7436	1.05316775728733
GO:0097225	sperm midpiece	 10	0.78367246101976	1	4	6	6720	7433	0.842534205829863
GO:0097227	sperm annulus	  6	0.0874151689581943	0.807895728316903	5	1	6719	7438	1.75527959547888
GO:0097228	sperm principal piece	 15	0.109100626262719	0.88413902838582	10	5	6714	7434	1.40422367638311
GO:0097237	cellular response to toxic substance	  7	0.0474968970055936	0.646585116783694	6	1	6718	7438	1.80543044106399
GO:0097242	amyloid-beta clearance	  6	1	1	0	6	6724	7433	0
GO:0097255	R2TP complex	  5	0.452745275304033	1	3	2	6721	7437	1.26380130874479
GO:0097264	self proteolysis	  6	0.979023167332401	1	1	5	6723	7434	0.351055919095776
GO:0097267	omega-hydroxylase P450 pathway	  6	0.607836179256654	1	3	3	6721	7436	1.05316775728733
GO:0097284	hepatocyte apoptotic process	 11	0.431935112460319	1	6	5	6718	7434	1.14891028067709
GO:0097296	activation of cysteine-type endopeptidase activity involved in apoptotic signaling pathway	 13	0.982330979346752	1	3	10	6721	7429	0.486077426440306
GO:0097320	plasma membrane tubulation	 10	0.559603563591584	1	5	5	6719	7434	1.05316775728733
GO:0097322	7SK snRNA binding	  7	0.444912401367032	1	4	3	6720	7436	1.20362029404266
GO:0097342	ripoptosome	  7	0.98898631085553	1	1	6	6723	7433	0.300905073510665
GO:0097345	mitochondrial outer membrane permeabilization	  8	0.309544448231027	1	5	3	6719	7436	1.31645969660916
GO:0097352	autophagosome maturation	 22	0.041054903272608	0.642192145499981	15	7	6709	7432	1.43613785084636
GO:0097381	photoreceptor disc membrane	 13	0.997057742126947	1	2	11	6722	7428	0.32405161762687
GO:0097398	cellular response to interleukin-17	  7	0.98898631085553	1	1	6	6723	7433	0.300905073510665
GO:0097418	neurofibrillary tangle	  5	0.452745275304033	1	3	2	6721	7437	1.26380130874479
GO:0097421	liver regeneration	 25	0.557266861497771	1	12	13	6712	7426	1.01104104699584
GO:0097427	microtubule bundle	  5	0.452745275304033	1	3	2	6721	7437	1.26380130874479
GO:0097428	protein maturation by iron-sulfur cluster transfer	  5	0.157494903089267	0.919686434773344	4	1	6720	7438	1.68506841165973
GO:0097431	mitotic spindle pole	 16	0.170220385600338	0.949543953868825	10	6	6714	7433	1.31645969660916
GO:0097433	dense body	  6	0.865182793759413	1	2	4	6722	7435	0.702111838191553
GO:0097435	supramolecular fiber organization	 13	0.822979434145659	1	5	8	6719	7431	0.810129044067176
GO:0097440	apical dendrite	 10	0.559603563591584	1	5	5	6719	7434	1.05316775728733
GO:0097443	sorting endosome	  6	0.865182793759413	1	2	4	6722	7435	0.702111838191553
GO:0097449	astrocyte projection	  8	0.580280354503036	1	4	4	6720	7435	1.05316775728733
GO:0097470	ribbon synapse	  6	0.0874151689581943	0.807895728316903	5	1	6719	7438	1.75527959547888
GO:0097484	dendrite extension	  9	0.206720270758876	0.983668097955673	6	3	6718	7436	1.40422367638311
GO:0097485	neuron projection guidance	  6	0.0114373555630656	0.427208830906354	6	0	6718	7439	2.10633551457466
GO:0097493	structural molecule activity conferring elasticity	 10	0.925275888620553	1	3	7	6721	7432	0.631900654372397
GO:0097500	receptor localization to non-motile cilium	  5	0.452745275304033	1	3	2	6721	7437	1.26380130874479
GO:0097502	mannosylation	 11	0.431935112460319	1	6	5	6718	7434	1.14891028067709
GO:0097503	sialylation	 18	0.506938913103874	1	9	9	6715	7430	1.05316775728733
GO:0097504	Gemini of coiled bodies	  9	0.972243904416257	1	2	7	6722	7432	0.468074558794368
GO:0097512	cardiac myofibril	  6	0.865182793759413	1	2	4	6722	7435	0.702111838191553
GO:0097527	necroptotic signaling pathway	  6	1	1	0	6	6724	7433	0
GO:0097539	ciliary transition fiber	  9	0.438074670071218	1	5	4	6719	7435	1.17018639698592
GO:0097542	ciliary tip	 41	0.013533818843293	0.443847740701633	27	14	6697	7425	1.38709899740282
GO:0097546	ciliary base	 26	0.107316947101236	0.88413902838582	16	10	6708	7429	1.29620647050748
GO:0097550	transcriptional preinitiation complex	  6	0.297654371351411	1	4	2	6720	7437	1.40422367638311
GO:0097602	cullin family protein binding	 14	0.0183006792268162	0.495149842313607	11	3	6713	7436	1.65497790430866
GO:0097647	amylin receptor signaling pathway	  6	1	1	0	6	6724	7433	0
GO:0097711	ciliary basal body-plasma membrane docking	 91	0.0150278115967281	0.468867721817917	54	37	6670	7402	1.24991338227507
GO:0097718	disordered domain specific binding	 30	0.322199322975026	1	16	14	6708	7425	1.12337894110648
GO:0097730	non-motile cilium	 22	0.0957434892101259	0.843214701401555	14	8	6710	7431	1.3403953274566
GO:0097746	regulation of blood vessel diameter	  9	0.996964464269463	1	1	8	6723	7431	0.234037279397184
GO:0097755	positive regulation of blood vessel diameter	 23	0.843995637843635	1	9	14	6715	7425	0.824218244833562
GO:0097756	negative regulation of blood vessel diameter	  6	0.297654371351411	1	4	2	6720	7437	1.40422367638311
GO:0098505	G-rich strand telomeric DNA binding	 10	0.316545776550851	1	6	4	6718	7435	1.26380130874479
GO:0098574	cytoplasmic side of lysosomal membrane	  6	0.607836179256654	1	3	3	6721	7436	1.05316775728733
GO:0098586	cellular response to virus	 14	0.323388997222084	1	8	6	6716	7433	1.20362029404266
GO:0098641	cadherin binding involved in cell-cell adhesion	 18	0.926471989195673	1	6	12	6718	7427	0.702111838191553
GO:0098655	cation transmembrane transport	 56	0.914271805246169	1	22	34	6702	7405	0.82748895215433
GO:0098656	anion transmembrane transport	 31	0.529914677492654	1	15	16	6709	7423	1.01919460382645
GO:0098664	G-protein coupled serotonin receptor signaling pathway	 10	0.998406526036605	1	1	9	6723	7430	0.210633551457466
GO:0098703	calcium ion import across plasma membrane	  9	0.69404490204849	1	4	5	6720	7434	0.936149117588737
GO:0098712	L-glutamate import across plasma membrane	  5	0.157494903089267	0.919686434773344	4	1	6720	7438	1.68506841165973
GO:0098719	sodium ion import across plasma membrane	 10	0.925275888620553	1	3	7	6721	7432	0.631900654372397
GO:0098742	cell-cell adhesion via plasma-membrane adhesion molecules	 11	0.953160347938253	1	3	8	6721	7431	0.574455140338543
GO:0098773	skin epidermis development	  5	0.77940058892516	1	2	3	6722	7436	0.842534205829863
GO:0098780	response to mitochondrial depolarisation	  5	0.77940058892516	1	2	3	6722	7436	0.842534205829863
GO:0098789	pre-mRNA cleavage required for polyadenylation	  7	0.730029012673872	1	3	4	6721	7435	0.902715220531996
GO:0098793	presynapse	 58	0.0954880608272735	0.843214701401555	33	25	6691	7414	1.19843227553386
GO:0098794	postsynapse	 39	0.168947296909436	0.949543953868825	22	17	6702	7422	1.18818926463186
GO:0098797	plasma membrane protein complex	  9	0.996964464269463	1	1	8	6723	7431	0.234037279397184
GO:0098821	BMP receptor activity	  6	0.607836179256654	1	3	3	6721	7436	1.05316775728733
GO:0098839	postsynaptic density membrane	  6	0.865182793759413	1	2	4	6722	7435	0.702111838191553
GO:0098869	cellular oxidant detoxification	 60	0.981506012696284	1	21	39	6703	7400	0.73721743010113
GO:0098887	neurotransmitter receptor transport, endosome to postsynaptic membrane	  5	0.452745275304033	1	3	2	6721	7437	1.26380130874479
GO:0098909	regulation of cardiac muscle cell action potential involved in regulation of contraction	  8	0.580280354503036	1	4	4	6720	7435	1.05316775728733
GO:0098911	regulation of ventricular cardiac muscle cell action potential	 11	0.990836032904502	1	2	9	6722	7430	0.382970093559029
GO:0098914	membrane repolarization during atrial cardiac muscle cell action potential	  5	0.77940058892516	1	2	3	6722	7436	0.842534205829863
GO:0098915	membrane repolarization during ventricular cardiac muscle cell action potential	  6	0.607836179256654	1	3	3	6721	7436	1.05316775728733
GO:0099078	BORC complex	  7	0.187210848839696	0.949543953868825	5	2	6719	7437	1.50452536755333
GO:0099132	ATP hydrolysis coupled cation transmembrane transport	 27	0.0776311536569698	0.807895728316903	17	10	6707	7429	1.32621124991738
GO:0099133	ATP hydrolysis coupled anion transmembrane transport	 12	0.5430601307694	1	6	6	6718	7433	1.05316775728733
GO:0099565	chemical synaptic transmission, postsynaptic	  7	0.444912401367032	1	4	3	6720	7436	1.20362029404266
GO:0099738	cell cortex region	 11	0.850917330440019	1	4	7	6720	7432	0.765940187118057
GO:0101003	ficolin-1-rich granule membrane	 46	0.754808097501554	1	20	26	6704	7413	0.915798049815069
GO:0102336	3-oxo-arachidoyl-CoA synthase activity	  5	0.452745275304033	1	3	2	6721	7437	1.26380130874479
GO:0102337	3-oxo-cerotoyl-CoA synthase activity	  5	0.452745275304033	1	3	2	6721	7437	1.26380130874479
GO:0102338	3-oxo-lignoceronyl-CoA synthase activity	  5	0.452745275304033	1	3	2	6721	7437	1.26380130874479
GO:0102391	decanoate--CoA ligase activity	  7	0.187210848839696	0.949543953868825	5	2	6719	7437	1.50452536755333
GO:0106003	amyloid-beta complex	  7	0.919244306193629	1	2	5	6722	7434	0.601810147021331
GO:0140052	cellular response to oxidised low-density lipoprotein particle stimulus	  5	0.960049771736903	1	1	4	6723	7435	0.421267102914932
GO:1900006	positive regulation of dendrite development	 14	0.529251719099727	1	7	7	6717	7432	1.05316775728733
GO:1900016	negative regulation of cytokine production involved in inflammatory response	  9	0.972243904416257	1	2	7	6722	7432	0.468074558794368
GO:1900017	positive regulation of cytokine production involved in inflammatory response	 12	0.994792086314609	1	2	10	6722	7429	0.351055919095776
GO:1900025	negative regulation of substrate adhesion-dependent cell spreading	 12	0.971055765853963	1	3	9	6721	7430	0.526583878643665
GO:1900026	positive regulation of substrate adhesion-dependent cell spreading	 29	0.0822805002524998	0.807895728316903	18	11	6706	7428	1.30738066421875
GO:1900027	regulation of ruffle assembly	  7	0.730029012673872	1	3	4	6721	7435	0.902715220531996
GO:1900029	positive regulation of ruffle assembly	  8	0.819878207576373	1	3	5	6721	7434	0.789875817965497
GO:1900034	regulation of cellular response to heat	 74	0.0253663131521931	0.495149842313607	44	30	6680	7409	1.25241571136872
GO:1900086	positive regulation of peptidyl-tyrosine autophosphorylation	  5	0.960049771736903	1	1	4	6723	7435	0.421267102914932
GO:1900087	positive regulation of G1/S transition of mitotic cell cycle	 22	0.796326194402031	1	9	13	6715	7426	0.861682710507815
GO:1900113	negative regulation of histone H3-K9 trimethylation	  6	0.297654371351411	1	4	2	6720	7437	1.40422367638311
GO:1900119	positive regulation of execution phase of apoptosis	  8	0.952366339066048	1	2	6	6722	7433	0.526583878643665
GO:1900121	negative regulation of receptor binding	  6	0.607836179256654	1	3	3	6721	7436	1.05316775728733
GO:1900122	positive regulation of receptor binding	  6	0.865182793759413	1	2	4	6722	7435	0.702111838191553
GO:1900153	positive regulation of nuclear-transcribed mRNA catabolic process, deadenylation-dependent decay	 14	0.323388997222084	1	8	6	6716	7433	1.20362029404266
GO:1900165	negative regulation of interleukin-6 secretion	  5	0.452745275304033	1	3	2	6721	7437	1.26380130874479
GO:1900180	regulation of protein localization to nucleus	  5	0.960049771736903	1	1	4	6723	7435	0.421267102914932
GO:1900181	negative regulation of protein localization to nucleus	 11	0.665993939534306	1	5	6	6719	7433	0.957425233897572
GO:1900182	positive regulation of protein localization to nucleus	 19	0.949176156916864	1	6	13	6718	7426	0.665158583549892
GO:1900223	positive regulation of amyloid-beta clearance	  5	0.77940058892516	1	2	3	6722	7436	0.842534205829863
GO:1900227	positive regulation of NLRP3 inflammasome complex assembly	  5	0.77940058892516	1	2	3	6722	7436	0.842534205829863
GO:1900246	positive regulation of RIG-I signaling pathway	  6	0.607836179256654	1	3	3	6721	7436	1.05316775728733
GO:1900264	positive regulation of DNA-directed DNA polymerase activity	  7	0.187210848839696	0.949543953868825	5	2	6719	7437	1.50452536755333
GO:1900271	regulation of long-term synaptic potentiation	  6	0.0874151689581943	0.807895728316903	5	1	6719	7438	1.75527959547888
GO:1900272	negative regulation of long-term synaptic potentiation	  6	0.607836179256654	1	3	3	6721	7436	1.05316775728733
GO:1900273	positive regulation of long-term synaptic potentiation	 13	0.230372725000093	1	8	5	6716	7434	1.29620647050748
GO:1900364	negative regulation of mRNA polyadenylation	  8	0.309544448231027	1	5	3	6719	7436	1.31645969660916
GO:1900740	positive regulation of protein insertion into mitochondrial membrane involved in apoptotic signaling pathway	 31	0.668178704248721	1	14	17	6710	7422	0.951248296904684
GO:1900744	regulation of p38MAPK cascade	  5	1	1	0	5	6724	7434	0
GO:1900745	positive regulation of p38MAPK cascade	 15	0.798298186583662	1	6	9	6718	7430	0.842534205829863
GO:1901016	regulation of potassium ion transmembrane transporter activity	  7	0.0474968970055936	0.646585116783694	6	1	6718	7438	1.80543044106399
GO:1901017	negative regulation of potassium ion transmembrane transporter activity	  8	0.113810689204897	0.88413902838582	6	2	6718	7437	1.57975163593099
GO:1901018	positive regulation of potassium ion transmembrane transporter activity	  6	0.297654371351411	1	4	2	6720	7437	1.40422367638311
GO:1901029	negative regulation of mitochondrial outer membrane permeabilization involved in apoptotic signaling pathway	  7	0.919244306193629	1	2	5	6722	7434	0.601810147021331
GO:1901030	positive regulation of mitochondrial outer membrane permeabilization involved in apoptotic signaling pathway	  9	0.438074670071218	1	5	4	6719	7435	1.17018639698592
GO:1901098	positive regulation of autophagosome maturation	  6	0.297654371351411	1	4	2	6720	7437	1.40422367638311
GO:1901164	negative regulation of trophoblast cell migration	  5	0.77940058892516	1	2	3	6722	7436	0.842534205829863
GO:1901185	negative regulation of ERBB signaling pathway	 11	0.431935112460319	1	6	5	6718	7434	1.14891028067709
GO:1901214	regulation of neuron death	 18	0.0811513291101853	0.807895728316903	12	6	6712	7433	1.40422367638311
GO:1901215	negative regulation of neuron death	 40	0.0401507445605401	0.629755700009341	25	15	6699	7424	1.31645969660916
GO:1901216	positive regulation of neuron death	 26	0.62841636814953	1	12	14	6712	7425	0.972154852880611
GO:1901222	regulation of NIK/NF-kappaB signaling	  6	0.607836179256654	1	3	3	6721	7436	1.05316775728733
GO:1901223	negative regulation of NIK/NF-kappaB signaling	  6	0.607836179256654	1	3	3	6721	7436	1.05316775728733
GO:1901224	positive regulation of NIK/NF-kappaB signaling	 22	0.655120963592744	1	10	12	6714	7427	0.957425233897572
GO:1901379	regulation of potassium ion transmembrane transport	 13	0.000953326541898035	0.165233002219546	12	1	6712	7438	1.94430970576122
GO:1901380	negative regulation of potassium ion transmembrane transport	  8	0.309544448231027	1	5	3	6719	7436	1.31645969660916
GO:1901381	positive regulation of potassium ion transmembrane transport	 13	0.822979434145659	1	5	8	6719	7431	0.810129044067176
GO:1901385	regulation of voltage-gated calcium channel activity	  8	0.113810689204897	0.88413902838582	6	2	6718	7437	1.57975163593099
GO:1901386	negative regulation of voltage-gated calcium channel activity	  5	0.77940058892516	1	2	3	6722	7436	0.842534205829863
GO:1901409	positive regulation of phosphorylation of RNA polymerase II C-terminal domain	  7	0.00542743198931091	0.334473021939644	7	0	6717	7439	2.10633551457466
GO:1901522	positive regulation of transcription from RNA polymerase II promoter involved in cellular response to chemical stimulus	  9	0.69404490204849	1	4	5	6720	7434	0.936149117588737
GO:1901612	cardiolipin binding	  7	0.730029012673872	1	3	4	6721	7435	0.902715220531996
GO:1901621	negative regulation of smoothened signaling pathway involved in dorsal/ventral neural tube patterning	  5	0.157494903089267	0.919686434773344	4	1	6720	7438	1.68506841165973
GO:1901642	nucleoside transmembrane transport	  6	0.865182793759413	1	2	4	6722	7435	0.702111838191553
GO:1901652	response to peptide	 11	0.990836032904502	1	2	9	6722	7430	0.382970093559029
GO:1901653	cellular response to peptide	 14	0.875453509540804	1	5	9	6719	7430	0.752262683776664
GO:1901673	regulation of mitotic spindle assembly	 13	0.426320358160906	1	7	6	6717	7433	1.13418066169405
GO:1901687	glutathione derivative biosynthetic process	 15	0.798298186583662	1	6	9	6718	7430	0.842534205829863
GO:1901727	positive regulation of histone deacetylase activity	  5	0.452745275304033	1	3	2	6721	7437	1.26380130874479
GO:1901741	positive regulation of myoblast fusion	 15	0.914031171019375	1	5	10	6719	7429	0.702111838191553
GO:1901799	negative regulation of proteasomal protein catabolic process	  7	0.187210848839696	0.949543953868825	5	2	6719	7437	1.50452536755333
GO:1901800	positive regulation of proteasomal protein catabolic process	 14	0.875453509540804	1	5	9	6719	7430	0.752262683776664
GO:1901838	positive regulation of transcription of nuclear large rRNA transcript from RNA polymerase I promoter	  7	0.187210848839696	0.949543953868825	5	2	6719	7437	1.50452536755333
GO:1901841	regulation of high voltage-gated calcium channel activity	  5	0.77940058892516	1	2	3	6722	7436	0.842534205829863
GO:1901844	regulation of cell communication by electrical coupling involved in cardiac conduction	  5	0.77940058892516	1	2	3	6722	7436	0.842534205829863
GO:1901981	phosphatidylinositol phosphate binding	  7	0.444912401367032	1	4	3	6720	7436	1.20362029404266
GO:1901990	regulation of mitotic cell cycle phase transition	  7	0.919244306193629	1	2	5	6722	7434	0.601810147021331
GO:1901998	toxin transport	 31	0.158221432536759	0.919686434773344	18	13	6706	7426	1.22303352459174
GO:1902004	positive regulation of amyloid-beta formation	  6	0.607836179256654	1	3	3	6721	7436	1.05316775728733
GO:1902017	regulation of cilium assembly	 12	0.0514533113817507	0.679607581911819	9	3	6715	7436	1.57975163593099
GO:1902018	negative regulation of cilium assembly	  6	0.0874151689581943	0.807895728316903	5	1	6719	7438	1.75527959547888
GO:1902036	regulation of hematopoietic stem cell differentiation	 65	0.798237873639875	1	28	37	6696	7402	0.907344529355237
GO:1902041	regulation of extrinsic apoptotic signaling pathway via death domain receptors	 17	0.988941271773965	1	4	13	6720	7426	0.495608356370508
GO:1902042	negative regulation of extrinsic apoptotic signaling pathway via death domain receptors	 32	0.992187676419535	1	9	23	6715	7416	0.592406863474123
GO:1902043	positive regulation of extrinsic apoptotic signaling pathway via death domain receptors	 13	0.0975861781940815	0.843214701401555	9	4	6715	7435	1.45823227932092
GO:1902065	response to L-glutamate	  7	0.444912401367032	1	4	3	6720	7436	1.20362029404266
GO:1902083	negative regulation of peptidyl-cysteine S-nitrosylation	  5	0.157494903089267	0.919686434773344	4	1	6720	7438	1.68506841165973
GO:1902108	regulation of mitochondrial membrane permeability involved in apoptotic process	  5	0.77940058892516	1	2	3	6722	7436	0.842534205829863
GO:1902166	negative regulation of intrinsic apoptotic signaling pathway in response to DNA damage by p53 class mediator	 10	0.78367246101976	1	4	6	6720	7433	0.842534205829863
GO:1902176	negative regulation of oxidative stress-induced intrinsic apoptotic signaling pathway	 11	0.850917330440019	1	4	7	6720	7432	0.765940187118057
GO:1902187	negative regulation of viral release from host cell	 12	0.899474094191123	1	4	8	6720	7431	0.702111838191553
GO:1902188	positive regulation of viral release from host cell	  8	0.580280354503036	1	4	4	6720	7435	1.05316775728733
GO:1902219	negative regulation of intrinsic apoptotic signaling pathway in response to osmotic stress	  5	0.77940058892516	1	2	3	6722	7436	0.842534205829863
GO:1902230	negative regulation of intrinsic apoptotic signaling pathway in response to DNA damage	 15	0.421118865258844	1	8	7	6716	7432	1.12337894110648
GO:1902231	positive regulation of intrinsic apoptotic signaling pathway in response to DNA damage	  6	0.0874151689581943	0.807895728316903	5	1	6719	7438	1.75527959547888
GO:1902236	negative regulation of endoplasmic reticulum stress-induced intrinsic apoptotic signaling pathway	 13	0.643122793005253	1	6	7	6718	7432	0.972154852880611
GO:1902237	positive regulation of endoplasmic reticulum stress-induced intrinsic apoptotic signaling pathway	 10	0.316545776550851	1	6	4	6718	7435	1.26380130874479
GO:1902254	negative regulation of intrinsic apoptotic signaling pathway by p53 class mediator	  5	0.452745275304033	1	3	2	6721	7437	1.26380130874479
GO:1902259	regulation of delayed rectifier potassium channel activity	  5	0.452745275304033	1	3	2	6721	7437	1.26380130874479
GO:1902261	positive regulation of delayed rectifier potassium channel activity	  5	0.77940058892516	1	2	3	6722	7436	0.842534205829863
GO:1902262	apoptotic process involved in blood vessel morphogenesis	  5	0.960049771736903	1	1	4	6723	7435	0.421267102914932
GO:1902282	voltage-gated potassium channel activity involved in ventricular cardiac muscle cell action potential repolarization	  6	0.607836179256654	1	3	3	6721	7436	1.05316775728733
GO:1902305	regulation of sodium ion transmembrane transport	  8	0.819878207576373	1	3	5	6721	7434	0.789875817965497
GO:1902358	sulfate transmembrane transport	  9	0.69404490204849	1	4	5	6720	7434	0.936149117588737
GO:1902430	negative regulation of amyloid-beta formation	  6	0.865182793759413	1	2	4	6722	7435	0.702111838191553
GO:1902474	positive regulation of protein localization to synapse	  5	0.452745275304033	1	3	2	6721	7437	1.26380130874479
GO:1902475	L-alpha-amino acid transmembrane transport	 11	0.953160347938253	1	3	8	6721	7431	0.574455140338543
GO:1902476	chloride transmembrane transport	 72	0.377076499607311	1	36	36	6688	7403	1.05316775728733
GO:1902533	positive regulation of intracellular signal transduction	  8	0.952366339066048	1	2	6	6722	7433	0.526583878643665
GO:1902570	protein localization to nucleolus	  5	0.452745275304033	1	3	2	6721	7437	1.26380130874479
GO:1902600	hydrogen ion transmembrane transport	 40	0.132916295180638	0.919686434773344	23	17	6701	7422	1.21114292088043
GO:1902711	GABA-A receptor complex	 12	0.148657926965624	0.919686434773344	8	4	6716	7435	1.40422367638311
GO:1902715	positive regulation of interferon-gamma secretion	  5	1	1	0	5	6724	7434	0
GO:1902741	positive regulation of interferon-alpha secretion	  6	0.297654371351411	1	4	2	6720	7437	1.40422367638311
GO:1902749	regulation of cell cycle G2/M phase transition	  5	0.960049771736903	1	1	4	6723	7435	0.421267102914932
GO:1902808	positive regulation of cell cycle G1/S phase transition	  5	0.77940058892516	1	2	3	6722	7436	0.842534205829863
GO:1902857	positive regulation of non-motile cilium assembly	  7	0.730029012673872	1	3	4	6721	7435	0.902715220531996
GO:1902894	negative regulation of pri-miRNA transcription from RNA polymerase II promoter	 10	0.559603563591584	1	5	5	6719	7434	1.05316775728733
GO:1902895	positive regulation of pri-miRNA transcription from RNA polymerase II promoter	 20	0.911428444807446	1	7	13	6717	7426	0.73721743010113
GO:1902902	negative regulation of autophagosome assembly	 11	0.431935112460319	1	6	5	6718	7434	1.14891028067709
GO:1902916	positive regulation of protein polyubiquitination	  5	0.452745275304033	1	3	2	6721	7437	1.26380130874479
GO:1902961	positive regulation of aspartic-type endopeptidase activity involved in amyloid precursor protein catabolic process	  5	0.452745275304033	1	3	2	6721	7437	1.26380130874479
GO:1903071	positive regulation of ER-associated ubiquitin-dependent protein catabolic process	  6	0.865182793759413	1	2	4	6722	7435	0.702111838191553
GO:1903076	regulation of protein localization to plasma membrane	 14	0.323388997222084	1	8	6	6716	7433	1.20362029404266
GO:1903077	negative regulation of protein localization to plasma membrane	 14	0.0183006792268162	0.495149842313607	11	3	6713	7436	1.65497790430866
GO:1903078	positive regulation of protein localization to plasma membrane	 39	0.500905896338627	1	19	20	6705	7419	1.02616345581842
GO:1903136	cuprous ion binding	  5	0.0241003244622537	0.495149842313607	5	0	6719	7439	2.10633551457466
GO:1903140	regulation of establishment of endothelial barrier	  5	0.960049771736903	1	1	4	6723	7435	0.421267102914932
GO:1903142	positive regulation of establishment of endothelial barrier	  5	0.960049771736903	1	1	4	6723	7435	0.421267102914932
GO:1903146	regulation of autophagy of mitochondrion	 27	0.150496283020169	0.919686434773344	16	11	6708	7428	1.24819882345165
GO:1903169	regulation of calcium ion transmembrane transport	  6	0.865182793759413	1	2	4	6722	7435	0.702111838191553
GO:1903204	negative regulation of oxidative stress-induced neuron death	 12	0.012434352666713	0.427208830906354	10	2	6714	7437	1.75527959547888
GO:1903206	negative regulation of hydrogen peroxide-induced cell death	 10	0.316545776550851	1	6	4	6718	7435	1.26380130874479
GO:1903214	regulation of protein targeting to mitochondrion	  5	0.157494903089267	0.919686434773344	4	1	6720	7438	1.68506841165973
GO:1903265	positive regulation of tumor necrosis factor-mediated signaling pathway	  8	0.994217735396885	1	1	7	6723	7432	0.263291939321832
GO:1903307	positive regulation of regulated secretory pathway	  5	0.452745275304033	1	3	2	6721	7437	1.26380130874479
GO:1903351	cellular response to dopamine	 11	0.220387996626296	1	7	4	6717	7435	1.3403953274566
GO:1903358	regulation of Golgi organization	  5	0.77940058892516	1	2	3	6722	7436	0.842534205829863
GO:1903361	protein localization to basolateral plasma membrane	  6	0.607836179256654	1	3	3	6721	7436	1.05316775728733
GO:1903363	negative regulation of cellular protein catabolic process	  5	0.77940058892516	1	2	3	6722	7436	0.842534205829863
GO:1903364	positive regulation of cellular protein catabolic process	 10	0.78367246101976	1	4	6	6720	7433	0.842534205829863
GO:1903416	response to glycoside	  5	0.452745275304033	1	3	2	6721	7437	1.26380130874479
GO:1903427	negative regulation of reactive oxygen species biosynthetic process	  6	0.607836179256654	1	3	3	6721	7436	1.05316775728733
GO:1903428	positive regulation of reactive oxygen species biosynthetic process	  9	0.206720270758876	0.983668097955673	6	3	6718	7436	1.40422367638311
GO:1903432	regulation of TORC1 signaling	  5	0.452745275304033	1	3	2	6721	7437	1.26380130874479
GO:1903506	regulation of nucleic acid-templated transcription	 28	0.616649478927714	1	13	15	6711	7424	0.977941488909663
GO:1903507	negative regulation of nucleic acid-templated transcription	 32	0.724657061059778	1	14	18	6710	7421	0.921521787626413
GO:1903543	positive regulation of exosomal secretion	 13	0.822979434145659	1	5	8	6719	7431	0.810129044067176
GO:1903546	protein localization to photoreceptor outer segment	  7	0.444912401367032	1	4	3	6720	7436	1.20362029404266
GO:1903561	extracellular vesicle	 50	0.41366085413375	1	25	25	6699	7414	1.05316775728733
GO:1903599	positive regulation of autophagy of mitochondrion	  7	0.0474968970055936	0.646585116783694	6	1	6718	7438	1.80543044106399
GO:1903608	protein localization to cytoplasmic stress granule	  6	0.0114373555630656	0.427208830906354	6	0	6718	7439	2.10633551457466
GO:1903672	positive regulation of sprouting angiogenesis	  7	0.919244306193629	1	2	5	6722	7434	0.601810147021331
GO:1903715	regulation of aerobic respiration	  6	0.607836179256654	1	3	3	6721	7436	1.05316775728733
GO:1903779	regulation of cardiac conduction	 46	0.652923382796465	1	21	25	6703	7414	0.961587952305822
GO:1903799	negative regulation of production of miRNAs involved in gene silencing by miRNA	  6	0.607836179256654	1	3	3	6721	7436	1.05316775728733
GO:1903800	positive regulation of production of miRNAs involved in gene silencing by miRNA	  6	0.607836179256654	1	3	3	6721	7436	1.05316775728733
GO:1903818	positive regulation of voltage-gated potassium channel activity	  5	0.157494903089267	0.919686434773344	4	1	6720	7438	1.68506841165973
GO:1903825	organic acid transmembrane transport	  7	0.98898631085553	1	1	6	6723	7433	0.300905073510665
GO:1903826	arginine transmembrane transport	  5	0.77940058892516	1	2	3	6722	7436	0.842534205829863
GO:1903827	regulation of cellular protein localization	  9	0.996964464269463	1	1	8	6723	7431	0.234037279397184
GO:1903829	positive regulation of cellular protein localization	  5	0.452745275304033	1	3	2	6721	7437	1.26380130874479
GO:1903830	magnesium ion transmembrane transport	 15	0.237875362689918	1	9	6	6715	7433	1.26380130874479
GO:1903861	positive regulation of dendrite extension	 15	0.00204077897587989	0.222937212333575	13	2	6711	7437	1.82549077929804
GO:1903896	positive regulation of IRE1-mediated unfolded protein response	  8	0.952366339066048	1	2	6	6722	7433	0.526583878643665
GO:1903898	negative regulation of PERK-mediated unfolded protein response	  5	0.960049771736903	1	1	4	6723	7435	0.421267102914932
GO:1903912	negative regulation of endoplasmic reticulum stress-induced eIF2 alpha phosphorylation	  5	0.77940058892516	1	2	3	6722	7436	0.842534205829863
GO:1903955	positive regulation of protein targeting to mitochondrion	 71	0.334246611114102	1	36	35	6688	7404	1.06800110598152
GO:1903959	regulation of anion transmembrane transport	 13	0.0975861781940815	0.843214701401555	9	4	6715	7435	1.45823227932092
GO:1904115	axon cytoplasm	 37	0.0249556725988263	0.495149842313607	24	13	6700	7426	1.36627168512951
GO:1904153	negative regulation of retrograde protein transport, ER to cytosol	  9	0.206720270758876	0.983668097955673	6	3	6718	7436	1.40422367638311
GO:1904261	positive regulation of basement membrane assembly involved in embryonic body morphogenesis	  5	0.452745275304033	1	3	2	6721	7437	1.26380130874479
GO:1904262	negative regulation of TORC1 signaling	 12	0.0514533113817507	0.679607581911819	9	3	6715	7436	1.57975163593099
GO:1904263	positive regulation of TORC1 signaling	  8	0.025392299605826	0.495149842313607	7	1	6717	7438	1.84304357525283
GO:1904264	ubiquitin protein ligase activity involved in ERAD pathway	 10	0.316545776550851	1	6	4	6718	7435	1.26380130874479
GO:1904322	cellular response to forskolin	 10	0.78367246101976	1	4	6	6720	7433	0.842534205829863
GO:1904355	positive regulation of telomere capping	 16	0.324860333233664	1	9	7	6715	7432	1.18481372694825
GO:1904357	negative regulation of telomere maintenance via telomere lengthening	  8	0.952366339066048	1	2	6	6722	7433	0.526583878643665
GO:1904380	endoplasmic reticulum mannose trimming	 14	0.0183006792268162	0.495149842313607	11	3	6713	7436	1.65497790430866
GO:1904417	positive regulation of xenophagy	  6	0.865182793759413	1	2	4	6722	7435	0.702111838191553
GO:1904469	positive regulation of tumor necrosis factor secretion	  7	0.730029012673872	1	3	4	6721	7435	0.902715220531996
GO:1904504	positive regulation of lipophagy	  5	0.157494903089267	0.919686434773344	4	1	6720	7438	1.68506841165973
GO:1904646	cellular response to amyloid-beta	 15	0.623867966210499	1	7	8	6717	7431	0.982956573468174
GO:1904659	glucose transmembrane transport	 17	0.895242422289557	1	6	11	6718	7428	0.743412534555762
GO:1904667	negative regulation of ubiquitin protein ligase activity	  6	0.865182793759413	1	2	4	6722	7435	0.702111838191553
GO:1904668	positive regulation of ubiquitin protein ligase activity	 10	0.559603563591584	1	5	5	6719	7434	1.05316775728733
GO:1904706	negative regulation of vascular smooth muscle cell proliferation	  6	0.865182793759413	1	2	4	6722	7435	0.702111838191553
GO:1904707	positive regulation of vascular smooth muscle cell proliferation	 14	0.529251719099727	1	7	7	6717	7432	1.05316775728733
GO:1904714	regulation of chaperone-mediated autophagy	  5	0.452745275304033	1	3	2	6721	7437	1.26380130874479
GO:1904724	tertiary granule lumen	 51	0.993448265343146	1	16	35	6708	7404	0.660811141827344
GO:1904751	positive regulation of protein localization to nucleolus	  5	0.960049771736903	1	1	4	6723	7435	0.421267102914932
GO:1904754	positive regulation of vascular associated smooth muscle cell migration	 11	0.431935112460319	1	6	5	6718	7434	1.14891028067709
GO:1904778	positive regulation of protein localization to cell cortex	  5	0.77940058892516	1	2	3	6722	7436	0.842534205829863
GO:1904837	beta-catenin-TCF complex assembly	 32	0.724657061059778	1	14	18	6710	7421	0.921521787626413
GO:1904851	positive regulation of establishment of protein localization to telomere	  8	0.113810689204897	0.88413902838582	6	2	6718	7437	1.57975163593099
GO:1904871	positive regulation of protein localization to Cajal body	  7	0.0474968970055936	0.646585116783694	6	1	6718	7438	1.80543044106399
GO:1904874	positive regulation of telomerase RNA localization to Cajal body	 14	0.0625726545054608	0.771729405567349	10	4	6714	7435	1.50452536755333
GO:1904885	beta-catenin destruction complex assembly	  5	0.77940058892516	1	2	3	6722	7436	0.842534205829863
GO:1904886	beta-catenin destruction complex disassembly	 20	0.813860390499775	1	8	12	6716	7427	0.842534205829863
GO:1904903	ESCRT III complex disassembly	  9	0.69404490204849	1	4	5	6720	7434	0.936149117588737
GO:1904938	planar cell polarity pathway involved in axon guidance	  5	0.77940058892516	1	2	3	6722	7436	0.842534205829863
GO:1904948	midbrain dopaminergic neuron differentiation	  7	0.444912401367032	1	4	3	6720	7436	1.20362029404266
GO:1905050	positive regulation of metallopeptidase activity	  5	0.452745275304033	1	3	2	6721	7437	1.26380130874479
GO:1905515	non-motile cilium assembly	 35	0.261382282184478	1	19	16	6705	7423	1.14343927934053
GO:1990000	amyloid fibril formation	  9	0.438074670071218	1	5	4	6719	7435	1.17018639698592
GO:1990001	inhibition of cysteine-type endopeptidase activity involved in apoptotic process	  7	0.444912401367032	1	4	3	6720	7436	1.20362029404266
GO:1990023	mitotic spindle midzone	  5	0.77940058892516	1	2	3	6722	7436	0.842534205829863
GO:1990050	phosphatidic acid transporter activity	  5	0.452745275304033	1	3	2	6721	7437	1.26380130874479
GO:1990090	cellular response to nerve growth factor stimulus	 34	0.0324276974379125	0.568913889397054	22	12	6702	7427	1.3629229800189
GO:1990124	messenger ribonucleoprotein complex	  8	0.819878207576373	1	3	5	6721	7434	0.789875817965497
GO:1990126	retrograde transport, endosome to plasma membrane	 11	0.431935112460319	1	6	5	6718	7434	1.14891028067709
GO:1990130	GATOR1 complex	  5	0.452745275304033	1	3	2	6721	7437	1.26380130874479
GO:1990138	neuron projection extension	 19	0.592680980401227	1	9	10	6715	7429	0.997737875324838
GO:1990226	histone methyltransferase binding	  5	0.77940058892516	1	2	3	6722	7436	0.842534205829863
GO:1990234	transferase complex	  5	0.77940058892516	1	2	3	6722	7436	0.842534205829863
GO:1990239	steroid hormone binding	  6	0.0874151689581943	0.807895728316903	5	1	6719	7438	1.75527959547888
GO:1990246	uniplex complex	  5	0.77940058892516	1	2	3	6722	7436	0.842534205829863
GO:1990247	N6-methyladenosine-containing RNA binding	  6	0.0874151689581943	0.807895728316903	5	1	6719	7438	1.75527959547888
GO:1990253	cellular response to leucine starvation	  8	0.113810689204897	0.88413902838582	6	2	6718	7437	1.57975163593099
GO:1990266	neutrophil migration	  5	0.960049771736903	1	1	4	6723	7435	0.421267102914932
GO:1990314	cellular response to insulin-like growth factor stimulus	  6	0.607836179256654	1	3	3	6721	7436	1.05316775728733
GO:1990316	ATG1/ULK1 kinase complex	  8	0.113810689204897	0.88413902838582	6	2	6718	7437	1.57975163593099
GO:1990380	Lys48-specific deubiquitinase activity	 10	0.0390070262266277	0.625040317669623	8	2	6716	7437	1.68506841165973
GO:1990381	ubiquitin-specific protease binding	 13	0.0309498150207146	0.552600112408603	10	3	6714	7436	1.62025808813435
GO:1990391	DNA repair complex	  5	0.452745275304033	1	3	2	6721	7437	1.26380130874479
GO:1990403	embryonic brain development	  7	0.444912401367032	1	4	3	6720	7436	1.20362029404266
GO:1990416	cellular response to brain-derived neurotrophic factor stimulus	  8	0.819878207576373	1	3	5	6721	7434	0.789875817965497
GO:1990440	positive regulation of transcription from RNA polymerase II promoter in response to endoplasmic reticulum stress	  7	0.919244306193629	1	2	5	6722	7434	0.601810147021331
GO:1990441	negative regulation of transcription from RNA polymerase II promoter in response to endoplasmic reticulum stress	  5	0.960049771736903	1	1	4	6723	7435	0.421267102914932
GO:1990454	L-type voltage-gated calcium channel complex	  7	0.444912401367032	1	4	3	6720	7436	1.20362029404266
GO:1990459	transferrin receptor binding	  8	0.580280354503036	1	4	4	6720	7435	1.05316775728733
GO:1990573	potassium ion import across plasma membrane	  8	0.113810689204897	0.88413902838582	6	2	6718	7437	1.57975163593099
GO:1990592	protein K69-linked ufmylation	  5	0.157494903089267	0.919686434773344	4	1	6720	7438	1.68506841165973
GO:1990668	vesicle fusion with endoplasmic reticulum-Golgi intermediate compartment (ERGIC) membrane	  6	0.607836179256654	1	3	3	6721	7436	1.05316775728733
GO:1990712	HFE-transferrin receptor complex	  8	0.309544448231027	1	5	3	6719	7436	1.31645969660916
GO:1990782	protein tyrosine kinase binding	 10	0.316545776550851	1	6	4	6718	7435	1.26380130874479
GO:1990822	basic amino acid transmembrane transport	  6	0.979023167332401	1	1	5	6723	7434	0.351055919095776
GO:1990825	sequence-specific mRNA binding	  6	0.297654371351411	1	4	2	6720	7437	1.40422367638311
GO:1990830	cellular response to leukemia inhibitory factor	 89	0.244498603602711	1	46	43	6678	7396	1.08866779404982
GO:1990841	promoter-specific chromatin binding	 24	0.780026211443039	1	10	14	6714	7425	0.877639797739441
GO:1990909	Wnt signalosome	  9	0.067355898427907	0.780679208284898	7	2	6717	7437	1.63826095578029
GO:2000001	regulation of DNA damage checkpoint	  8	0.309544448231027	1	5	3	6719	7436	1.31645969660916
GO:2000008	regulation of protein localization to cell surface	  8	0.025392299605826	0.495149842313607	7	1	6717	7438	1.84304357525283
GO:2000009	negative regulation of protein localization to cell surface	 11	0.0221890923454724	0.495149842313607	9	2	6715	7437	1.72336542101563
GO:2000010	positive regulation of protein localization to cell surface	 11	0.431935112460319	1	6	5	6718	7434	1.14891028067709
GO:2000020	positive regulation of male gonad development	  5	0.77940058892516	1	2	3	6722	7436	0.842534205829863
GO:2000036	regulation of stem cell population maintenance	 10	0.559603563591584	1	5	5	6719	7434	1.05316775728733
GO:2000042	negative regulation of double-strand break repair via homologous recombination	  6	0.607836179256654	1	3	3	6721	7436	1.05316775728733
GO:2000045	regulation of G1/S transition of mitotic cell cycle	 11	0.665993939534306	1	5	6	6719	7433	0.957425233897572
GO:2000049	positive regulation of cell-cell adhesion mediated by cadherin	  5	0.960049771736903	1	1	4	6723	7435	0.421267102914932
GO:2000052	positive regulation of non-canonical Wnt signaling pathway	  5	0.77940058892516	1	2	3	6722	7436	0.842534205829863
GO:2000059	negative regulation of protein ubiquitination involved in ubiquitin-dependent protein catabolic process	 12	0.320810094151237	1	7	5	6717	7434	1.22869571683522
GO:2000060	positive regulation of protein ubiquitination involved in ubiquitin-dependent protein catabolic process	 13	0.933471720877997	1	4	9	6720	7430	0.648103235253741
GO:2000096	positive regulation of Wnt signaling pathway, planar cell polarity pathway	  7	0.919244306193629	1	2	5	6722	7434	0.601810147021331
GO:2000107	negative regulation of leukocyte apoptotic process	  6	0.865182793759413	1	2	4	6722	7435	0.702111838191553
GO:2000114	regulation of establishment of cell polarity	 14	0.529251719099727	1	7	7	6717	7432	1.05316775728733
GO:2000117	negative regulation of cysteine-type endopeptidase activity	 14	0.998346203775137	1	2	12	6722	7427	0.300905073510665
GO:2000121	regulation of removal of superoxide radicals	  5	0.960049771736903	1	1	4	6723	7435	0.421267102914932
GO:2000134	negative regulation of G1/S transition of mitotic cell cycle	 25	0.557266861497771	1	12	13	6712	7426	1.01104104699584
GO:2000144	positive regulation of DNA-templated transcription, initiation	  7	0.444912401367032	1	4	3	6720	7436	1.20362029404266
GO:2000145	regulation of cell motility	 25	0.70711219518503	1	11	14	6713	7425	0.926787626412849
GO:2000146	negative regulation of cell motility	 11	0.850917330440019	1	4	7	6720	7432	0.765940187118057
GO:2000147	positive regulation of cell motility	 13	0.426320358160906	1	7	6	6717	7433	1.13418066169405
GO:2000171	negative regulation of dendrite development	  7	0.187210848839696	0.949543953868825	5	2	6719	7437	1.50452536755333
GO:2000177	regulation of neural precursor cell proliferation	  8	0.819878207576373	1	3	5	6721	7434	0.789875817965497
GO:2000178	negative regulation of neural precursor cell proliferation	 10	0.983985908365184	1	2	8	6722	7431	0.421267102914932
GO:2000179	positive regulation of neural precursor cell proliferation	 13	0.933471720877997	1	4	9	6720	7430	0.648103235253741
GO:2000188	regulation of cholesterol homeostasis	  8	0.952366339066048	1	2	6	6722	7433	0.526583878643665
GO:2000210	positive regulation of anoikis	  5	0.960049771736903	1	1	4	6723	7435	0.421267102914932
GO:2000234	positive regulation of rRNA processing	  6	0.297654371351411	1	4	2	6720	7437	1.40422367638311
GO:2000249	regulation of actin cytoskeleton reorganization	 16	0.94165410331218	1	5	11	6719	7428	0.658229848304581
GO:2000251	positive regulation of actin cytoskeleton reorganization	 14	0.875453509540804	1	5	9	6719	7430	0.752262683776664
GO:2000252	negative regulation of feeding behavior	  6	0.979023167332401	1	1	5	6723	7434	0.351055919095776
GO:2000270	negative regulation of fibroblast apoptotic process	  7	0.444912401367032	1	4	3	6720	7436	1.20362029404266
GO:2000271	positive regulation of fibroblast apoptotic process	  7	0.187210848839696	0.949543953868825	5	2	6719	7437	1.50452536755333
GO:2000272	negative regulation of receptor activity	  5	0.77940058892516	1	2	3	6722	7436	0.842534205829863
GO:2000273	positive regulation of receptor activity	 12	0.0514533113817507	0.679607581911819	9	3	6715	7436	1.57975163593099
GO:2000279	negative regulation of DNA biosynthetic process	 10	0.78367246101976	1	4	6	6720	7433	0.842534205829863
GO:2000288	positive regulation of myoblast proliferation	  5	0.960049771736903	1	1	4	6723	7435	0.421267102914932
GO:2000300	regulation of synaptic vesicle exocytosis	 12	0.0514533113817507	0.679607581911819	9	3	6715	7436	1.57975163593099
GO:2000304	positive regulation of ceramide biosynthetic process	  8	0.819878207576373	1	3	5	6721	7434	0.789875817965497
GO:2000310	regulation of NMDA receptor activity	 15	0.421118865258844	1	8	7	6716	7432	1.12337894110648
GO:2000311	regulation of AMPA receptor activity	 16	0.517377397284026	1	8	8	6716	7431	1.05316775728733
GO:2000323	negative regulation of glucocorticoid receptor signaling pathway	  5	0.77940058892516	1	2	3	6722	7436	0.842534205829863
GO:2000344	positive regulation of acrosome reaction	  5	0.77940058892516	1	2	3	6722	7436	0.842534205829863
GO:2000352	negative regulation of endothelial cell apoptotic process	 22	0.999058190015592	1	4	18	6720	7421	0.382970093559029
GO:2000353	positive regulation of endothelial cell apoptotic process	 13	0.933471720877997	1	4	9	6720	7430	0.648103235253741
GO:2000369	regulation of clathrin-dependent endocytosis	  8	0.819878207576373	1	3	5	6721	7434	0.789875817965497
GO:2000377	regulation of reactive oxygen species metabolic process	 20	0.0888797275608513	0.807895728316903	13	7	6711	7432	1.36911808447353
GO:2000378	negative regulation of reactive oxygen species metabolic process	 21	0.0609416617953418	0.764685373658072	14	7	6710	7432	1.40422367638311
GO:2000379	positive regulation of reactive oxygen species metabolic process	 27	0.993722653510536	1	7	20	6717	7419	0.546086985260096
GO:2000394	positive regulation of lamellipodium morphogenesis	  7	0.730029012673872	1	3	4	6721	7435	0.902715220531996
GO:2000406	positive regulation of T cell migration	 12	0.999560983443925	1	1	11	6723	7428	0.175527959547888
GO:2000427	positive regulation of apoptotic cell clearance	  5	1	1	0	5	6724	7434	0
GO:2000463	positive regulation of excitatory postsynaptic potential	 22	0.189941610858229	0.956669265160296	13	9	6711	7430	1.24465280406684
GO:2000480	negative regulation of cAMP-dependent protein kinase activity	  8	0.309544448231027	1	5	3	6719	7436	1.31645969660916
GO:2000483	negative regulation of interleukin-8 secretion	  5	1	1	0	5	6724	7434	0
GO:2000484	positive regulation of interleukin-8 secretion	 11	0.990836032904502	1	2	9	6722	7430	0.382970093559029
GO:2000505	regulation of energy homeostasis	 11	0.220387996626296	1	7	4	6717	7435	1.3403953274566
GO:2000507	positive regulation of energy homeostasis	  6	0.979023167332401	1	1	5	6723	7434	0.351055919095776
GO:2000510	positive regulation of dendritic cell chemotaxis	  6	0.297654371351411	1	4	2	6720	7437	1.40422367638311
GO:2000535	regulation of entry of bacterium into host cell	  5	0.77940058892516	1	2	3	6722	7436	0.842534205829863
GO:2000543	positive regulation of gastrulation	  5	0.960049771736903	1	1	4	6723	7435	0.421267102914932
GO:2000573	positive regulation of DNA biosynthetic process	 12	0.971055765853963	1	3	9	6721	7430	0.526583878643665
GO:2000582	positive regulation of ATP-dependent microtubule motor activity, plus-end-directed	  5	0.77940058892516	1	2	3	6722	7436	0.842534205829863
GO:2000587	negative regulation of platelet-derived growth factor receptor-beta signaling pathway	  7	0.730029012673872	1	3	4	6721	7435	0.902715220531996
GO:2000601	positive regulation of Arp2/3 complex-mediated actin nucleation	  7	0.919244306193629	1	2	5	6722	7434	0.601810147021331
GO:2000617	positive regulation of histone H3-K9 acetylation	  6	0.607836179256654	1	3	3	6721	7436	1.05316775728733
GO:2000637	positive regulation of gene silencing by miRNA	  9	0.69404490204849	1	4	5	6720	7434	0.936149117588737
GO:2000641	regulation of early endosome to late endosome transport	  7	0.444912401367032	1	4	3	6720	7436	1.20362029404266
GO:2000643	positive regulation of early endosome to late endosome transport	  8	0.113810689204897	0.88413902838582	6	2	6718	7437	1.57975163593099
GO:2000647	negative regulation of stem cell proliferation	  5	1	1	0	5	6724	7434	0
GO:2000648	positive regulation of stem cell proliferation	  9	0.996964464269463	1	1	8	6723	7431	0.234037279397184
GO:2000649	regulation of sodium ion transmembrane transporter activity	 14	0.160610520833599	0.919686434773344	9	5	6715	7434	1.35407283079799
GO:2000650	negative regulation of sodium ion transmembrane transporter activity	  7	0.730029012673872	1	3	4	6721	7435	0.902715220531996
GO:2000651	positive regulation of sodium ion transmembrane transporter activity	  6	0.297654371351411	1	4	2	6720	7437	1.40422367638311
GO:2000675	negative regulation of type B pancreatic cell apoptotic process	  5	0.452745275304033	1	3	2	6721	7437	1.26380130874479
GO:2000678	negative regulation of transcription regulatory region DNA binding	 14	0.875453509540804	1	5	9	6719	7430	0.752262683776664
GO:2000679	positive regulation of transcription regulatory region DNA binding	 10	0.925275888620553	1	3	7	6721	7432	0.631900654372397
GO:2000726	negative regulation of cardiac muscle cell differentiation	  5	0.452745275304033	1	3	2	6721	7437	1.26380130874479
GO:2000727	positive regulation of cardiac muscle cell differentiation	  8	0.113810689204897	0.88413902838582	6	2	6718	7437	1.57975163593099
GO:2000737	negative regulation of stem cell differentiation	  9	0.438074670071218	1	5	4	6719	7435	1.17018639698592
GO:2000766	negative regulation of cytoplasmic translation	  6	0.865182793759413	1	2	4	6722	7435	0.702111838191553
GO:2000772	regulation of cellular senescence	 11	0.665993939534306	1	5	6	6719	7433	0.957425233897572
GO:2000773	negative regulation of cellular senescence	 10	0.78367246101976	1	4	6	6720	7433	0.842534205829863
GO:2000774	positive regulation of cellular senescence	  7	0.187210848839696	0.949543953868825	5	2	6719	7437	1.50452536755333
GO:2000778	positive regulation of interleukin-6 secretion	 17	0.895242422289557	1	6	11	6718	7428	0.743412534555762
GO:2000780	negative regulation of double-strand break repair	  5	0.452745275304033	1	3	2	6721	7437	1.26380130874479
GO:2000781	positive regulation of double-strand break repair	  7	0.444912401367032	1	4	3	6720	7436	1.20362029404266
GO:2000785	regulation of autophagosome assembly	 11	0.220387996626296	1	7	4	6717	7435	1.3403953274566
GO:2000786	positive regulation of autophagosome assembly	 10	0.316545776550851	1	6	4	6718	7435	1.26380130874479
GO:2000809	positive regulation of synaptic vesicle clustering	  5	0.452745275304033	1	3	2	6721	7437	1.26380130874479
GO:2000810	regulation of bicellular tight junction assembly	 13	0.982330979346752	1	3	10	6721	7429	0.486077426440306
GO:2000811	negative regulation of anoikis	 15	0.914031171019375	1	5	10	6719	7429	0.702111838191553
GO:2000821	regulation of grooming behavior	  6	0.865182793759413	1	2	4	6722	7435	0.702111838191553
GO:2000969	positive regulation of AMPA receptor activity	  5	0.77940058892516	1	2	3	6722	7436	0.842534205829863
GO:2001014	regulation of skeletal muscle cell differentiation	  5	0.157494903089267	0.919686434773344	4	1	6720	7438	1.68506841165973
GO:2001020	regulation of response to DNA damage stimulus	 10	0.925275888620553	1	3	7	6721	7432	0.631900654372397
GO:2001022	positive regulation of response to DNA damage stimulus	  9	0.69404490204849	1	4	5	6720	7434	0.936149117588737
GO:2001028	positive regulation of endothelial cell chemotaxis	  6	0.865182793759413	1	2	4	6722	7435	0.702111838191553
GO:2001046	positive regulation of integrin-mediated signaling pathway	  6	0.865182793759413	1	2	4	6722	7435	0.702111838191553
GO:2001054	negative regulation of mesenchymal cell apoptotic process	  6	0.979023167332401	1	1	5	6723	7434	0.351055919095776
GO:2001056	positive regulation of cysteine-type endopeptidase activity	  5	0.960049771736903	1	1	4	6723	7435	0.421267102914932
GO:2001171	positive regulation of ATP biosynthetic process	  6	0.297654371351411	1	4	2	6720	7437	1.40422367638311
GO:2001199	negative regulation of dendritic cell differentiation	  5	0.960049771736903	1	1	4	6723	7435	0.421267102914932
GO:2001214	positive regulation of vasculogenesis	 10	0.983985908365184	1	2	8	6722	7431	0.421267102914932
GO:2001222	regulation of neuron migration	 10	0.983985908365184	1	2	8	6722	7431	0.421267102914932
GO:2001223	negative regulation of neuron migration	  8	0.309544448231027	1	5	3	6719	7436	1.31645969660916
GO:2001224	positive regulation of neuron migration	  6	0.865182793759413	1	2	4	6722	7435	0.702111838191553
GO:2001234	negative regulation of apoptotic signaling pathway	 18	0.506938913103874	1	9	9	6715	7430	1.05316775728733
GO:2001235	positive regulation of apoptotic signaling pathway	 25	0.70711219518503	1	11	14	6713	7425	0.926787626412849
GO:2001237	negative regulation of extrinsic apoptotic signaling pathway	 34	0.208644247909752	0.99200543569612	19	15	6705	7424	1.17706984637996
GO:2001238	positive regulation of extrinsic apoptotic signaling pathway	 25	0.912607021347774	1	9	16	6715	7423	0.758280785246877
GO:2001240	negative regulation of extrinsic apoptotic signaling pathway in absence of ligand	 28	0.855143171976428	1	11	17	6713	7422	0.82748895215433
GO:2001241	positive regulation of extrinsic apoptotic signaling pathway in absence of ligand	 12	0.75380380293781	1	5	7	6719	7432	0.877639797739441
GO:2001243	negative regulation of intrinsic apoptotic signaling pathway	 17	0.118839522247653	0.899006189270582	11	6	6713	7433	1.3629229800189
GO:2001244	positive regulation of intrinsic apoptotic signaling pathway	 30	0.605736885713723	1	14	16	6710	7423	0.982956573468174
GO:2001256	regulation of store-operated calcium entry	  8	0.952366339066048	1	2	6	6722	7433	0.526583878643665
GO:2001259	positive regulation of cation channel activity	  7	0.444912401367032	1	4	3	6720	7436	1.20362029404266
GO:2001268	negative regulation of cysteine-type endopeptidase activity involved in apoptotic signaling pathway	  5	0.77940058892516	1	2	3	6722	7436	0.842534205829863
GO:2001269	positive regulation of cysteine-type endopeptidase activity involved in apoptotic signaling pathway	  6	0.865182793759413	1	2	4	6722	7435	0.702111838191553
GO:2001275	positive regulation of glucose import in response to insulin stimulus	 11	0.220387996626296	1	7	4	6717	7435	1.3403953274566
