Term	Accession	Genes (tot)	Stat (non-dir.) p	p adj (non-dir.)	Significant..in.gene.set.	Non.significant..in.gene.set.	Significant..not.in.gene.set.	Non.significant..not.in.gene.set.	effect.size
IPR000001	Kringle	12	0.898382914875138	1	4	8	6743	7483	0.703423743886172
IPR000003	Retinoid X receptor/HNF4	 5	0.7781801260834	1	2	3	6745	7488	0.844108492663406
IPR000006	Metallothionein, vertebrate	 7	0.918536112180723	1	2	5	6745	7486	0.602934637616719
IPR000007	Tubby, C-terminal	 5	0.451093636045012	1	3	2	6744	7489	1.26616273899511
IPR000010	Cystatin domain	12	1	1	0	12	6747	7479	0
IPR000014	PAS domain	30	0.734037330539774	1	13	17	6734	7474	0.914450867052023
IPR000033	LDLR class B repeat	12	0.318565851958547	0.996215854772117	7	5	6740	7486	1.2309915518008
IPR000034	Laminin IV	 8	0.951870028050764	1	2	6	6745	7485	0.527567807914629
IPR000047	Helix-turn-helix motif	18	0.999990550122477	1	1	17	6746	7474	0.117237290647695
IPR000048	IQ motif, EF-hand binding site	62	0.768112773329093	1	27	35	6720	7456	0.918989084754515
IPR000058	Zinc finger, AN1-type	 8	0.0250958861430055	0.400696547198938	7	1	6740	7490	1.8464873277012
IPR000061	SWAP/Surp	 6	0.296087778157783	0.996215854772117	4	2	6743	7489	1.40684748777234
IPR000072	PDGF/VEGF domain	 8	0.818534364570598	1	3	5	6744	7486	0.791351711871943
IPR000073	Alpha/beta hydrolase fold-1	25	0.553727479428808	1	12	13	6735	7478	1.01293019119609
IPR000082	SEA domain	12	0.994702855212401	1	2	10	6745	7481	0.351711871943086
IPR000086	NUDIX hydrolase domain	25	0.143771550836479	0.806571393258297	15	10	6732	7481	1.26616273899511
IPR000089	Biotin/lipoyl attachment	 9	0.0666543852588519	0.639451333797848	7	2	6740	7489	1.64132206906773
IPR000095	CRIB domain	18	0.322822594532801	0.996215854772117	10	8	6737	7483	1.17237290647695
IPR000152	EGF-type aspartate/asparagine hydroxylation site	83	0.901084537200861	1	34	49	6713	7442	0.864448456342042
IPR000156	Ran binding domain	 6	0.606099493932241	1	3	3	6744	7488	1.05513561582926
IPR000157	Toll/interleukin-1 receptor homology (TIR) domain	21	0.998395649865949	1	4	17	6743	7474	0.401956425077812
IPR000159	Ras-associating (RA) domain	37	0.258114147944894	0.989333404834788	20	17	6727	7474	1.14068715224785
IPR000162	GPCR, family 3, metabotropic glutamate receptor	 7	0.728431267104624	1	3	4	6744	7487	0.904401956425078
IPR000169	Cysteine peptidase, cysteine active site	17	0.98873099117697	1	4	13	6743	7478	0.496534407449062
IPR000175	Sodium:neurotransmitter symporter	16	0.704217300302988	1	7	9	6740	7482	0.9232436638506
IPR000182	GNAT domain	20	0.494401109409875	1	10	10	6737	7481	1.05513561582926
IPR000192	Aminotransferase class V domain	 5	0.7781801260834	1	2	3	6745	7488	0.844108492663406
IPR000194	ATPase, F1/V1/A1 complex, alpha/beta subunit, nucleotide-binding domain	 5	0.156501784621734	0.806571393258297	4	1	6743	7490	1.68821698532681
IPR000195	Rab-GTPase-TBC domain	37	0.164028869709389	0.829577318689977	21	16	6726	7475	1.19772150986024
IPR000198	Rho GTPase-activating protein domain	59	0.54672099768538	1	28	31	6719	7460	1.00148465231252
IPR000203	GPS motif	22	0.895191698747345	1	8	14	6739	7477	0.767371356966733
IPR000209	Peptidase S8/S53 domain	11	0.849533330740884	1	4	7	6743	7484	0.767371356966733
IPR000215	Serpin family	22	0.999849221111008	1	3	19	6744	7472	0.287764258862525
IPR000217	Tubulin	17	0.241300442408668	0.962162721241616	10	7	6737	7484	1.24133601862266
IPR000219	Dbl homology (DH) domain	62	0.2941108390104	0.996215854772117	32	30	6715	7461	1.08917224859794
IPR000222	PPM-type phosphatase, divalent cation binding	11	0.218609653443	0.910681793158603	7	4	6740	7487	1.34289987469178
IPR000225	Armadillo	36	0.44047278956618	1	18	18	6729	7473	1.05513561582926
IPR000233	Cadherin, cytoplasmic domain	19	0.999909843383686	1	2	17	6745	7474	0.222133813858791
IPR000237	GRIP domain	 6	0.0867087878537095	0.700306179451134	5	1	6742	7490	1.75855935971543
IPR000239	GPCR kinase	 6	0.296087778157783	0.996215854772117	4	2	6743	7489	1.40684748777234
IPR000242	PTP type protein phosphatase	34	0.0136875069011754	0.355202023353453	23	11	6724	7480	1.42753642141605
IPR000243	Peptidase T1A, proteasome beta-subunit	 5	0.451093636045012	1	3	2	6744	7489	1.26616273899511
IPR000253	Forkhead-associated (FHA) domain	32	0.317403648795822	0.996215854772117	17	15	6730	7476	1.12108159181859
IPR000261	EH domain	11	0.0218793801836401	0.400696547198938	9	2	6738	7489	1.72658555317515
IPR000270	PB1 domain	13	0.423763673143334	1	7	6	6740	7485	1.13629989396997
IPR000286	Histone deacetylase superfamily	11	0.663808308432488	1	5	6	6742	7485	0.959214196208416
IPR000294	Gamma-carboxyglutamic acid-rich (GLA) domain	12	0.970652870999419	1	3	9	6744	7482	0.527567807914629
IPR000299	FERM domain	45	0.00705338074766788	0.331550196952537	30	15	6717	7476	1.40684748777234
IPR000300	Inositol polyphosphate-related phosphatase	10	0.132273529234937	0.806571393258297	7	3	6740	7488	1.47718986216096
IPR000301	Tetraspanin	29	0.991137619568151	1	8	21	6739	7470	0.582143788043728
IPR000306	FYVE zinc finger	30	0.026187031860106	0.410436350837107	20	10	6727	7481	1.40684748777234
IPR000308	14-3-3 protein	 7	0.185910764499323	0.845680287938012	5	2	6742	7489	1.5073365940418
IPR000313	PWWP domain	21	0.0599599805192226	0.62262586120625	14	7	6733	7484	1.40684748777234
IPR000315	B-box-type zinc finger	54	0.918317831460127	1	21	33	6726	7458	0.820661034533867
IPR000326	Phosphatidic acid phosphatase type 2/haloperoxidase	16	0.322268893536235	0.996215854772117	9	7	6738	7484	1.18702756780791
IPR000327	POU-specific domain	 8	0.951870028050764	1	2	6	6745	7485	0.527567807914629
IPR000330	SNF2-related, N-terminal domain	30	0.00353478698851229	0.307613914450433	22	8	6725	7483	1.54753223654958
IPR000331	Rap GTPase activating protein domain	10	0.0385318949833867	0.498382293530479	8	2	6739	7489	1.68821698532681
IPR000333	Ser/Thr protein kinase, TGFB receptor	11	0.218609653443	0.910681793158603	7	4	6740	7487	1.34289987469178
IPR000337	GPCR, family 3	10	0.781996958992377	1	4	6	6743	7485	0.844108492663406
IPR000340	Dual specificity phosphatase, catalytic domain	37	0.258114147944894	0.989333404834788	20	17	6727	7474	1.14068715224785
IPR000341	Phosphatidylinositol 3-kinase Ras-binding (PI3K RBD) domain	 6	0.86422044215898	1	2	4	6745	7487	0.703423743886172
IPR000355	Chemokine receptor family	11	0.990694524510238	1	2	9	6745	7482	0.383685678483366
IPR000357	HEAT repeat	11	0.429568982367594	1	6	5	6741	7486	1.1510570354501
IPR000372	Leucine-rich repeat N-terminal domain	42	0.54843097014694	1	20	22	6727	7469	1.00489106269453
IPR000375	Dynamin central domain	 5	0.451093636045012	1	3	2	6744	7489	1.26616273899511
IPR000387	Tyrosine specific protein phosphatases domain	74	0.00736608048354998	0.331550196952537	46	28	6701	7463	1.31179022508502
IPR000403	Phosphatidylinositol 3-/4-kinase, catalytic domain	17	0.241300442408668	0.962162721241616	10	7	6737	7484	1.24133601862266
IPR000407	Nucleoside phosphatase GDA1/CD39	 7	0.728431267104624	1	3	4	6744	7487	0.904401956425078
IPR000408	Regulator of chromosome condensation, RCC1	19	0.589639638513052	1	9	10	6738	7481	0.99960216236456
IPR000409	BEACH domain	 9	0.435918072496767	1	5	4	6742	7487	1.17237290647695
IPR000413	Integrin alpha chain	12	0.898382914875138	1	4	8	6743	7483	0.703423743886172
IPR000418	Ets domain	20	0.91014755755552	1	7	13	6740	7478	0.73859493108048
IPR000421	Coagulation factor 5/8 C-terminal domain	20	0.322841903662727	0.996215854772117	11	9	6736	7482	1.16064917741218
IPR000425	Major intrinsic protein	 9	0.996918035182955	1	1	8	6746	7483	0.234474581295391
IPR000426	Proteasome alpha-subunit, N-terminal domain	 5	0.7781801260834	1	2	3	6745	7488	0.844108492663406
IPR000433	Zinc finger, ZZ-type	16	0.00600957462569238	0.331550196952537	13	3	6734	7488	1.71459537572254
IPR000436	Sushi/SCR/CCP domain	44	0.760748538017882	1	19	25	6728	7466	0.911253486397995
IPR000451	NF-kappa-B/Dorsal	 5	0.959711673474999	1	1	4	6746	7487	0.422054246331703
IPR000460	Neuroligin	 5	0.7781801260834	1	2	3	6745	7488	0.844108492663406
IPR000462	CDP-alcohol phosphatidyltransferase	 5	0.7781801260834	1	2	3	6745	7488	0.844108492663406
IPR000463	Cytosolic fatty-acid binding	13	0.932643324273574	1	4	9	6743	7482	0.649314225125697
IPR000467	G-patch domain	21	0.248941062915496	0.985184256488074	12	9	6735	7482	1.20586927523344
IPR000472	Activin types I and II receptor domain	 9	0.0666543852588519	0.639451333797848	7	2	6740	7489	1.64132206906773
IPR000483	Cysteine-rich flanking region, C-terminal	67	0.988978291347074	1	23	44	6724	7447	0.724421467584266
IPR000488	Death domain	31	0.525950323990666	1	15	16	6732	7475	1.02109898306057
IPR000494	Receptor L-domain	 7	0.44299046303573	1	4	3	6743	7488	1.20586927523344
IPR000500	Connexin	15	0.971750526562492	1	4	11	6743	7480	0.562738995108937
IPR000519	P-type trefoil domain	 6	0.978809919738203	1	1	5	6746	7486	0.351711871943086
IPR000535	Major sperm protein (MSP) domain	 7	0.728431267104624	1	3	4	6744	7487	0.904401956425078
IPR000536	Nuclear hormone receptor, ligand-binding domain	45	0.960262472424454	1	16	29	6731	7462	0.75031866014525
IPR000538	Link domain	12	0.898382914875138	1	4	8	6743	7483	0.703423743886172
IPR000539	Frizzled protein	10	0.781996958992377	1	4	6	6743	7485	0.844108492663406
IPR000542	Acyltransferase ChoActase/COT/CPT	 5	0.7781801260834	1	2	3	6745	7488	0.844108492663406
IPR000547	Clathrin, heavy chain/VPS, 7-fold repeat	 7	0.0470279971954641	0.527980989790211	6	1	6741	7490	1.80880391285016
IPR000555	JAB1/MPN/MOV34 metalloenzyme domain	10	0.5573358874939	1	5	5	6742	7486	1.05513561582926
IPR000557	Calponin repeat	 6	0.86422044215898	1	2	4	6745	7487	0.703423743886172
IPR000558	Histone H2B	 8	1	1	0	8	6747	7483	0
IPR000560	Histidine phosphatase superfamily, clade-2	 6	0.0113099877671744	0.331550196952537	6	0	6741	7491	2.11027123165852
IPR000562	Fibronectin, type II, collagen-binding	11	0.663808308432488	1	5	6	6742	7485	0.959214196208416
IPR000566	Lipocalin/cytosolic fatty-acid binding domain	23	0.989551167093213	1	6	17	6741	7474	0.550505538693526
IPR000569	HECT domain	28	0.0542111727771984	0.57594823158594	18	10	6729	7481	1.35660293463762
IPR000571	Zinc finger, CCCH-type	45	0.257399583904716	0.989333404834788	24	21	6723	7470	1.12547799021787
IPR000582	Acyl-CoA-binding protein, ACBP	 6	0.606099493932241	1	3	3	6744	7488	1.05513561582926
IPR000585	Hemopexin-like domain	14	0.989142891012179	1	3	11	6744	7480	0.452200978212539
IPR000591	DEP domain	21	0.576463182978234	1	10	11	6737	7480	1.00489106269453
IPR000594	THIF-type NAD/FAD binding fold	 9	0.435918072496767	1	5	4	6742	7487	1.17237290647695
IPR000595	Cyclic nucleotide-binding domain	30	0.734037330539774	1	13	17	6734	7474	0.914450867052023
IPR000601	PKD domain	11	0.429568982367594	1	6	5	6741	7486	1.1510570354501
IPR000608	Ubiquitin-conjugating enzyme E2	34	0.205662147781175	0.889516885075412	19	15	6728	7476	1.17926921769152
IPR000611	Neuropeptide Y receptor family	 5	0.7781801260834	1	2	3	6745	7488	0.844108492663406
IPR000626	Ubiquitin domain	47	0.172427552952844	0.845680287938012	26	21	6721	7470	1.16738408559833
IPR000629	ATP-dependent RNA helicase DEAD-box, conserved site	20	0.811712983546889	1	8	12	6739	7479	0.844108492663406
IPR000639	Epoxide hydrolase-like	 7	0.728431267104624	1	3	4	6744	7487	0.904401956425078
IPR000640	Translation elongation factor EFG, V domain	 7	0.185910764499323	0.845680287938012	5	2	6742	7489	1.5073365940418
IPR000644	CBS domain	17	0.241300442408668	0.962162721241616	10	7	6737	7484	1.24133601862266
IPR000648	Oxysterol-binding protein	12	0.0508017172795473	0.547068833017165	9	3	6738	7488	1.58270342374389
IPR000651	Ras-like guanine nucleotide exchange factor, N-terminal	20	0.811712983546889	1	8	12	6739	7479	0.844108492663406
IPR000668	Peptidase C1A, papain C-terminal	13	0.997002331611534	1	2	11	6745	7480	0.324657112562848
IPR000679	Zinc finger, GATA-type	11	0.849533330740884	1	4	7	6743	7484	0.767371356966733
IPR000690	Matrin/U1-C, C2H2-type zinc finger	 5	0.7781801260834	1	2	3	6745	7488	0.844108492663406
IPR000697	WH1/EVH1 domain	12	0.898382914875138	1	4	8	6743	7483	0.703423743886172
IPR000699	RIH (RyR and IP3R Homology) domain	 6	0.296087778157783	0.996215854772117	4	2	6743	7489	1.40684748777234
IPR000700	PAS-associated, C-terminal	 6	0.86422044215898	1	2	4	6745	7487	0.703423743886172
IPR000716	Thyroglobulin type-1	17	0.9603750928026	1	5	12	6742	7479	0.620668009311328
IPR000717	Proteasome component (PCI) domain	16	0.00600957462569238	0.331550196952537	13	3	6734	7488	1.71459537572254
IPR000718	Peptidase M13	 5	1	1	0	5	6747	7486	0
IPR000725	Olfactory receptor	36	0.999976085118457	1	6	30	6741	7461	0.351711871943086
IPR000727	Target SNARE coiled-coil homology domain	24	0.0452553677222199	0.527980989790211	16	8	6731	7483	1.40684748777234
IPR000731	Sterol-sensing domain	12	0.970652870999419	1	3	9	6744	7482	0.527567807914629
IPR000734	Triacylglycerol lipase family	 5	0.959711673474999	1	1	4	6746	7487	0.422054246331703
IPR000738	WHEP-TRS domain	 5	0.451093636045012	1	3	2	6744	7489	1.26616273899511
IPR000756	Diacylglycerol kinase, accessory domain	 9	0.0666543852588519	0.639451333797848	7	2	6740	7489	1.64132206906773
IPR000760	Inositol monophosphatase-like	 5	0.7781801260834	1	2	3	6745	7488	0.844108492663406
IPR000770	SAND domain	 8	0.818534364570598	1	3	5	6744	7486	0.791351711871943
IPR000772	Ricin B, lectin domain	29	0.676804805102135	1	13	16	6734	7475	0.945983655571058
IPR000795	Transcription factor, GTP-binding domain	17	0.604411925991478	1	8	9	6739	7482	0.993068814898125
IPR000798	Ezrin/radixin/moesin-like	18	0.0295829455676686	0.436244582711385	13	5	6734	7486	1.52408477842004
IPR000800	Notch domain	 6	0.606099493932241	1	3	3	6744	7488	1.05513561582926
IPR000804	Clathrin adaptor complex, small chain	 5	0.7781801260834	1	2	3	6745	7488	0.844108492663406
IPR000826	Formyl peptide receptor-related	 6	0.86422044215898	1	2	4	6745	7487	0.703423743886172
IPR000827	CC chemokine, conserved site	12	1	1	0	12	6747	7479	0
IPR000832	GPCR, family 2, secretin-like	32	0.952168301580737	1	11	21	6736	7470	0.725405735882614
IPR000834	Peptidase M14, carboxypeptidase A	15	0.796340355433979	1	6	9	6741	7482	0.844108492663406
IPR000836	Phosphoribosyltransferase domain	 5	0.959711673474999	1	1	4	6746	7487	0.422054246331703
IPR000837	AP-1 transcription factor	 9	0.971908527019724	1	2	7	6745	7484	0.468949162590781
IPR000850	Adenylate kinase/UMP-CMP kinase	 7	0.728431267104624	1	3	4	6744	7487	0.904401956425078
IPR000857	MyTH4 domain	 9	0.881735281659405	1	3	6	6744	7485	0.703423743886172
IPR000859	CUB domain	42	0.666827525387444	1	19	23	6728	7468	0.954646509559804
IPR000863	Sulfotransferase domain	22	0.995530602717999	1	5	17	6742	7474	0.479607098104208
IPR000866	Alkyl hydroperoxide reductase subunit C/ Thiol specific antioxidant	 5	0.451093636045012	1	3	2	6744	7489	1.26616273899511
IPR000867	Insulin-like growth factor-binding protein, IGFBP	17	0.98873099117697	1	4	13	6743	7478	0.496534407449062
IPR000873	AMP-dependent synthetase/ligase	22	0.322470762069609	0.996215854772117	12	10	6735	7481	1.1510570354501
IPR000884	Thrombospondin type-1 (TSP1) repeat	52	0.989027328797492	1	17	35	6730	7456	0.689896364196053
IPR000885	Fibrillar collagen, C-terminal	10	0.314500257499634	0.996215854772117	6	4	6741	7487	1.26616273899511
IPR000889	Glutathione peroxidase	 6	0.978809919738203	1	1	5	6746	7486	0.351711871943086
IPR000904	Sec7 domain	16	0.168402871096864	0.838307374045079	10	6	6737	7485	1.31891951978657
IPR000906	ZU5 domain	11	0.218609653443	0.910681793158603	7	4	6740	7487	1.34289987469178
IPR000907	Lipoxygenase	 5	0.959711673474999	1	1	4	6746	7487	0.422054246331703
IPR000909	Phosphatidylinositol-specific phospholipase C, X domain	18	0.99299119807509	1	4	14	6743	7477	0.468949162590781
IPR000917	Sulfatase, N-terminal	16	0.940825060983318	1	5	11	6742	7480	0.659459759893286
IPR000920	Myelin P0 protein-related	 6	0.606099493932241	1	3	3	6744	7488	1.05513561582926
IPR000922	D-galactoside/L-rhamnose binding SUEL lectin domain	 5	0.7781801260834	1	2	3	6745	7488	0.844108492663406
IPR000938	CAP Gly-rich domain	10	0.0385318949833867	0.498382293530479	8	2	6739	7489	1.68821698532681
IPR000949	ELM2 domain	12	0.751834162472378	1	5	7	6742	7484	0.879279679857714
IPR000953	Chromo/chromo shadow domain	29	0.388086487993054	1	15	14	6732	7477	1.09151960258199
IPR000961	AGC-kinase, C-terminal	53	0.175416910228911	0.845680287938012	29	24	6718	7467	1.15467671166221
IPR000971	Globin	 6	0.978809919738203	1	1	5	6746	7486	0.351711871943086
IPR000975	Interleukin-1 family	 5	1	1	0	5	6747	7486	0
IPR000994	Peptidase M24	 9	0.205164220540816	0.889516885075412	6	3	6741	7488	1.40684748777234
IPR000998	MAM domain	14	0.989142891012179	1	3	11	6744	7480	0.452200978212539
IPR001003	MHC class II, alpha chain, N-terminal	 5	0.959711673474999	1	1	4	6746	7487	0.422054246331703
IPR001005	SANT/Myb domain	40	0.556155953460364	1	19	21	6728	7470	1.00237883503779
IPR001007	VWFC domain	33	0.863519747028549	1	13	20	6734	7471	0.831318970047294
IPR001012	UBX domain	13	0.228396290943016	0.934241159076989	8	5	6739	7486	1.29862845025139
IPR001019	Guanine nucleotide binding protein (G-protein), alpha subunit	14	0.726291373176396	1	6	8	6741	7483	0.904401956425078
IPR001024	PLAT/LH2 domain	14	0.956069496368817	1	4	10	6743	7481	0.602934637616719
IPR001025	Bromo adjacent homology (BAH) domain	10	0.314500257499634	0.996215854772117	6	4	6741	7487	1.26616273899511
IPR001039	MHC class I alpha chain, alpha1 alpha2 domains	 7	0.918536112180723	1	2	5	6745	7486	0.602934637616719
IPR001041	2Fe-2S ferredoxin-type iron-sulfur binding domain	 5	0.451093636045012	1	3	2	6744	7489	1.26616273899511
IPR001054	Adenylyl cyclase class-3/4/guanylyl cyclase	16	0.982059015088883	1	4	12	6743	7479	0.527567807914629
IPR001060	FCH domain	19	0.754052618694394	1	8	11	6739	7480	0.888535255435164
IPR001064	Beta/gamma crystallin	12	0.999552003041346	1	1	11	6746	7480	0.175855935971543
IPR001067	Nuclear translocator	 7	0.918536112180723	1	2	5	6745	7486	0.602934637616719
IPR001071	Cellular retinaldehyde binding/alpha-tocopherol transport	 7	0.44299046303573	1	4	3	6743	7488	1.20586927523344
IPR001073	C1q domain	20	0.811712983546889	1	8	12	6739	7479	0.844108492663406
IPR001079	Galectin, carbohydrate recognition domain	 9	0.971908527019724	1	2	7	6745	7484	0.468949162590781
IPR001089	CXC chemokine	 9	0.971908527019724	1	2	7	6745	7484	0.468949162590781
IPR001090	Ephrin receptor ligand binding domain	12	0.751834162472378	1	5	7	6742	7484	0.879279679857714
IPR001094	Flavodoxin-like	 6	0.86422044215898	1	2	4	6745	7487	0.703423743886172
IPR001101	Plectin repeat	 7	0.728431267104624	1	3	4	6744	7487	0.904401956425078
IPR001102	Transglutaminase, N-terminal	 7	0.988855554331116	1	1	6	6746	7485	0.301467318808359
IPR001107	Band 7 domain	 9	0.692132530392986	1	4	5	6743	7486	0.937898325181562
IPR001111	TGF-beta, propeptide	19	0.995679262798907	1	4	15	6743	7476	0.444267627717582
IPR001124	Lipid-binding serum glycoprotein, C-terminal	 6	0.978809919738203	1	1	5	6746	7486	0.351711871943086
IPR001128	Cytochrome P450	36	0.937297554404132	1	13	23	6734	7468	0.762042389210019
IPR001129	Membrane-associated, eicosanoid/glutathione metabolism (MAPEG) protein	 6	0.978809919738203	1	1	5	6746	7486	0.351711871943086
IPR001132	SMAD domain, Dwarfin-type	 8	0.307721488076794	0.996215854772117	5	3	6742	7488	1.31891951978657
IPR001134	Netrin domain	21	0.992945773587864	1	5	16	6742	7475	0.502445531347265
IPR001148	Alpha carbonic anhydrase	15	0.796340355433979	1	6	9	6741	7482	0.844108492663406
IPR001158	DIX domain	 6	1	1	0	6	6747	7485	0
IPR001163	LSM domain, eukaryotic/archaea-type	17	0.604411925991478	1	8	9	6739	7482	0.993068814898125
IPR001164	Arf GTPase activating protein	22	0.652020089710302	1	10	12	6737	7479	0.959214196208416
IPR001173	Glycosyltransferase 2-like	24	0.321808393417566	0.996215854772117	13	11	6734	7480	1.14306358381503
IPR001179	FKBP-type peptidyl-prolyl cis-trans isomerase domain	13	0.821296993728656	1	5	8	6742	7483	0.811642781407121
IPR001180	Citron homology (CNH) domain	15	0.235719255914089	0.951896893142864	9	6	6738	7485	1.26616273899511
IPR001190	SRCR domain	23	0.999991756362382	1	2	21	6745	7470	0.183501846231175
IPR001192	Phosphoinositide phospholipase C family	13	0.997002331611534	1	2	11	6745	7480	0.324657112562848
IPR001194	DENN domain	16	0.704217300302988	1	7	9	6740	7482	0.9232436638506
IPR001199	Cytochrome b5-like heme/steroid binding domain	12	0.0508017172795473	0.547068833017165	9	3	6738	7488	1.58270342374389
IPR001202	WW domain	52	0.0280681690526977	0.431377782625441	32	20	6715	7471	1.29862845025139
IPR001206	Diacylglycerol kinase, catalytic domain	13	0.0964724174428019	0.737757665758239	9	4	6738	7487	1.46095700653282
IPR001208	MCM domain	 8	0.578259437994666	1	4	4	6743	7487	1.05513561582926
IPR001211	Phospholipase A2	 5	1	1	0	5	6747	7486	0
IPR001212	Somatomedin B domain	 7	0.728431267104624	1	3	4	6744	7487	0.904401956425078
IPR001214	SET domain	43	0.103637535697739	0.777527104310525	25	18	6722	7473	1.22690187887123
IPR001217	Transcription factor STAT	 7	0.185910764499323	0.845680287938012	5	2	6742	7489	1.5073365940418
IPR001223	Glycoside hydrolase family 18, catalytic domain	 7	0.728431267104624	1	3	4	6744	7487	0.904401956425078
IPR001236	Lactate/malate dehydrogenase, N-terminal	 5	0.156501784621734	0.806571393258297	4	1	6743	7490	1.68821698532681
IPR001247	Exoribonuclease, phosphorolytic domain 1	 7	0.185910764499323	0.845680287938012	5	2	6742	7489	1.5073365940418
IPR001251	CRAL-TRIO lipid binding domain	25	0.0305894811629588	0.436244582711385	17	8	6730	7483	1.43498443752779
IPR001254	Serine proteases, trypsin domain	74	0.999999999999777	1	7	67	6740	7424	0.199620251643373
IPR001258	NHL repeat	 8	0.578259437994666	1	4	4	6743	7487	1.05513561582926
IPR001263	Phosphoinositide 3-kinase, accessory (PIK) domain	 9	0.692132530392986	1	4	5	6743	7486	0.937898325181562
IPR001279	Metallo-beta-lactamase	19	0.408621506536301	1	10	9	6737	7482	1.11066906929396
IPR001283	Cysteine-rich  secretory protein, allergen V5/Tpx-1-related	 6	1	1	0	6	6747	7485	0
IPR001293	Zinc finger, TRAF-type	12	0.751834162472378	1	5	7	6742	7484	0.879279679857714
IPR001298	Filamin/ABP280 repeat	 9	0.881735281659405	1	3	6	6744	7485	0.703423743886172
IPR001300	Peptidase C2, calpain, catalytic domain	 9	0.692132530392986	1	4	5	6743	7486	0.937898325181562
IPR001304	C-type lectin-like	49	0.999978069715882	1	10	39	6737	7452	0.430667598297656
IPR001305	Heat shock protein DnaJ, cysteine-rich domain	 5	0.451093636045012	1	3	2	6744	7489	1.26616273899511
IPR001309	Peptidase C14,  p20 domain	11	0.849533330740884	1	4	7	6743	7484	0.767371356966733
IPR001312	Hexokinase	 5	0.959711673474999	1	1	4	6746	7487	0.422054246331703
IPR001314	Peptidase S1A, chymotrypsin family	68	0.999999999999341	1	6	62	6741	7429	0.186200402793398
IPR001315	CARD domain	24	0.945062616694499	1	8	16	6739	7475	0.703423743886172
IPR001320	Ionotropic glutamate receptor	15	0.796340355433979	1	6	9	6741	7482	0.844108492663406
IPR001331	Guanine-nucleotide dissociation stimulator, CDC24, conserved site	21	0.576463182978234	1	10	11	6737	7480	1.00489106269453
IPR001345	Phosphoglycerate/bisphosphoglycerate mutase, active site	 7	0.44299046303573	1	4	3	6743	7488	1.20586927523344
IPR001346	Interferon regulatory factor DNA-binding domain	 8	0.994139200942595	1	1	7	6746	7484	0.263783903957314
IPR001353	Proteasome, subunit alpha/beta	14	0.526563311510249	1	7	7	6740	7484	1.05513561582926
IPR001357	BRCT domain	25	0.0305894811629588	0.436244582711385	17	8	6730	7483	1.43498443752779
IPR001365	Adenosine/AMP deaminase domain	 6	0.606099493932241	1	3	3	6744	7488	1.05513561582926
IPR001368	TNFR/NGFR cysteine-rich region	20	0.999546086947303	1	3	17	6744	7474	0.316540684748777
IPR001370	BIR repeat	 6	0.296087778157783	0.996215854772117	4	2	6743	7489	1.40684748777234
IPR001373	Cullin, N-terminal	10	0.00689456282010794	0.331550196952537	9	1	6738	7490	1.89924410849266
IPR001374	R3H domain	10	0.5573358874939	1	5	5	6742	7486	1.05513561582926
IPR001375	Peptidase S9, prolyl oligopeptidase, catalytic domain	 9	0.205164220540816	0.889516885075412	6	3	6741	7488	1.40684748777234
IPR001382	Glycoside hydrolase family 47	 6	0.0113099877671744	0.331550196952537	6	0	6741	7491	2.11027123165852
IPR001388	Synaptobrevin	13	0.640693632462334	1	6	7	6741	7484	0.973971337688545
IPR001390	Gamma-aminobutyric-acid A receptor, alpha subunit	 6	0.296087778157783	0.996215854772117	4	2	6743	7489	1.40684748777234
IPR001392	Clathrin adaptor, mu subunit	 6	0.296087778157783	0.996215854772117	4	2	6743	7489	1.40684748777234
IPR001394	Peptidase C19, ubiquitin carboxyl-terminal hydrolase	47	0.00128117677285015	0.169008569285149	33	14	6714	7477	1.48167980095172
IPR001401	Dynamin, GTPase domain	 6	0.296087778157783	0.996215854772117	4	2	6743	7489	1.40684748777234
IPR001408	G-protein alpha subunit, group I	 6	0.978809919738203	1	1	5	6746	7486	0.351711871943086
IPR001412	Aminoacyl-tRNA synthetase, class I, conserved site	14	0.0617512698732667	0.62262586120625	10	4	6737	7487	1.5073365940418
IPR001426	Tyrosine-protein kinase, receptor class V, conserved site	12	0.751834162472378	1	5	7	6742	7484	0.879279679857714
IPR001427	Pancreatic ribonuclease	 5	0.7781801260834	1	2	3	6745	7488	0.844108492663406
IPR001429	P2X purinoreceptor	 7	0.728431267104624	1	3	4	6744	7487	0.904401956425078
IPR001431	Peptidase M16, zinc-binding site	 5	0.0238764544482636	0.400696547198938	5	0	6742	7491	2.11027123165852
IPR001433	Oxidoreductase FAD/NAD(P)-binding	12	0.540572112776641	1	6	6	6741	7485	1.05513561582926
IPR001436	Alpha crystallin/Heat shock protein	 6	0.978809919738203	1	1	5	6746	7486	0.351711871943086
IPR001440	Tetratricopeptide repeat 1	24	0.0173974348673038	0.400696547198938	17	7	6730	7484	1.49477545575811
IPR001442	Collagen IV, non-collagenous	 5	0.7781801260834	1	2	3	6745	7488	0.844108492663406
IPR001451	Hexapeptide repeat	 5	0.451093636045012	1	3	2	6744	7489	1.26616273899511
IPR001461	Aspartic peptidase A1 family	 5	0.959711673474999	1	1	4	6746	7487	0.422054246331703
IPR001464	Annexin	11	0.849533330740884	1	4	7	6743	7484	0.767371356966733
IPR001487	Bromodomain	40	9.64415839280714e-05	0.138804266198691	31	9	6716	7482	1.63546020453535
IPR001494	Importin-beta, N-terminal domain	15	0.00199767521528973	0.21082132438691	13	2	6734	7489	1.82890173410405
IPR001496	SOCS box domain	28	0.924445133023354	1	10	18	6737	7473	0.753668297020898
IPR001503	Glycosyl transferase family 10	 6	0.86422044215898	1	2	4	6745	7487	0.703423743886172
IPR001507	Zona pellucida domain	 7	0.918536112180723	1	2	5	6745	7486	0.602934637616719
IPR001508	Ionotropic glutamate receptor, metazoa	15	0.796340355433979	1	6	9	6741	7482	0.844108492663406
IPR001509	NAD-dependent epimerase/dehydratase	 5	0.156501784621734	0.806571393258297	4	1	6743	7490	1.68821698532681
IPR001523	Paired domain	 5	0.959711673474999	1	1	4	6746	7487	0.422054246331703
IPR001557	L-lactate/malate dehydrogenase	 5	0.156501784621734	0.806571393258297	4	1	6743	7490	1.68821698532681
IPR001562	Zinc finger, Btk motif	 6	0.606099493932241	1	3	3	6744	7488	1.05513561582926
IPR001565	Synaptotagmin	15	0.0104700204735164	0.331550196952537	12	3	6735	7488	1.68821698532681
IPR001589	Actinin-type actin-binding domain, conserved site	22	0.793947417151464	1	9	13	6738	7478	0.863292776587574
IPR001590	Peptidase M12B, ADAM/reprolysin	29	0.388086487993054	1	15	14	6732	7477	1.09151960258199
IPR001594	Palmitoyltransferase, DHHC domain	25	0.395773627001197	1	13	12	6734	7479	1.09734104046243
IPR001599	Alpha-2-macroglobulin	 7	0.988855554331116	1	1	6	6746	7485	0.301467318808359
IPR001604	DNA/RNA non-specific endonuclease	 5	0.156501784621734	0.806571393258297	4	1	6743	7490	1.68821698532681
IPR001605	Pleckstrin homology domain, spectrin-type	 8	0.994139200942595	1	1	7	6746	7484	0.263783903957314
IPR001606	ARID DNA-binding domain	13	0.640693632462334	1	6	7	6741	7484	0.973971337688545
IPR001607	Zinc finger, UBP-type	13	0.0305036283181008	0.436244582711385	10	3	6737	7488	1.62328556281424
IPR001609	Myosin head, motor domain	26	0.762014417109878	1	11	15	6736	7476	0.892807059547833
IPR001610	PAC motif	16	0.982059015088883	1	4	12	6743	7479	0.527567807914629
IPR001619	Sec1-like protein	 7	0.44299046303573	1	4	3	6743	7488	1.20586927523344
IPR001623	DnaJ domain	45	0.596221030223774	1	21	24	6726	7467	0.98479324144064
IPR001627	Sema domain	27	0.391855307881216	1	14	13	6733	7478	1.09421471271182
IPR001628	Zinc finger, nuclear hormone receptor-type	43	0.932999248910495	1	16	27	6731	7464	0.785217202477587
IPR001632	G-protein, beta subunit	 7	0.44299046303573	1	4	3	6743	7488	1.20586927523344
IPR001650	Helicase, C-terminal	95	0.0253124792924156	0.400696547198938	55	40	6692	7451	1.22173597622335
IPR001660	Sterile alpha motif domain	82	0.44265809420585	1	40	42	6707	7449	1.02940060080903
IPR001664	Intermediate filament protein	45	0.999966976568299	1	9	36	6738	7455	0.422054246331703
IPR001666	Phosphatidylinositol transfer protein	 6	0.606099493932241	1	3	3	6744	7488	1.05513561582926
IPR001675	Glycosyl transferase family 29	18	0.503894207576696	1	9	9	6738	7482	1.05513561582926
IPR001678	SAM-dependent methyltransferase RsmB/NOP2-type	 5	0.156501784621734	0.806571393258297	4	1	6743	7490	1.68821698532681
IPR001683	Phox homologous domain	47	0.108056095122156	0.800900963894823	27	20	6720	7471	1.21228347350596
IPR001695	Lysyl oxidase	 5	0.959711673474999	1	1	4	6746	7487	0.422054246331703
IPR001696	Voltage gated sodium channel, alpha subunit	 8	0.951870028050764	1	2	6	6745	7485	0.527567807914629
IPR001699	Transcription factor, T-box	14	0.989142891012179	1	3	11	6744	7480	0.452200978212539
IPR001709	Flavoprotein pyridine nucleotide cytochrome reductase	 9	0.692132530392986	1	4	5	6743	7486	0.937898325181562
IPR001711	Phospholipase C, phosphatidylinositol-specific, Y domain	13	0.997002331611534	1	2	11	6745	7480	0.324657112562848
IPR001715	Calponin homology domain	71	0.418596852274317	1	35	36	6712	7455	1.04027455081758
IPR001723	Nuclear hormone receptor	44	0.94816449481948	1	16	28	6731	7463	0.767371356966733
IPR001734	Sodium/solute symporter	 9	0.971908527019724	1	2	7	6745	7484	0.468949162590781
IPR001736	Phospholipase D/Transphosphatidylase	 7	0.185910764499323	0.845680287938012	5	2	6742	7489	1.5073365940418
IPR001739	Methyl-CpG DNA binding	11	0.0218793801836401	0.400696547198938	9	2	6738	7489	1.72658555317515
IPR001751	S100/Calbindin-D9k, conserved site	18	0.99299119807509	1	4	14	6743	7477	0.468949162590781
IPR001752	Kinesin motor domain	30	0.318689333581118	0.996215854772117	16	14	6731	7477	1.12547799021787
IPR001753	Crotonase superfamily	12	0.540572112776641	1	6	6	6741	7485	1.05513561582926
IPR001757	P-type ATPase	34	0.122001332868948	0.806571393258297	20	14	6727	7477	1.24133601862266
IPR001759	Pentraxin-related	 6	0.606099493932241	1	3	3	6744	7488	1.05513561582926
IPR001762	Disintegrin domain	15	0.235719255914089	0.951896893142864	9	6	6738	7485	1.26616273899511
IPR001763	Rhodanese-like domain	19	0.408621506536301	1	10	9	6737	7482	1.11066906929396
IPR001766	Fork head domain	32	0.991972464494191	1	9	23	6738	7468	0.593513783903957
IPR001770	G-protein, gamma subunit	 8	0.11282433035284	0.800900963894823	6	2	6741	7489	1.58270342374389
IPR001772	Kinase associated domain 1 (KA1)	 5	0.7781801260834	1	2	3	6745	7488	0.844108492663406
IPR001781	Zinc finger, LIM-type	61	0.918209088624749	1	24	37	6723	7454	0.830270648521383
IPR001791	Laminin G domain	50	0.631549102874116	1	23	27	6724	7464	0.970724766562917
IPR001799	Ephrin receptor-binding domain	 8	0.951870028050764	1	2	6	6745	7485	0.527567807914629
IPR001807	Chloride channel, voltage gated	 8	0.11282433035284	0.800900963894823	6	2	6741	7489	1.58270342374389
IPR001810	F-box domain	59	0.117747478800403	0.806571393258297	33	26	6714	7465	1.18032119736832
IPR001811	Chemokine interleukin-8-like domain	25	0.999794832659233	1	4	21	6743	7470	0.337643397065362
IPR001818	Peptidase M10, metallopeptidase	15	0.993490982124601	1	3	12	6744	7479	0.422054246331703
IPR001824	Tyrosine-protein kinase, receptor class III, conserved site	 6	1	1	0	6	6747	7485	0
IPR001827	Homeobox protein, antennapedia type, conserved site	 7	1	1	0	7	6747	7484	0
IPR001828	Receptor, ligand binding region	29	0.797549712888833	1	12	17	6735	7474	0.873215682065592
IPR001834	NADH:cytochrome b5 reductase (CBR)	 5	0.451093636045012	1	3	2	6744	7489	1.26616273899511
IPR001839	Transforming growth factor-beta, C-terminal	28	0.999751697120707	1	5	23	6742	7468	0.376834148510449
IPR001846	von Willebrand factor, type D domain	13	0.932643324273574	1	4	9	6743	7482	0.649314225125697
IPR001863	Glypican	 6	0.86422044215898	1	2	4	6745	7487	0.703423743886172
IPR001870	B30.2/SPRY domain	66	0.92381695680427	1	26	40	6721	7451	0.831318970047294
IPR001873	Epithelial sodium channel	 7	0.728431267104624	1	3	4	6744	7487	0.904401956425078
IPR001875	Death effector domain	 7	0.918536112180723	1	2	5	6745	7486	0.602934637616719
IPR001876	Zinc finger, RanBP2-type	21	0.00699903872889012	0.331550196952537	16	5	6731	7486	1.60782570031125
IPR001878	Zinc finger, CCHC-type	25	0.0305894811629588	0.436244582711385	17	8	6730	7483	1.43498443752779
IPR001879	GPCR, family 2, extracellular hormone receptor domain	20	0.964745817786683	1	6	14	6741	7477	0.633081369497555
IPR001885	Lipoxygenase, mammalian	 5	0.959711673474999	1	1	4	6746	7487	0.422054246331703
IPR001895	Ras guanine-nucleotide exchange factors catalytic domain	27	0.811579669872116	1	11	16	6736	7475	0.859740131416432
IPR001902	SLC26A/SulP transporter	 8	0.578259437994666	1	4	4	6743	7487	1.05513561582926
IPR001917	Aminotransferase, class-II, pyridoxal-phosphate binding site	 5	0.451093636045012	1	3	2	6744	7489	1.26616273899511
IPR001926	Tryptophan synthase beta subunit-like PLP-dependent enzyme	 5	1	1	0	5	6747	7486	0
IPR001930	Peptidase M1, alanine aminopeptidase/leukotriene A4 hydrolase	10	0.924480277088131	1	3	7	6744	7484	0.633081369497555
IPR001932	PPM-type phosphatase domain	18	0.322822594532801	0.996215854772117	10	8	6737	7483	1.17237290647695
IPR001936	Ras GTPase-activating protein	14	0.158970483067965	0.806571393258297	9	5	6738	7486	1.35660293463762
IPR001958	Tetracycline resistance protein TetA/multidrug resistance protein MdtG	 5	0.451093636045012	1	3	2	6744	7489	1.26616273899511
IPR001965	Zinc finger, PHD-type	83	0.000390695788043135	0.145440073294157	55	28	6692	7463	1.39837250290624
IPR001969	Aspartic peptidase, active site	 5	0.959711673474999	1	1	4	6746	7487	0.422054246331703
IPR001978	Troponin	 6	0.978809919738203	1	1	5	6746	7486	0.351711871943086
IPR001991	Sodium:dicarboxylate symporter	 7	0.185910764499323	0.845680287938012	5	2	6742	7489	1.5073365940418
IPR002004	Polyadenylate-binding protein/Hyperplastic disc protein	 5	0.156501784621734	0.806571393258297	4	1	6743	7490	1.68821698532681
IPR002011	Tyrosine-protein kinase, receptor class II, conserved site	 9	0.435918072496767	1	5	4	6742	7487	1.17237290647695
IPR002014	VHS domain	 8	0.00253714334619093	0.23625281864825	8	0	6739	7491	2.11027123165852
IPR002017	Spectrin repeat	22	0.0403236689473323	0.506606094790691	15	7	6732	7484	1.43882129431262
IPR002018	Carboxylesterase, type B	12	0.318565851958547	0.996215854772117	7	5	6740	7486	1.2309915518008
IPR002030	Mitochondrial brown fat uncoupling protein	 6	0.86422044215898	1	2	4	6745	7487	0.703423743886172
IPR002035	von Willebrand factor, type A	78	0.784110570039375	1	34	44	6713	7447	0.919861818928071
IPR002049	Laminin EGF domain	35	0.510351849537127	1	17	18	6730	7473	1.02498888394842
IPR002052	DNA methylase, N-6 adenine-specific, conserved site	 7	0.728431267104624	1	3	4	6744	7487	0.904401956425078
IPR002058	PAP/25A-associated	 7	0.185910764499323	0.845680287938012	5	2	6742	7489	1.5073365940418
IPR002059	Cold-shock protein, DNA-binding	 5	0.7781801260834	1	2	3	6745	7488	0.844108492663406
IPR002067	Mitochondrial carrier protein	25	0.143771550836479	0.806571393258297	15	10	6732	7481	1.26616273899511
IPR002068	Alpha crystallin/Hsp20 domain	 7	0.988855554331116	1	1	6	6746	7485	0.301467318808359
IPR002070	Transcription factor, Brachyury	 6	1	1	0	6	6747	7485	0
IPR002073	3'5'-cyclic nucleotide phosphodiesterase, catalytic domain	21	0.40413282848468	1	11	10	6736	7481	1.10538016896398
IPR002075	Nuclear transport factor 2	 5	0.7781801260834	1	2	3	6745	7488	0.844108492663406
IPR002076	ELO family	 5	0.451093636045012	1	3	2	6744	7489	1.26616273899511
IPR002077	Voltage-dependent calcium channel, alpha-1 subunit	 9	0.881735281659405	1	3	6	6744	7485	0.703423743886172
IPR002083	MATH/TRAF domain	 8	0.11282433035284	0.800900963894823	6	2	6741	7489	1.58270342374389
IPR002087	Anti-proliferative protein	 5	0.156501784621734	0.806571393258297	4	1	6743	7490	1.68821698532681
IPR002108	Actin-depolymerising factor homology domain	 9	0.692132530392986	1	4	5	6743	7486	0.937898325181562
IPR002109	Glutaredoxin	 6	0.86422044215898	1	2	4	6745	7487	0.703423743886172
IPR002119	Histone H2A	 9	0.881735281659405	1	3	6	6744	7485	0.703423743886172
IPR002123	Phospholipid/glycerol acyltransferase	15	0.0104700204735164	0.331550196952537	12	3	6735	7488	1.68821698532681
IPR002125	Cytidine and deoxycytidylate deaminases, zinc-binding	 9	0.881735281659405	1	3	6	6744	7485	0.703423743886172
IPR002126	Cadherin	72	0.999792670175687	1	20	52	6727	7439	0.586186453238476
IPR002129	Pyridoxal phosphate-dependent decarboxylase	 5	0.7781801260834	1	2	3	6745	7488	0.844108492663406
IPR002130	Cyclophilin-type peptidyl-prolyl cis-trans isomerase domain	17	0.0463935769314538	0.527980989790211	12	5	6735	7486	1.48960322234719
IPR002138	Peptidase C14, caspase non-catalytic subunit p10	 9	0.971908527019724	1	2	7	6745	7484	0.468949162590781
IPR002155	Thiolase	 5	0.156501784621734	0.806571393258297	4	1	6743	7490	1.68821698532681
IPR002164	Nucleosome assembly protein (NAP)	10	0.314500257499634	0.996215854772117	6	4	6741	7487	1.26616273899511
IPR002165	Plexin repeat	24	0.100305453297802	0.759729820911105	15	9	6732	7482	1.31891951978657
IPR002172	Low-density lipoprotein (LDL) receptor class A repeat	37	0.74787959795501	1	16	21	6731	7470	0.912549721798277
IPR002181	Fibrinogen, alpha/beta/gamma chain, C-terminal globular domain	21	0.992945773587864	1	5	16	6742	7475	0.502445531347265
IPR002190	MAGE homology domain	12	0.751834162472378	1	5	7	6742	7484	0.879279679857714
IPR002194	Chaperonin TCP-1, conserved site	 8	0.0250958861430055	0.400696547198938	7	1	6740	7490	1.8464873277012
IPR002209	Fibroblast growth factor family	15	0.999053970109399	1	2	13	6745	7478	0.281369497554469
IPR002219	Protein kinase C-like, phorbol ester/diacylglycerol-binding domain	64	0.212922339323926	0.910155062580864	34	30	6713	7461	1.12108159181859
IPR002223	Pancreatic trypsin inhibitor Kunitz domain	12	0.898382914875138	1	4	8	6743	7483	0.703423743886172
IPR002231	5-hydroxytryptamine receptor family	 7	0.988855554331116	1	1	6	6746	7485	0.301467318808359
IPR002233	Adrenoceptor family	 9	1	1	0	9	6747	7482	0
IPR002293	Amino acid/polyamine transporter I	11	0.849533330740884	1	4	7	6743	7484	0.767371356966733
IPR002300	Aminoacyl-tRNA synthetase, class Ia	 6	0.0113099877671744	0.331550196952537	6	0	6741	7491	2.11027123165852
IPR002314	Aminoacyl-tRNA synthetase, class II (G/ P/ S/T)	 7	0.728431267104624	1	3	4	6744	7487	0.904401956425078
IPR002328	Alcohol dehydrogenase, zinc-type, conserved site	 5	0.451093636045012	1	3	2	6744	7489	1.26616273899511
IPR002343	Paraneoplastic encephalomyelitis antigen	 9	0.435918072496767	1	5	4	6742	7487	1.17237290647695
IPR002345	Lipocalin	 5	0.959711673474999	1	1	4	6746	7487	0.422054246331703
IPR002347	Short-chain dehydrogenase/reductase SDR	43	0.882527160896487	1	17	26	6730	7465	0.834293277632436
IPR002350	Kazal domain	34	0.944813555608377	1	12	22	6735	7469	0.744801611173593
IPR002364	Quinone oxidoreductase/zeta-crystallin, conserved site	 5	0.156501784621734	0.806571393258297	4	1	6743	7490	1.68821698532681
IPR002369	Integrin beta subunit, VWA domain	 6	0.606099493932241	1	3	3	6744	7488	1.05513561582926
IPR002394	Nicotinic acetylcholine receptor	11	1	1	0	11	6747	7480	0
IPR002401	Cytochrome P450, E-class, group I	27	0.811579669872116	1	11	16	6736	7475	0.859740131416432
IPR002403	Cytochrome P450, E-class, group IV	 5	0.451093636045012	1	3	2	6744	7489	1.26616273899511
IPR002404	IRS-type PTB domain	11	0.849533330740884	1	4	7	6743	7484	0.767371356966733
IPR002420	Phosphatidylinositol 3-kinase, C2 domain	 7	0.728431267104624	1	3	4	6744	7487	0.904401956425078
IPR002423	Chaperonin Cpn60/TCP-1 family	14	0.0617512698732667	0.62262586120625	10	4	6737	7487	1.5073365940418
IPR002452	Alpha tubulin	 6	0.86422044215898	1	2	4	6745	7487	0.703423743886172
IPR002453	Beta tubulin	 6	0.296087778157783	0.996215854772117	4	2	6743	7489	1.40684748777234
IPR002464	DNA/RNA helicase, ATP-dependent, DEAH-box type, conserved site	20	0.182408576511681	0.845680287938012	12	8	6735	7483	1.26616273899511
IPR002466	Adenosine deaminase/editase	 5	0.959711673474999	1	1	4	6746	7487	0.422054246331703
IPR002469	Dipeptidylpeptidase IV, N-terminal domain	 6	0.296087778157783	0.996215854772117	4	2	6743	7489	1.40684748777234
IPR002475	Bcl2-like	10	0.781996958992377	1	4	6	6743	7485	0.844108492663406
IPR002477	Peptidoglycan binding-like	13	0.982055735017173	1	3	10	6744	7481	0.486985668844273
IPR002478	PUA domain	 5	0.451093636045012	1	3	2	6744	7489	1.26616273899511
IPR002483	PWI domain	 6	0.0867087878537095	0.700306179451134	5	1	6742	7490	1.75855935971543
IPR002494	Keratin-associated protein	10	0.983765589502622	1	2	8	6745	7483	0.422054246331703
IPR002495	Glycosyl transferase, family 8	10	0.924480277088131	1	3	7	6744	7484	0.633081369497555
IPR002498	Phosphatidylinositol-4-phosphate 5-kinase, core	 8	0.578259437994666	1	4	4	6743	7487	1.05513561582926
IPR002515	Zinc finger, C2HC-type	 5	0.156501784621734	0.806571393258297	4	1	6743	7490	1.68821698532681
IPR002524	Cation efflux protein	10	0.5573358874939	1	5	5	6742	7486	1.05513561582926
IPR002553	Clathrin/coatomer adaptor, adaptin-like, N-terminal	14	0.00369214426693508	0.307613914450433	12	2	6735	7489	1.80880391285016
IPR002554	Protein phosphatase 2A, regulatory B subunit, B56	 5	0.156501784621734	0.806571393258297	4	1	6743	7490	1.68821698532681
IPR002589	Macro domain	 9	0.205164220540816	0.889516885075412	6	3	6741	7488	1.40684748777234
IPR002591	Type I phosphodiesterase/nucleotide pyrophosphatase/phosphate transferase	 9	0.0132220292527637	0.348841205118748	8	1	6739	7490	1.87579665036312
IPR002610	Peptidase S54, rhomboid	 5	0.959711673474999	1	1	4	6746	7487	0.422054246331703
IPR002641	Patatin-like phospholipase domain	 8	0.951870028050764	1	2	6	6745	7485	0.527567807914629
IPR002645	STAS domain	 8	0.578259437994666	1	4	4	6743	7487	1.05513561582926
IPR002652	Importin-alpha, importin-beta-binding domain	 6	0.606099493932241	1	3	3	6744	7488	1.05513561582926
IPR002653	Zinc finger, A20-type	 6	0.296087778157783	0.996215854772117	4	2	6743	7489	1.40684748777234
IPR002659	Glycosyl transferase, family 31	15	0.912946663336211	1	5	10	6742	7481	0.703423743886172
IPR002710	Dilute domain	 6	0.978809919738203	1	1	5	6746	7486	0.351711871943086
IPR002713	FF domain	 6	0.0867087878537095	0.700306179451134	5	1	6742	7490	1.75855935971543
IPR002716	PIN domain	 5	0.451093636045012	1	3	2	6744	7489	1.26616273899511
IPR002857	Zinc finger, CXXC-type	11	0.0218793801836401	0.400696547198938	9	2	6738	7489	1.72658555317515
IPR002867	IBR domain	13	0.0305036283181008	0.436244582711385	10	3	6737	7488	1.62328556281424
IPR002870	Peptidase M12B, propeptide	28	0.463837741497859	1	14	14	6733	7477	1.05513561582926
IPR002877	Ribosomal RNA methyltransferase FtsJ domain	 5	0.959711673474999	1	1	4	6746	7487	0.422054246331703
IPR002884	Proprotein convertase, P	 7	0.918536112180723	1	2	5	6745	7486	0.602934637616719
IPR002885	Pentatricopeptide repeat	 8	0.0250958861430055	0.400696547198938	7	1	6740	7490	1.8464873277012
IPR002889	Carbohydrate-binding WSC	 5	0.959711673474999	1	1	4	6746	7487	0.422054246331703
IPR002890	Alpha-2-macroglobulin, N-terminal	 7	0.988855554331116	1	1	6	6746	7485	0.301467318808359
IPR002893	Zinc finger, MYND-type	17	0.0463935769314538	0.527980989790211	12	5	6735	7486	1.48960322234719
IPR002909	IPT domain	24	0.777427531599741	1	10	14	6737	7477	0.879279679857714
IPR002913	START domain	12	0.147212368789038	0.806571393258297	8	4	6739	7487	1.40684748777234
IPR002919	Trypsin Inhibitor-like, cysteine rich domain	10	0.924480277088131	1	3	7	6744	7484	0.633081369497555
IPR002928	Myosin tail	10	0.781996958992377	1	4	6	6743	7485	0.844108492663406
IPR002931	Transglutaminase-like	 8	0.951870028050764	1	2	6	6745	7485	0.527567807914629
IPR002934	Polymerase, nucleotidyl transferase domain	 9	0.435918072496767	1	5	4	6742	7487	1.17237290647695
IPR002937	Amine oxidase	10	0.781996958992377	1	4	6	6743	7485	0.844108492663406
IPR002938	FAD-binding domain	 6	0.0113099877671744	0.331550196952537	6	0	6741	7491	2.11027123165852
IPR002939	Chaperone DnaJ, C-terminal	 8	0.951870028050764	1	2	6	6745	7485	0.527567807914629
IPR002942	RNA-binding S4 domain	 5	0.7781801260834	1	2	3	6745	7488	0.844108492663406
IPR002946	Intracellular chloride channel	 6	0.86422044215898	1	2	4	6745	7487	0.703423743886172
IPR002957	Keratin, type I	15	0.971750526562492	1	4	11	6743	7480	0.562738995108937
IPR002999	Tudor domain	23	0.251531533112904	0.989333404834788	13	10	6734	7481	1.19276200050264
IPR003000	Sirtuin family	 7	0.44299046303573	1	4	3	6743	7488	1.20586927523344
IPR003006	Immunoglobulin/major histocompatibility complex, conserved site	27	0.999591783536328	1	5	22	6742	7469	0.390790968825651
IPR003008	Tubulin/FtsZ, GTPase domain	17	0.241300442408668	0.962162721241616	10	7	6737	7484	1.24133601862266
IPR003010	Carbon-nitrogen hydrolase	 7	0.728431267104624	1	3	4	6744	7487	0.904401956425078
IPR003018	GAF domain	 6	0.606099493932241	1	3	3	6744	7488	1.05513561582926
IPR003019	Metallothionein	 7	0.918536112180723	1	2	5	6745	7486	0.602934637616719
IPR003020	Bicarbonate transporter, eukaryotic	 7	0.728431267104624	1	3	4	6744	7487	0.904401956425078
IPR003029	S1 domain	 9	0.435918072496767	1	5	4	6742	7487	1.17237290647695
IPR003033	SCP2 sterol-binding domain	 5	0.451093636045012	1	3	2	6744	7489	1.26616273899511
IPR003034	SAP domain	22	0.322470762069609	0.996215854772117	12	10	6735	7481	1.1510570354501
IPR003054	Keratin, type II	17	0.999706119467108	1	2	15	6745	7476	0.248267203724531
IPR003092	Two pore domain potassium channel, TASK family	 8	0.994139200942595	1	1	7	6746	7484	0.263783903957314
IPR003096	Smooth muscle protein/calponin	11	0.849533330740884	1	4	7	6743	7484	0.767371356966733
IPR003097	FAD-binding, type 1	 6	0.86422044215898	1	2	4	6745	7487	0.703423743886172
IPR003100	PAZ domain	 9	0.0666543852588519	0.639451333797848	7	2	6740	7489	1.64132206906773
IPR003103	BAG domain	 5	0.451093636045012	1	3	2	6744	7489	1.26616273899511
IPR003107	HAT (Half-A-TPR) repeat	10	0.5573358874939	1	5	5	6742	7486	1.05513561582926
IPR003108	Gas2-related domain	 6	0.0867087878537095	0.700306179451134	5	1	6742	7490	1.75855935971543
IPR003109	GoLoco motif	 5	0.7781801260834	1	2	3	6745	7488	0.844108492663406
IPR003110	Phosphorylated immunoreceptor signalling ITAM	 7	0.988855554331116	1	1	6	6746	7485	0.301467318808359
IPR003111	Lon, substrate-binding domain	 6	0.0867087878537095	0.700306179451134	5	1	6742	7490	1.75855935971543
IPR003112	Olfactomedin-like domain	13	0.423763673143334	1	7	6	6740	7485	1.13629989396997
IPR003116	Raf-like Ras-binding	 7	0.185910764499323	0.845680287938012	5	2	6742	7489	1.5073365940418
IPR003117	cAMP-dependent protein kinase regulatory subunit, dimerization-anchoring domain	12	0.751834162472378	1	5	7	6742	7484	0.879279679857714
IPR003118	Pointed domain	 7	0.918536112180723	1	2	5	6745	7486	0.602934637616719
IPR003121	SWIB/MDM2 domain	 6	0.86422044215898	1	2	4	6745	7487	0.703423743886172
IPR003123	VPS9 domain	 8	0.307721488076794	0.996215854772117	5	3	6742	7488	1.31891951978657
IPR003124	WH2 domain	18	0.684826100723303	1	8	10	6739	7481	0.937898325181562
IPR003126	Zinc finger, UBR-type	 7	0.0470279971954641	0.527980989790211	6	1	6741	7490	1.80880391285016
IPR003128	Villin headpiece	 8	0.951870028050764	1	2	6	6745	7485	0.527567807914629
IPR003130	Dynamin GTPase effector	 5	0.451093636045012	1	3	2	6744	7489	1.26616273899511
IPR003131	Potassium channel tetramerisation-type BTB domain	41	0.820315953728005	1	17	24	6730	7467	0.874990510687677
IPR003137	PA domain	16	0.168402871096864	0.838307374045079	10	6	6737	7485	1.31891951978657
IPR003150	DNA-binding RFX-type winged-helix domain	 7	0.185910764499323	0.845680287938012	5	2	6742	7489	1.5073365940418
IPR003151	PIK-related kinase, FAT	 5	0.0238764544482636	0.400696547198938	5	0	6742	7491	2.11027123165852
IPR003152	FATC domain	 6	0.0113099877671744	0.331550196952537	6	0	6741	7491	2.11027123165852
IPR003165	Piwi domain	 7	0.185910764499323	0.845680287938012	5	2	6742	7489	1.5073365940418
IPR003191	Guanylate-binding protein, C-terminal	 7	0.728431267104624	1	3	4	6744	7487	0.904401956425078
IPR003280	Two pore domain potassium channel	12	0.994702855212401	1	2	10	6745	7481	0.351711871943086
IPR003307	W2 domain	 7	0.44299046303573	1	4	3	6743	7488	1.20586927523344
IPR003309	SCAN domain	45	0.706405838796912	1	20	25	6727	7466	0.937898325181562
IPR003316	E2F/DP family, winged-helix DNA-binding domain	 7	0.918536112180723	1	2	5	6745	7486	0.602934637616719
IPR003323	OTU domain	14	0.158970483067965	0.806571393258297	9	5	6738	7486	1.35660293463762
IPR003347	JmjC domain	27	0.811579669872116	1	11	16	6736	7475	0.859740131416432
IPR003349	JmjN domain	 8	0.578259437994666	1	4	4	6743	7487	1.05513561582926
IPR003350	CUT domain	 7	0.918536112180723	1	2	5	6745	7486	0.602934637616719
IPR003367	Thrombospondin, type 3-like repeat	 5	1	1	0	5	6747	7486	0
IPR003378	Fringe-like	 5	0.959711673474999	1	1	4	6746	7487	0.422054246331703
IPR003380	Transforming protein Ski	 5	0.156501784621734	0.806571393258297	4	1	6743	7490	1.68821698532681
IPR003392	Protein patched/dispatched	 8	0.951870028050764	1	2	6	6745	7485	0.527567807914629
IPR003395	RecF/RecN/SMC, N-terminal	 7	0.185910764499323	0.845680287938012	5	2	6742	7489	1.5073365940418
IPR003397	Mitochondrial inner membrane translocase subunit Tim17/Tim22/Tim23/peroxisomal protein PMP24	 8	0.0250958861430055	0.400696547198938	7	1	6740	7490	1.8464873277012
IPR003406	Glycosyl transferase, family 14	 6	1	1	0	6	6747	7485	0
IPR003409	MORN motif	14	0.874077894035467	1	5	9	6742	7482	0.753668297020898
IPR003439	ABC transporter-like	41	0.257989634438452	0.989333404834788	22	19	6725	7472	1.13234066088993
IPR003508	CIDE-N domain	 5	0.451093636045012	1	3	2	6744	7489	1.26616273899511
IPR003527	Mitogen-activated protein (MAP) kinase, conserved site	12	0.540572112776641	1	6	6	6741	7485	1.05513561582926
IPR003529	Long hematopoietin receptor, Gp130 family 2, conserved site	 7	0.918536112180723	1	2	5	6745	7486	0.602934637616719
IPR003531	Short hematopoietin receptor, family 1, conserved site	 5	0.959711673474999	1	1	4	6746	7487	0.422054246331703
IPR003532	Short hematopoietin receptor, family 2, conserved site	 5	1	1	0	5	6747	7486	0
IPR003533	Doublecortin domain	 5	0.7781801260834	1	2	3	6745	7488	0.844108492663406
IPR003585	Neurexin/syndecan/glycophorin C	14	0.0617512698732667	0.62262586120625	10	4	6737	7487	1.5073365940418
IPR003594	Histidine kinase-like ATPase, C-terminal domain	19	0.0534689376003887	0.571900866360915	13	6	6734	7485	1.44386979008214
IPR003595	Protein-tyrosine phosphatase, catalytic	55	0.000918436427652396	0.164204496229	38	17	6709	7474	1.45800557823679
IPR003597	Immunoglobulin C1-set	31	0.999991819602565	1	4	27	6743	7464	0.272293062149486
IPR003603	U2A'/phosphoprotein 32 family A, C-terminal	 7	0.0470279971954641	0.527980989790211	6	1	6741	7490	1.80880391285016
IPR003604	Matrin/U1-C-like, C2H2-type zinc finger	27	0.391855307881216	1	14	13	6733	7478	1.09421471271182
IPR003605	GS domain	 6	0.296087778157783	0.996215854772117	4	2	6743	7489	1.40684748777234
IPR003607	HD/PDEase domain	21	0.132509211708819	0.806571393258297	13	8	6734	7483	1.30635838150289
IPR003613	U box domain	10	0.5573358874939	1	5	5	6742	7486	1.05513561582926
IPR003616	Post-SET domain	16	0.0714456925480936	0.66528547825666	11	5	6736	7486	1.45081147176523
IPR003617	Transcription elongation factor, TFIIS/CRSP70, N-terminal, sub-type	 5	0.0238764544482636	0.400696547198938	5	0	6742	7491	2.11027123165852
IPR003618	Transcription elongation factor S-II, central domain	 6	0.0867087878537095	0.700306179451134	5	1	6742	7490	1.75855935971543
IPR003619	MAD homology 1, Dwarfin-type	12	0.0508017172795473	0.547068833017165	9	3	6738	7488	1.58270342374389
IPR003644	Na-Ca exchanger/integrin-beta4	 9	0.881735281659405	1	3	6	6744	7485	0.703423743886172
IPR003645	Follistatin-like, N-terminal	 8	0.578259437994666	1	4	4	6743	7487	1.05513561582926
IPR003649	B-box, C-terminal	14	0.0617512698732667	0.62262586120625	10	4	6737	7487	1.5073365940418
IPR003650	Orange domain	10	0.983765589502622	1	2	8	6745	7483	0.422054246331703
IPR003653	Ulp1 protease family, C-terminal catalytic domain	 6	0.296087778157783	0.996215854772117	4	2	6743	7489	1.40684748777234
IPR003654	OAR domain	 8	1	1	0	8	6747	7483	0
IPR003656	Zinc finger, BED-type	 9	0.435918072496767	1	5	4	6742	7487	1.17237290647695
IPR003663	Sugar/inositol transporter	11	0.990694524510238	1	2	9	6745	7482	0.383685678483366
IPR003689	Zinc/iron permease	12	0.318565851958547	0.996215854772117	7	5	6740	7486	1.2309915518008
IPR003859	Beta-1,4-galactosyltransferase	 7	0.728431267104624	1	3	4	6744	7487	0.904401956425078
IPR003877	SPRY domain	63	0.969352820910963	1	23	40	6724	7451	0.77041648139914
IPR003879	Butyrophylin-like	41	0.999306736300376	1	10	31	6737	7460	0.514700300404516
IPR003886	NIDO domain	 5	0.451093636045012	1	3	2	6744	7489	1.26616273899511
IPR003887	LEM domain	 6	0.606099493932241	1	3	3	6744	7488	1.05513561582926
IPR003888	FY-rich, N-terminal	 5	0.156501784621734	0.806571393258297	4	1	6743	7490	1.68821698532681
IPR003889	FY-rich, C-terminal	 5	0.156501784621734	0.806571393258297	4	1	6743	7490	1.68821698532681
IPR003890	MIF4G-like, type 3	 9	0.996918035182955	1	1	8	6746	7483	0.234474581295391
IPR003891	Initiation factor eIF-4 gamma, MA3	 6	0.978809919738203	1	1	5	6746	7486	0.351711871943086
IPR003892	Ubiquitin system component Cue	10	0.0385318949833867	0.498382293530479	8	2	6739	7489	1.68821698532681
IPR003893	Iroquois-class homeodomain protein	 5	0.959711673474999	1	1	4	6746	7487	0.422054246331703
IPR003894	TAFH/NHR1	 5	0.7781801260834	1	2	3	6745	7488	0.844108492663406
IPR003903	Ubiquitin interacting motif	20	0.0350918670667404	0.491596686430531	14	6	6733	7485	1.47718986216096
IPR003937	Potassium channel, voltage dependent, KCNQ	 5	0.7781801260834	1	2	3	6745	7488	0.844108492663406
IPR003938	Potassium channel, voltage-dependent, EAG/ELK/ERG	10	0.781996958992377	1	4	6	6743	7485	0.844108492663406
IPR003954	RNA recognition motif domain, eukaryote	17	0.0463935769314538	0.527980989790211	12	5	6735	7486	1.48960322234719
IPR003958	Transcription factor CBF/NF-Y/archaeal histone domain	 7	0.728431267104624	1	3	4	6744	7487	0.904401956425078
IPR003959	ATPase, AAA-type, core	43	0.0144515352714222	0.368980327978409	28	15	6719	7476	1.37413010433578
IPR003960	ATPase, AAA-type, conserved site	25	0.143771550836479	0.806571393258297	15	10	6732	7481	1.26616273899511
IPR003968	Potassium channel, voltage dependent, Kv	23	0.923591754777823	1	8	15	6739	7476	0.734007384924701
IPR003971	Potassium channel, voltage dependent, Kv9	 6	0.86422044215898	1	2	4	6745	7487	0.703423743886172
IPR003972	Potassium channel, voltage dependent, Kv1	 5	0.959711673474999	1	1	4	6746	7487	0.422054246331703
IPR003987	Intercellular adhesion molecule/vascular cell adhesion molecule, N-terminal	 6	0.978809919738203	1	1	5	6746	7486	0.351711871943086
IPR004000	Actin family	20	0.322841903662727	0.996215854772117	11	9	6736	7482	1.16064917741218
IPR004001	Actin, conserved site	10	0.132273529234937	0.806571393258297	7	3	6740	7488	1.47718986216096
IPR004009	Myosin, N-terminal, SH3-like	 8	0.818534364570598	1	3	5	6744	7486	0.791351711871943
IPR004012	RUN domain	16	0.322268893536235	0.996215854772117	9	7	6738	7484	1.18702756780791
IPR004014	Cation-transporting P-type ATPase, N-terminal	18	0.503894207576696	1	9	9	6738	7482	1.05513561582926
IPR004018	RPEL repeat	 7	0.185910764499323	0.845680287938012	5	2	6742	7489	1.5073365940418
IPR004020	DAPIN domain	12	0.898382914875138	1	4	8	6743	7483	0.703423743886172
IPR004031	PMP-22/EMP/MP20/Claudin superfamily	31	0.998841842927616	1	7	24	6740	7467	0.4765128587616
IPR004032	PMP-22/EMP/MP20	 7	0.918536112180723	1	2	5	6745	7486	0.602934637616719
IPR004038	Ribosomal protein L7Ae/L30e/S12e/Gadd45	 9	0.205164220540816	0.889516885075412	6	3	6741	7488	1.40684748777234
IPR004043	LCCL domain	 5	0.7781801260834	1	2	3	6745	7488	0.844108492663406
IPR004045	Glutathione S-transferase, N-terminal	16	0.940825060983318	1	5	11	6742	7480	0.659459759893286
IPR004046	Glutathione S-transferase, C-terminal	13	0.821296993728656	1	5	8	6742	7483	0.811642781407121
IPR004061	Sphingosine 1-phosphate receptor	 5	0.959711673474999	1	1	4	6746	7487	0.422054246331703
IPR004074	Interleukin-1 receptor type I/II	 5	1	1	0	5	6747	7486	0
IPR004087	K Homology domain	30	0.0103256552570428	0.331550196952537	21	9	6726	7482	1.47718986216096
IPR004088	K Homology domain, type 1	35	0.00924267132391677	0.331550196952537	24	11	6723	7480	1.44704313028012
IPR004092	Mbt repeat	11	0.0829386011160441	0.700306179451134	8	3	6739	7488	1.53474271393347
IPR004095	TGS	 5	0.7781801260834	1	2	3	6745	7488	0.844108492663406
IPR004099	Pyridine nucleotide-disulphide oxidoreductase, dimerisation domain	 6	0.606099493932241	1	3	3	6744	7488	1.05513561582926
IPR004100	ATPase, F1/V1/A1 complex, alpha/beta subunit, N-terminal domain	 5	0.156501784621734	0.806571393258297	4	1	6743	7490	1.68821698532681
IPR004129	Glycerophosphoryl diester phosphodiesterase	 5	0.7781801260834	1	2	3	6745	7488	0.844108492663406
IPR004133	DAN	 5	0.7781801260834	1	2	3	6745	7488	0.844108492663406
IPR004147	UbiB domain	 5	0.451093636045012	1	3	2	6744	7489	1.26616273899511
IPR004148	BAR domain	15	0.912946663336211	1	5	10	6742	7481	0.703423743886172
IPR004152	GAT domain	 5	0.0238764544482636	0.400696547198938	5	0	6742	7491	2.11027123165852
IPR004154	Anticodon-binding	14	0.526563311510249	1	7	7	6740	7484	1.05513561582926
IPR004156	Organic anion transporter polypeptide OATP	 6	0.86422044215898	1	2	4	6745	7487	0.703423743886172
IPR004160	Translation elongation factor EFTu/EF1A, C-terminal	 5	0.451093636045012	1	3	2	6744	7489	1.26616273899511
IPR004161	Translation elongation factor EFTu-like, domain 2	12	0.318565851958547	0.996215854772117	7	5	6740	7486	1.2309915518008
IPR004166	MHCK/EF2 kinase	 5	0.451093636045012	1	3	2	6744	7489	1.26616273899511
IPR004170	WWE domain	13	0.640693632462334	1	6	7	6741	7484	0.973971337688545
IPR004172	L27 domain	13	0.228396290943016	0.934241159076989	8	5	6739	7486	1.29862845025139
IPR004177	DDHD domain	 6	0.296087778157783	0.996215854772117	4	2	6743	7489	1.40684748777234
IPR004181	Zinc finger, MIZ-type	 7	0.44299046303573	1	4	3	6743	7488	1.20586927523344
IPR004182	GRAM domain	20	0.667562071415652	1	9	11	6738	7480	0.949622054246332
IPR004198	Zinc finger, C5HC2-type	 5	0.7781801260834	1	2	3	6745	7488	0.844108492663406
IPR004241	Autophagy protein Atg8 ubiquitin-like	 5	0.156501784621734	0.806571393258297	4	1	6743	7490	1.68821698532681
IPR004254	AdipoR/Haemolysin-III-related	11	0.663808308432488	1	5	6	6742	7485	0.959214196208416
IPR004263	Exostosin-like	 5	0.451093636045012	1	3	2	6744	7489	1.26616273899511
IPR004273	Dynein heavy chain domain	10	0.132273529234937	0.806571393258297	7	3	6740	7488	1.47718986216096
IPR004274	FCP1 homology domain	 8	0.578259437994666	1	4	4	6743	7487	1.05513561582926
IPR004279	Perilipin	 5	0.959711673474999	1	1	4	6746	7487	0.422054246331703
IPR004299	Membrane bound O-acyl transferase, MBOAT	 8	0.578259437994666	1	4	4	6743	7487	1.05513561582926
IPR004328	BRO1 domain	 6	0.606099493932241	1	3	3	6744	7488	1.05513561582926
IPR004344	Tubulin-tyrosine ligase/Tubulin polyglutamylase	11	0.0829386011160441	0.700306179451134	8	3	6739	7488	1.53474271393347
IPR004345	TB2/DP1/HVA22-related protein	 6	0.296087778157783	0.996215854772117	4	2	6743	7489	1.40684748777234
IPR004364	Aminoacyl-tRNA synthetase, class II (D/K/N)	 5	0.7781801260834	1	2	3	6745	7488	0.844108492663406
IPR004365	OB-fold nucleic acid binding domain, AA-tRNA synthetase-type	 9	0.881735281659405	1	3	6	6744	7485	0.703423743886172
IPR004367	Cyclin, C-terminal domain	16	0.940825060983318	1	5	11	6742	7480	0.659459759893286
IPR004589	DNA helicase, ATP-dependent, RecQ type	 5	0.7781801260834	1	2	3	6745	7488	0.844108492663406
IPR004686	Tricarboxylate/iron carrier	 5	0.7781801260834	1	2	3	6745	7488	0.844108492663406
IPR004709	Na+/H+ exchanger	 8	0.818534364570598	1	3	5	6744	7486	0.791351711871943
IPR004724	Epithelial sodium channel, chordates	 6	0.606099493932241	1	3	3	6744	7488	1.05513561582926
IPR004729	Transient receptor potential channel	 8	0.951870028050764	1	2	6	6745	7485	0.527567807914629
IPR004749	Organic cation transport protein/SVOP	 8	0.994139200942595	1	1	7	6746	7484	0.263783903957314
IPR004821	Cytidyltransferase-like domain	 7	0.185910764499323	0.845680287938012	5	2	6742	7489	1.5073365940418
IPR004823	TATA box binding protein associated factor (TAF)	 5	0.959711673474999	1	1	4	6746	7487	0.422054246331703
IPR004826	Basic leucine zipper domain, Maf-type	11	0.849533330740884	1	4	7	6743	7484	0.767371356966733
IPR004827	Basic-leucine zipper domain	48	0.826221618799695	1	20	28	6727	7463	0.879279679857714
IPR004837	Sodium/calcium exchanger membrane region	 8	0.994139200942595	1	1	7	6746	7484	0.263783903957314
IPR004839	Aminotransferase, class I/classII	14	0.158970483067965	0.806571393258297	9	5	6738	7486	1.35660293463762
IPR004841	Amino acid permease/ SLC12A domain	 8	0.818534364570598	1	3	5	6744	7486	0.791351711871943
IPR004842	SLC12A transporter family	 6	0.606099493932241	1	3	3	6744	7488	1.05513561582926
IPR004843	Calcineurin-like phosphoesterase domain, ApaH type	24	0.192066497470497	0.866214431611958	14	10	6733	7481	1.2309915518008
IPR004853	Sugar phosphate transporter domain	 9	0.205164220540816	0.889516885075412	6	3	6741	7488	1.40684748777234
IPR004865	HSR domain	 5	0.7781801260834	1	2	3	6745	7488	0.844108492663406
IPR004875	DDE superfamily endonuclease domain	 9	0.692132530392986	1	4	5	6743	7486	0.937898325181562
IPR004910	Yippee/Mis18/Cereblon	 7	0.0470279971954641	0.527980989790211	6	1	6741	7490	1.80880391285016
IPR004934	Tropomodulin	 5	0.156501784621734	0.806571393258297	4	1	6743	7490	1.68821698532681
IPR004939	APC10/DOC domain	 8	0.307721488076794	0.996215854772117	5	3	6742	7488	1.31891951978657
IPR005024	Snf7 family	 9	0.435918072496767	1	5	4	6742	7487	1.17237290647695
IPR005036	CBM21 (carbohydrate binding type-21) domain	 5	0.156501784621734	0.806571393258297	4	1	6743	7490	1.68821698532681
IPR005108	HELP	 6	0.0867087878537095	0.700306179451134	5	1	6742	7490	1.75855935971543
IPR005112	dDENN domain	16	0.704217300302988	1	7	9	6740	7482	0.9232436638506
IPR005113	uDENN domain	16	0.704217300302988	1	7	9	6740	7482	0.9232436638506
IPR005123	Oxoglutarate/iron-dependent dioxygenase	18	0.503894207576696	1	9	9	6738	7482	1.05513561582926
IPR005135	Endonuclease/exonuclease/phosphatase	25	0.704030190887963	1	11	14	6736	7477	0.928519341929747
IPR005176	Potentiating neddylation domain	 5	0.156501784621734	0.806571393258297	4	1	6743	7490	1.68821698532681
IPR005301	MOB kinase activator family	 7	0.988855554331116	1	1	6	6746	7485	0.301467318808359
IPR005331	Sulfotransferase	10	0.314500257499634	0.996215854772117	6	4	6741	7487	1.26616273899511
IPR005467	Histidine kinase domain	 5	0.451093636045012	1	3	2	6744	7489	1.26616273899511
IPR005475	Transketolase-like, pyrimidine-binding domain	 7	0.44299046303573	1	4	3	6743	7488	1.20586927523344
IPR005479	Carbamoyl-phosphate synthetase large subunit-like, ATP-binding domain	 7	0.44299046303573	1	4	3	6743	7488	1.20586927523344
IPR005481	Biotin carboxylase-like, N-terminal domain	 5	0.451093636045012	1	3	2	6744	7489	1.26616273899511
IPR005482	Biotin carboxylase, C-terminal	 5	0.451093636045012	1	3	2	6744	7489	1.26616273899511
IPR005492	Leucine-rich glioma-inactivated , EPTP repeat	 5	0.451093636045012	1	3	2	6744	7489	1.26616273899511
IPR005522	Inositol polyphosphate kinase	 6	0.606099493932241	1	3	3	6744	7488	1.05513561582926
IPR005617	Groucho/TLE, N-terminal Q-rich domain	 5	0.959711673474999	1	1	4	6746	7487	0.422054246331703
IPR005775	P-type ATPase, subfamily IIC	 6	0.606099493932241	1	3	3	6744	7488	1.05513561582926
IPR005804	Fatty acid desaturase domain	 5	0.451093636045012	1	3	2	6744	7489	1.26616273899511
IPR005814	Aminotransferase class-III	 5	0.451093636045012	1	3	2	6744	7489	1.26616273899511
IPR005817	Wnt	15	0.999053970109399	1	2	13	6745	7478	0.281369497554469
IPR005818	Linker histone H1/H5, domain H15	12	0.898382914875138	1	4	8	6743	7483	0.703423743886172
IPR005819	Histone H5	 8	0.994139200942595	1	1	7	6746	7484	0.263783903957314
IPR005821	Ion transport domain	88	0.976220155401079	1	33	55	6714	7436	0.791351711871943
IPR005824	KOW	 6	0.86422044215898	1	2	4	6745	7487	0.703423743886172
IPR005828	Major facilitator,  sugar transporter-like	29	0.9760271327998	1	9	20	6738	7471	0.654911761549194
IPR005829	Sugar transporter, conserved site	24	0.978679937586903	1	7	17	6740	7474	0.6154957759004
IPR005843	Alpha-D-phosphohexomutase, C-terminal	 5	0.451093636045012	1	3	2	6744	7489	1.26616273899511
IPR005844	Alpha-D-phosphohexomutase, alpha/beta/alpha domain I	 5	0.451093636045012	1	3	2	6744	7489	1.26616273899511
IPR005937	26S proteasome subunit P45	 5	0.959711673474999	1	1	4	6746	7487	0.422054246331703
IPR006011	Syntaxin, N-terminal domain	 9	0.0132220292527637	0.348841205118748	8	1	6739	7490	1.87579665036312
IPR006012	Syntaxin/epimorphin, conserved site	13	0.0964724174428019	0.737757665758239	9	4	6738	7487	1.46095700653282
IPR006020	PTB/PI domain	41	0.367928814253268	1	21	20	6726	7471	1.08087063084948
IPR006026	Peptidase, metallopeptidase	17	0.98873099117697	1	4	13	6743	7478	0.496534407449062
IPR006028	Gamma-aminobutyric acid A receptor/Glycine receptor alpha	14	0.320964034776418	0.996215854772117	8	6	6739	7485	1.20586927523344
IPR006029	Neurotransmitter-gated ion-channel transmembrane domain	28	0.966157148275869	1	9	19	6738	7472	0.678301467318808
IPR006052	Tumour necrosis factor domain	13	0.997002331611534	1	2	11	6745	7480	0.324657112562848
IPR006053	Tumour necrosis factor	 5	1	1	0	5	6747	7486	0
IPR006068	Cation-transporting P-type ATPase, C-terminal	16	0.514504384844781	1	8	8	6739	7483	1.05513561582926
IPR006073	GTP binding domain	18	0.0295829455676686	0.436244582711385	13	5	6734	7486	1.52408477842004
IPR006076	FAD dependent oxidoreductase	 9	0.692132530392986	1	4	5	6743	7486	0.937898325181562
IPR006077	Vinculin/alpha-catenin	 7	0.44299046303573	1	4	3	6743	7488	1.20586927523344
IPR006089	Acyl-CoA dehydrogenase, conserved site	 9	0.205164220540816	0.889516885075412	6	3	6741	7488	1.40684748777234
IPR006091	Acyl-CoA oxidase/dehydrogenase, central domain	12	0.318565851958547	0.996215854772117	7	5	6740	7486	1.2309915518008
IPR006116	2-5-oligoadenylate synthetase, N-terminal	 5	0.959711673474999	1	1	4	6746	7487	0.422054246331703
IPR006121	Heavy metal-associated domain, HMA	 5	0.451093636045012	1	3	2	6744	7489	1.26616273899511
IPR006153	Cation/H+ exchanger	10	0.781996958992377	1	4	6	6743	7485	0.844108492663406
IPR006186	Serine/threonine-specific protein phosphatase/bis(5-nucleosyl)-tetraphosphatase	12	0.318565851958547	0.996215854772117	7	5	6740	7486	1.2309915518008
IPR006187	Claudin	12	0.999552003041346	1	1	11	6746	7480	0.175855935971543
IPR006195	Aminoacyl-tRNA synthetase, class II	16	0.704217300302988	1	7	9	6740	7482	0.9232436638506
IPR006201	Neurotransmitter-gated ion-channel	28	0.966157148275869	1	9	19	6738	7472	0.678301467318808
IPR006202	Neurotransmitter-gated ion-channel ligand-binding domain	28	0.966157148275869	1	9	19	6738	7472	0.678301467318808
IPR006204	GHMP kinase N-terminal domain	 5	0.7781801260834	1	2	3	6745	7488	0.844108492663406
IPR006207	Cystine knot, C-terminal	18	0.973820267033553	1	5	13	6742	7478	0.586186453238476
IPR006208	Glycoprotein hormone subunit beta, cystine knot	 7	1	1	0	7	6747	7484	0
IPR006211	Furin-like cysteine-rich domain	 7	0.44299046303573	1	4	3	6743	7488	1.20586927523344
IPR006212	Furin-like repeat	18	0.684826100723303	1	8	10	6739	7481	0.937898325181562
IPR006214	Bax inhibitor 1-related	 6	0.296087778157783	0.996215854772117	4	2	6743	7489	1.40684748777234
IPR006439	HAD hydrolase, subfamily IA	 5	0.7781801260834	1	2	3	6745	7488	0.844108492663406
IPR006536	HnRNP-L/PTB	 5	0.451093636045012	1	3	2	6744	7489	1.26616273899511
IPR006539	P-type ATPase, subfamily IV	12	0.147212368789038	0.806571393258297	8	4	6739	7487	1.40684748777234
IPR006544	P-type ATPase, subfamily  V	 5	0.156501784621734	0.806571393258297	4	1	6743	7490	1.68821698532681
IPR006553	Leucine-rich repeat, cysteine-containing subtype	17	0.1173745711786	0.806571393258297	11	6	6736	7485	1.36546962048492
IPR006560	AWS domain	 5	0.0238764544482636	0.400696547198938	5	0	6742	7491	2.11027123165852
IPR006561	DZF domain	 5	0.156501784621734	0.806571393258297	4	1	6743	7490	1.68821698532681
IPR006569	CID domain	 8	0.11282433035284	0.800900963894823	6	2	6741	7489	1.58270342374389
IPR006571	TLDc domain	 6	0.0867087878537095	0.700306179451134	5	1	6742	7490	1.75855935971543
IPR006574	SPRY-associated	32	0.999259021934019	1	7	25	6740	7466	0.4616218319253
IPR006575	RWD domain	10	0.314500257499634	0.996215854772117	6	4	6741	7487	1.26616273899511
IPR006576	BRK domain	 6	0.606099493932241	1	3	3	6744	7488	1.05513561582926
IPR006581	VPS10	 5	0.156501784621734	0.806571393258297	4	1	6743	7490	1.68821698532681
IPR006586	ADAM, cysteine-rich	19	0.245603573729651	0.976860445261401	11	8	6736	7483	1.22173597622335
IPR006593	Cytochrome b561/ferric reductase transmembrane	 5	0.7781801260834	1	2	3	6745	7488	0.844108492663406
IPR006594	LIS1 homology motif	28	0.000744553141943595	0.164204496229	22	6	6725	7485	1.65807025344598
IPR006595	CTLH, C-terminal LisH motif	10	0.0385318949833867	0.498382293530479	8	2	6739	7489	1.68821698532681
IPR006597	Sel1-like repeat	 8	0.307721488076794	0.996215854772117	5	3	6742	7488	1.31891951978657
IPR006599	CARP motif	 5	0.451093636045012	1	3	2	6744	7489	1.26616273899511
IPR006600	HTH CenpB-type DNA-binding domain	10	0.5573358874939	1	5	5	6742	7486	1.05513561582926
IPR006603	PQ-loop repeat	 5	0.959711673474999	1	1	4	6746	7487	0.422054246331703
IPR006612	Zinc finger, C2CH-type	12	0.898382914875138	1	4	8	6743	7483	0.703423743886172
IPR006615	Peptidase C19, ubiquitin-specific peptidase, DUSP domain	 7	0.185910764499323	0.845680287938012	5	2	6742	7489	1.5073365940418
IPR006620	Prolyl 4-hydroxylase, alpha subunit	13	0.640693632462334	1	6	7	6741	7484	0.973971337688545
IPR006630	RNA-binding protein Lupus La	 7	0.0470279971954641	0.527980989790211	6	1	6741	7490	1.80880391285016
IPR006634	TRAM/LAG1/CLN8 homology domain	16	0.514504384844781	1	8	8	6739	7483	1.05513561582926
IPR006636	Heat shock chaperonin-binding	 7	0.918536112180723	1	2	5	6745	7486	0.602934637616719
IPR006638	Elongator protein 3/MiaB/NifB	 6	0.86422044215898	1	2	4	6745	7487	0.703423743886172
IPR006639	Presenilin/signal peptide peptidase	 7	0.0470279971954641	0.527980989790211	6	1	6741	7490	1.80880391285016
IPR006642	Zinc finger, Rad18-type putative	 5	0.451093636045012	1	3	2	6744	7489	1.26616273899511
IPR006652	Kelch repeat type 1	55	0.0706566147134527	0.66528547825666	32	23	6715	7468	1.22779417114677
IPR006671	Cyclin, N-terminal	29	0.256206834784657	0.989333404834788	16	13	6731	7478	1.16428757608746
IPR006680	Amidohydrolase-related	 9	0.435918072496767	1	5	4	6742	7487	1.17237290647695
IPR006689	Small GTPase superfamily, ARF/SAR type	22	0.652020089710302	1	10	12	6737	7479	0.959214196208416
IPR006694	Fatty acid hydroxylase	 5	0.156501784621734	0.806571393258297	4	1	6743	7490	1.68821698532681
IPR006703	AIG1-type guanine nucleotide-binding (G) domain	 6	0.0867087878537095	0.700306179451134	5	1	6742	7490	1.75855935971543
IPR006797	PRELI/MSF1 domain	 6	0.296087778157783	0.996215854772117	4	2	6743	7489	1.40684748777234
IPR006816	ELMO domain	 6	0.296087778157783	0.996215854772117	4	2	6743	7489	1.40684748777234
IPR006821	Intermediate filament head, DNA-binding domain	 6	0.86422044215898	1	2	4	6745	7487	0.703423743886172
IPR006895	Zinc finger, Sec23/Sec24-type	 6	0.296087778157783	0.996215854772117	4	2	6743	7489	1.40684748777234
IPR006896	Sec23/Sec24, trunk domain	 6	0.296087778157783	0.996215854772117	4	2	6743	7489	1.40684748777234
IPR006900	Sec23/Sec24, helical domain	 6	0.296087778157783	0.996215854772117	4	2	6743	7489	1.40684748777234
IPR006903	RNA polymerase II-binding domain	 7	0.185910764499323	0.845680287938012	5	2	6742	7489	1.5073365940418
IPR006911	Armadillo repeat-containing domain	 9	0.205164220540816	0.889516885075412	6	3	6741	7488	1.40684748777234
IPR006941	Ribonuclease CAF1	 5	0.451093636045012	1	3	2	6744	7489	1.26616273899511
IPR006977	Yip1 domain	 5	0.156501784621734	0.806571393258297	4	1	6743	7490	1.68821698532681
IPR007052	CS domain	15	0.418386639190508	1	8	7	6739	7484	1.12547799021787
IPR007053	LRAT-like domain	 8	0.818534364570598	1	3	5	6744	7486	0.791351711871943
IPR007084	BRICHOS domain	 6	0.86422044215898	1	2	4	6745	7487	0.703423743886172
IPR007111	NACHT nucleoside triphosphatase	14	0.874077894035467	1	5	9	6742	7482	0.753668297020898
IPR007122	Villin/Gelsolin	 8	0.994139200942595	1	1	7	6746	7484	0.263783903957314
IPR007123	Gelsolin-like domain	14	0.874077894035467	1	5	9	6742	7482	0.753668297020898
IPR007125	Histone H2A/H2B/H3	23	0.997191557058217	1	5	18	6742	7473	0.458754615577938
IPR007197	Radical SAM	 6	0.86422044215898	1	2	4	6745	7487	0.703423743886172
IPR007237	CD20-like family	14	0.998312238378093	1	2	12	6745	7479	0.301467318808359
IPR007259	Gamma-tubulin complex component protein	 5	0.156501784621734	0.806571393258297	4	1	6743	7490	1.68821698532681
IPR007273	SCAMP	 5	0.156501784621734	0.806571393258297	4	1	6743	7490	1.68821698532681
IPR007330	MIT	12	0.012238601151671	0.339889572335004	10	2	6737	7489	1.75855935971543
IPR007369	Peptidase A22B, signal peptide peptidase	 5	0.156501784621734	0.806571393258297	4	1	6743	7490	1.68821698532681
IPR007397	F-box associated (FBA) domain	 5	0.959711673474999	1	1	4	6746	7487	0.422054246331703
IPR007484	Peptidase M28	 8	0.307721488076794	0.996215854772117	5	3	6742	7488	1.31891951978657
IPR007502	Helicase-associated domain	15	0.418386639190508	1	8	7	6739	7484	1.12547799021787
IPR007526	SWIRM domain	 6	0.606099493932241	1	3	3	6744	7488	1.05513561582926
IPR007527	Zinc finger, SWIM-type	 8	0.818534364570598	1	3	5	6744	7486	0.791351711871943
IPR007529	Zinc finger, HIT-type	 5	0.451093636045012	1	3	2	6744	7489	1.26616273899511
IPR007593	CD225/Dispanin family	 8	0.951870028050764	1	2	6	6745	7485	0.527567807914629
IPR007604	CP2 transcription factor	 5	0.451093636045012	1	3	2	6744	7489	1.26616273899511
IPR007623	Brain-expressed X-linked protein	 5	0.0238764544482636	0.400696547198938	5	0	6742	7491	2.11027123165852
IPR007632	Anoctamin	11	0.849533330740884	1	4	7	6743	7484	0.767371356966733
IPR007677	Gasdermin	 6	0.606099493932241	1	3	3	6744	7488	1.05513561582926
IPR007728	Pre-SET domain	 7	0.728431267104624	1	3	4	6744	7487	0.904401956425078
IPR007863	Peptidase M16, C-terminal	 7	0.00535698619579275	0.331550196952537	7	0	6740	7491	2.11027123165852
IPR007875	Sprouty	 7	0.918536112180723	1	2	5	6745	7486	0.602934637616719
IPR007889	DNA binding HTH domain, Psq-type	10	0.781996958992377	1	4	6	6743	7485	0.844108492663406
IPR007960	Taste receptor type 2	 6	0.606099493932241	1	3	3	6744	7488	1.05513561582926
IPR008011	Complex 1 LYR protein	10	0.0385318949833867	0.498382293530479	8	2	6739	7489	1.68821698532681
IPR008138	Saposin B type, region 2	 5	0.959711673474999	1	1	4	6746	7487	0.422054246331703
IPR008139	Saposin B type domain	 6	0.86422044215898	1	2	4	6745	7487	0.703423743886172
IPR008144	Guanylate kinase-like domain	20	0.494401109409875	1	10	10	6737	7481	1.05513561582926
IPR008145	Guanylate kinase/L-type calcium channel beta subunit	24	0.192066497470497	0.866214431611958	14	10	6733	7481	1.2309915518008
IPR008152	Clathrin adaptor, alpha/beta/gamma-adaptin, appendage, Ig-like subdomain	 9	0.00120153260786934	0.169008569285149	9	0	6738	7491	2.11027123165851
IPR008153	Gamma-adaptin ear (GAE) domain	 6	0.0113099877671744	0.331550196952537	6	0	6741	7491	2.11027123165852
IPR008160	Collagen triple helix repeat	61	0.918209088624749	1	24	37	6723	7454	0.830270648521383
IPR008197	WAP-type 'four-disulfide core' domain	 9	0.971908527019724	1	2	7	6745	7484	0.468949162590781
IPR008211	Laminin, N-terminal	14	0.726291373176396	1	6	8	6741	7483	0.904401956425078
IPR008250	P-type ATPase, A  domain	34	0.122001332868948	0.806571393258297	20	14	6727	7477	1.24133601862266
IPR008253	Marvel domain	25	0.395773627001197	1	13	12	6734	7479	1.09734104046243
IPR008254	Flavodoxin/nitric oxide synthase	 6	0.86422044215898	1	2	4	6745	7487	0.703423743886172
IPR008266	Tyrosine-protein kinase, active site	83	0.974887708604579	1	31	52	6716	7439	0.788173592547156
IPR008280	Tubulin/FtsZ, C-terminal	16	0.168402871096864	0.838307374045079	10	6	6737	7485	1.31891951978657
IPR008333	Oxidoreductase, FAD-binding domain	 5	0.451093636045012	1	3	2	6744	7489	1.26616273899511
IPR008343	Mitogen-activated protein (MAP) kinase phosphatase	 9	0.435918072496767	1	5	4	6742	7487	1.17237290647695
IPR008365	Prostanoid receptor	 8	0.951870028050764	1	2	6	6745	7485	0.527567807914629
IPR008368	Voltage-dependent calcium channel, gamma subunit	 5	0.7781801260834	1	2	3	6745	7488	0.844108492663406
IPR008405	Apolipoprotein L	 7	0.988855554331116	1	1	6	6746	7485	0.301467318808359
IPR008422	Homeobox KN domain	14	0.526563311510249	1	7	7	6740	7484	1.05513561582926
IPR008428	Chondroitin N-acetylgalactosaminyltransferase	 7	0.44299046303573	1	4	3	6743	7488	1.20586927523344
IPR008521	Magnesium transporter NIPA	 5	0.451093636045012	1	3	2	6744	7489	1.26616273899511
IPR008598	Drought induced 19 protein type, zinc-binding domain	 7	0.728431267104624	1	3	4	6744	7487	0.904401956425078
IPR008636	Hook-related protein family	 6	0.606099493932241	1	3	3	6744	7488	1.05513561582926
IPR008661	L6 membrane	 5	1	1	0	5	6747	7486	0
IPR008753	Peptidase M13, N-terminal domain	 5	1	1	0	5	6747	7486	0
IPR008859	Thrombospondin, C-terminal	 5	1	1	0	5	6747	7486	0
IPR008906	HAT, C-terminal dimerisation domain	 5	0.959711673474999	1	1	4	6746	7487	0.422054246331703
IPR008916	Retrovirus capsid, C-terminal	45	0.706405838796912	1	20	25	6727	7466	0.937898325181562
IPR008917	Transcription factor, Skn-1-like, DNA-binding domain	15	0.912946663336211	1	5	10	6742	7481	0.703423743886172
IPR008921	DNA polymerase III, clamp loader complex, gamma/delta/delta subunit, C-terminal	 6	0.0113099877671744	0.331550196952537	6	0	6741	7491	2.11027123165852
IPR008927	6-phosphogluconate dehydrogenase C-terminal domain-like	12	0.898382914875138	1	4	8	6743	7483	0.703423743886172
IPR008928	Six-hairpin glycosidase-like	10	0.781996958992377	1	4	6	6743	7485	0.844108492663406
IPR008930	Terpenoid cyclases/protein prenyltransferase alpha-alpha toroid	11	0.952585381968349	1	3	8	6744	7483	0.57552851772505
IPR008936	Rho GTPase activation protein	79	0.320062671200564	0.996215854772117	40	39	6707	7452	1.06849176286507
IPR008942	ENTH/VHS	25	0.000175368624382427	0.138804266198691	21	4	6726	7487	1.77262783459315
IPR008949	Isoprenoid synthase domain	 6	0.606099493932241	1	3	3	6744	7488	1.05513561582926
IPR008952	Tetraspanin, EC2 domain	29	0.999281062776612	1	6	23	6741	7468	0.436607841032796
IPR008954	Moesin tail domain	 5	0.7781801260834	1	2	3	6745	7488	0.844108492663406
IPR008958	Transglutaminase, C-terminal	 7	0.988855554331116	1	1	6	6746	7485	0.301467318808359
IPR008962	PapD-like	10	0.781996958992377	1	4	6	6743	7485	0.844108492663406
IPR008967	p53-like transcription factor, DNA-binding	39	0.973810438908754	1	13	26	6734	7465	0.703423743886172
IPR008969	Carboxypeptidase-like, regulatory domain	11	0.952585381968349	1	3	8	6744	7483	0.57552851772505
IPR008971	HSP40/DnaJ peptide-binding	 8	0.951870028050764	1	2	6	6745	7485	0.527567807914629
IPR008972	Cupredoxin	16	0.940825060983318	1	5	11	6742	7480	0.659459759893286
IPR008974	TRAF-like	21	0.576463182978234	1	10	11	6737	7480	1.00489106269453
IPR008978	HSP20-like chaperone	22	0.793947417151464	1	9	13	6738	7478	0.863292776587574
IPR008979	Galactose-binding domain-like	73	0.600487958809621	1	34	39	6713	7452	0.982866053101226
IPR008983	Tumour necrosis factor-like domain	34	0.974515351363869	1	11	23	6736	7468	0.682734810242461
IPR008984	SMAD/FHA domain	47	0.588264931486696	1	22	25	6725	7466	0.987786533967816
IPR008991	Translation protein SH3-like domain	 8	0.578259437994666	1	4	4	6743	7487	1.05513561582926
IPR008993	Tissue inhibitor of metalloproteinases-like, OB-fold	22	0.984157354545405	1	6	16	6741	7475	0.57552851772505
IPR008996	Cytokine IL1/FGF	21	0.999972622271258	1	2	19	6745	7472	0.200978212538906
IPR009000	Translation protein, beta-barrel domain	25	0.395773627001197	1	13	12	6734	7479	1.09734104046243
IPR009001	Translation elongation factor EF1A/initiation factor IF2gamma, C-terminal	 8	0.578259437994666	1	4	4	6743	7487	1.05513561582926
IPR009003	Peptidase S1, PA clan	81	0.999999999982216	1	11	70	6736	7421	0.286580043805477
IPR009008	Valyl/Leucyl/Isoleucyl-tRNA synthetase, editing domain	 6	0.0113099877671744	0.331550196952537	6	0	6741	7491	2.11027123165852
IPR009011	Mannose-6-phosphate receptor binding domain	 8	0.0250958861430055	0.400696547198938	7	1	6740	7490	1.8464873277012
IPR009020	Protease propeptides/proteinase inhibitor I9	12	0.994702855212401	1	2	10	6745	7481	0.351711871943086
IPR009022	Elongation factor G, III-V domain	 6	0.296087778157783	0.996215854772117	4	2	6743	7489	1.40684748777234
IPR009028	Coatomer/calthrin adaptor appendage, C-terminal subdomain	 6	0.0867087878537095	0.700306179451134	5	1	6742	7490	1.75855935971543
IPR009038	GOLD domain	16	0.514504384844781	1	8	8	6739	7483	1.05513561582926
IPR009039	EAR	 6	0.296087778157783	0.996215854772117	4	2	6743	7489	1.40684748777234
IPR009048	Alpha-macroglobulin, receptor-binding	 7	0.988855554331116	1	1	6	6746	7485	0.301467318808359
IPR009050	Globin-like	 6	0.978809919738203	1	1	5	6746	7486	0.351711871943086
IPR009060	UBA-like	50	0.00607615427634305	0.331550196952537	33	17	6714	7474	1.39277901289462
IPR009061	Putative DNA-binding domain	 8	0.0250958861430055	0.400696547198938	7	1	6740	7490	1.8464873277012
IPR009068	S15/NS1, RNA-binding	 6	0.296087778157783	0.996215854772117	4	2	6743	7489	1.40684748777234
IPR009071	High mobility group box domain	51	0.573331858140147	1	24	27	6723	7464	0.993068814898125
IPR009072	Histone-fold	50	0.995981404813376	1	15	35	6732	7456	0.633081369497554
IPR009075	Acyl-CoA dehydrogenase/oxidase C-terminal	12	0.318565851958547	0.996215854772117	7	5	6740	7486	1.2309915518008
IPR009078	Ferritin-like superfamily	 5	0.7781801260834	1	2	3	6745	7488	0.844108492663406
IPR009079	Four-helical cytokine-like, core	20	0.999997390307277	1	1	19	6746	7472	0.105513561582926
IPR009080	Aminoacyl-tRNA synthetase, class Ia, anticodon-binding	13	0.00675909300174208	0.331550196952537	11	2	6736	7489	1.78561411909567
IPR009091	Regulator of chromosome condensation 1/beta-lactamase-inhibitor protein II	21	0.40413282848468	1	11	10	6736	7481	1.10538016896398
IPR009097	Cyclic phosphodiesterase	 6	0.86422044215898	1	2	4	6745	7487	0.703423743886172
IPR009100	Acyl-CoA dehydrogenase/oxidase, N-terminal and middle domain	12	0.318565851958547	0.996215854772117	7	5	6740	7486	1.2309915518008
IPR009110	Nuclear receptor coactivator, interlocking	 5	0.156501784621734	0.806571393258297	4	1	6743	7490	1.68821698532681
IPR009168	Insulin-like growth factor binding protein	 6	1	1	0	6	6747	7485	0
IPR009254	Laminin alpha, domain I	 5	0.7781801260834	1	2	3	6745	7488	0.844108492663406
IPR009263	SERTA domain	 5	0.7781801260834	1	2	3	6745	7488	0.844108492663406
IPR009398	Adenylate cyclase, conserved domain	 6	0.978809919738203	1	1	5	6746	7486	0.351711871943086
IPR009818	Ataxin-2, C-terminal	 8	0.578259437994666	1	4	4	6743	7487	1.05513561582926
IPR010255	Haem peroxidase	 8	0.951870028050764	1	2	6	6745	7485	0.527567807914629
IPR010294	ADAM-TS Spacer 1	19	0.875695456652499	1	7	12	6740	7479	0.777468348505769
IPR010307	Laminin domain II	 5	0.7781801260834	1	2	3	6745	7488	0.844108492663406
IPR010326	Exocyst complex component EXOC3/Sec6	 5	0.959711673474999	1	1	4	6746	7487	0.422054246331703
IPR010439	Calcium-dependent secretion activator domain	 5	0.156501784621734	0.806571393258297	4	1	6743	7490	1.68821698532681
IPR010442	PET domain	 5	1	1	0	5	6747	7486	0
IPR010448	Torsin	 5	0.959711673474999	1	1	4	6746	7487	0.422054246331703
IPR010472	Formin, FH3 domain	 9	0.435918072496767	1	5	4	6742	7487	1.17237290647695
IPR010473	Formin, GTPase-binding domain	 9	0.435918072496767	1	5	4	6742	7487	1.17237290647695
IPR010504	Arfaptin homology (AH) domain	 5	0.0238764544482636	0.400696547198938	5	0	6742	7491	2.11027123165852
IPR010506	DMAP1-binding domain	 6	0.0867087878537095	0.700306179451134	5	1	6742	7490	1.75855935971543
IPR010507	Zinc finger, MYM-type	 6	0.0867087878537095	0.700306179451134	5	1	6742	7490	1.75855935971543
IPR010526	Sodium ion transport-associated	 8	0.951870028050764	1	2	6	6745	7485	0.527567807914629
IPR010569	Myotubularin-like phosphatase domain	13	0.0964724174428019	0.737757665758239	9	4	6738	7487	1.46095700653282
IPR010600	Inter-alpha-trypsin inhibitor heavy chain, C-terminal	 6	0.978809919738203	1	1	5	6746	7486	0.351711871943086
IPR010622	FAST kinase leucine-rich	 6	0.296087778157783	0.996215854772117	4	2	6743	7489	1.40684748777234
IPR010625	CHCH	 6	0.86422044215898	1	2	4	6745	7487	0.703423743886172
IPR010666	Zinc finger, GRF-type	 6	0.606099493932241	1	3	3	6744	7488	1.05513561582926
IPR010703	Dedicator of cytokinesis, C-terminal	11	0.429568982367594	1	6	5	6741	7486	1.1510570354501
IPR010734	Copine	 9	0.0666543852588519	0.639451333797848	7	2	6740	7489	1.64132206906773
IPR010844	Occludin homology domain	 5	0.7781801260834	1	2	3	6745	7488	0.844108492663406
IPR010908	Longin domain	 5	0.451093636045012	1	3	2	6744	7489	1.26616273899511
IPR010909	PLAC	18	0.925417639802123	1	6	12	6741	7479	0.703423743886172
IPR010911	Rab-binding domain	11	0.0829386011160441	0.700306179451134	8	3	6739	7488	1.53474271393347
IPR010919	SAND domain-like	10	0.5573358874939	1	5	5	6742	7486	1.05513561582926
IPR010920	LSM domain	20	0.494401109409875	1	10	10	6737	7481	1.05513561582926
IPR010926	Class I myosin tail homology domain	 6	0.86422044215898	1	2	4	6745	7487	0.703423743886172
IPR010935	SMCs flexible hinge	 6	0.296087778157783	0.996215854772117	4	2	6743	7489	1.40684748777234
IPR010982	Lambda repressor-like, DNA-binding domain	19	0.948366339717334	1	6	13	6741	7478	0.666401441576373
IPR010987	Glutathione S-transferase, C-terminal-like	27	0.391855307881216	1	14	13	6733	7478	1.09421471271182
IPR010989	SNARE	15	0.0387245875579589	0.498382293530479	11	4	6736	7487	1.54753223654958
IPR010994	RuvA domain 2-like	 8	0.11282433035284	0.800900963894823	6	2	6741	7489	1.58270342374389
IPR011001	Saposin-like	 7	0.918536112180723	1	2	5	6745	7486	0.602934637616719
IPR011004	Trimeric LpxA-like	 7	0.44299046303573	1	4	3	6743	7488	1.20586927523344
IPR011008	Dimeric alpha-beta barrel	 7	0.0470279971954641	0.527980989790211	6	1	6741	7490	1.80880391285016
IPR011012	Longin-like domain	24	0.100305453297802	0.759729820911105	15	9	6732	7482	1.31891951978657
IPR011013	Galactose mutarotase-like domain	 8	0.0250958861430055	0.400696547198938	7	1	6740	7490	1.8464873277012
IPR011015	LEM/LEM-like domain	 6	0.606099493932241	1	3	3	6744	7488	1.05513561582926
IPR011016	Zinc finger, RING-CH-type	17	0.413358401054748	1	9	8	6738	7483	1.11720241676039
IPR011017	TRASH domain	 7	0.185910764499323	0.845680287938012	5	2	6742	7489	1.5073365940418
IPR011021	Arrestin-like, N-terminal	 8	0.818534364570598	1	3	5	6744	7486	0.791351711871943
IPR011022	Arrestin C-terminal-like domain	 8	0.818534364570598	1	3	5	6744	7486	0.791351711871943
IPR011024	Gamma-crystallin-related	12	0.999552003041346	1	1	11	6746	7480	0.175855935971543
IPR011025	G protein alpha subunit, helical insertion	14	0.726291373176396	1	6	8	6741	7483	0.904401956425078
IPR011029	Death-like domain	74	0.977926918254652	1	27	47	6720	7444	0.769963827767296
IPR011032	GroES-like	16	0.0714456925480936	0.66528547825666	11	5	6736	7486	1.45081147176523
IPR011040	Sialidases	 7	0.728431267104624	1	3	4	6744	7487	0.904401956425078
IPR011041	Soluble quinoprotein glucose/sorbosone dehydrogenase	 6	0.606099493932241	1	3	3	6744	7488	1.05513561582926
IPR011042	Six-bladed beta-propeller, TolB-like	35	0.257951629588203	0.989333404834788	19	16	6728	7475	1.14557581147177
IPR011043	Galactose oxidase/kelch, beta-propeller	12	0.012238601151671	0.339889572335004	10	2	6737	7489	1.75855935971543
IPR011044	Quinoprotein amine dehydrogenase, beta chain-like	11	0.218609653443	0.910681793158603	7	4	6740	7487	1.34289987469178
IPR011047	Quinoprotein alcohol dehydrogenase-like superfamily	41	0.101142326760988	0.762420491726875	24	17	6723	7474	1.23528072097084
IPR011051	RmlC-like cupin domain	 7	0.44299046303573	1	4	3	6743	7488	1.20586927523344
IPR011053	Single hybrid motif	10	0.0385318949833867	0.498382293530479	8	2	6739	7489	1.68821698532681
IPR011054	Rudiment single hybrid motif	 6	0.296087778157783	0.996215854772117	4	2	6743	7489	1.40684748777234
IPR011057	Mss4-like	 6	0.606099493932241	1	3	3	6744	7488	1.05513561582926
IPR011059	Metal-dependent hydrolase, composite domain	 9	0.435918072496767	1	5	4	6742	7487	1.17237290647695
IPR011072	HR1 rho-binding repeat	 7	0.728431267104624	1	3	4	6744	7487	0.904401956425078
IPR011074	CRAL/TRIO, N-terminal domain	10	0.132273529234937	0.806571393258297	7	3	6740	7488	1.47718986216096
IPR011124	Zinc finger, CW-type	 5	0.451093636045012	1	3	2	6744	7489	1.26616273899511
IPR011129	Cold shock domain	 5	0.7781801260834	1	2	3	6745	7488	0.844108492663406
IPR011146	HIT-like domain	 9	0.0666543852588519	0.639451333797848	7	2	6740	7489	1.64132206906773
IPR011161	MHC class I-like antigen recognition-like	18	0.999836997831119	1	2	16	6745	7475	0.234474581295391
IPR011162	MHC classes I/II-like antigen recognition protein	26	0.999878875416495	1	4	22	6743	7469	0.324657112562848
IPR011249	Metalloenzyme, LuxS/M16 peptidase-like	 7	0.00535698619579275	0.331550196952537	7	0	6740	7491	2.11027123165852
IPR011330	Glycoside hydrolase/deacetylase, beta/alpha-barrel	 6	0.0113099877671744	0.331550196952537	6	0	6741	7491	2.11027123165852
IPR011332	Zinc-binding ribosomal protein	 5	0.451093636045012	1	3	2	6744	7489	1.26616273899511
IPR011489	EMI domain	11	0.663808308432488	1	5	6	6742	7485	0.959214196208416
IPR011498	Kelch repeat type 2	 5	0.0238764544482636	0.400696547198938	5	0	6742	7491	2.11027123165852
IPR011500	GPCR, family 3, nine cysteines domain	 9	0.692132530392986	1	4	5	6743	7486	0.937898325181562
IPR011511	Variant SH3 domain	52	0.302125907120612	0.996215854772117	27	25	6720	7466	1.09571775489961
IPR011524	SARAH domain	 8	0.0250958861430055	0.400696547198938	7	1	6740	7490	1.8464873277012
IPR011527	ABC transporter type 1, transmembrane domain	25	0.395773627001197	1	13	12	6734	7479	1.09734104046243
IPR011531	Bicarbonate transporter, C-terminal	 7	0.728431267104624	1	3	4	6744	7487	0.904401956425078
IPR011539	Rel homology domain (RHD), DNA-binding domain	 9	0.881735281659405	1	3	6	6744	7485	0.703423743886172
IPR011545	DEAD/DEAH box helicase domain	58	0.393838117786691	1	29	29	6718	7462	1.05513561582926
IPR011547	SLC26A/SulP transporter domain	 8	0.578259437994666	1	4	4	6743	7487	1.05513561582926
IPR011583	Chitinase II	 7	0.728431267104624	1	3	4	6744	7487	0.904401956425078
IPR011598	Myc-type, basic helix-loop-helix (bHLH) domain	91	0.99909832135353	1	29	62	6718	7429	0.672504018880186
IPR011625	Alpha-2-macroglobulin, N-terminal 2	 7	0.988855554331116	1	1	6	6746	7485	0.301467318808359
IPR011626	Alpha-macroglobulin complement component	 7	0.988855554331116	1	1	6	6746	7485	0.301467318808359
IPR011641	Tyrosine-protein kinase ephrin type A/B receptor-like	22	0.793947417151464	1	9	13	6738	7478	0.863292776587574
IPR011645	Haem NO binding associated	 5	0.451093636045012	1	3	2	6744	7489	1.26616273899511
IPR011651	Notch ligand, N-terminal domain	 5	0.451093636045012	1	3	2	6744	7489	1.26616273899511
IPR011701	Major facilitator superfamily	52	0.141527272684298	0.806571393258297	29	23	6718	7468	1.17688203304033
IPR011704	ATPase, dynein-related, AAA domain	10	0.314500257499634	0.996215854772117	6	4	6741	7487	1.26616273899511
IPR011705	BTB/Kelch-associated	54	0.401067566944438	1	27	27	6720	7464	1.05513561582926
IPR011709	Domain of unknown function DUF1605	14	0.320964034776418	0.996215854772117	8	6	6739	7485	1.20586927523344
IPR011761	ATP-grasp fold	13	0.0964724174428019	0.737757665758239	9	4	6738	7487	1.46095700653282
IPR011764	Biotin carboxylation domain	 5	0.451093636045012	1	3	2	6744	7489	1.26616273899511
IPR011765	Peptidase M16, N-terminal	 7	0.00535698619579275	0.331550196952537	7	0	6740	7491	2.11027123165852
IPR011778	Hydantoinase/dihydropyrimidinase	 6	0.606099493932241	1	3	3	6744	7488	1.05513561582926
IPR011948	Dullard phosphatase domain, eukaryotic	 5	0.7781801260834	1	2	3	6745	7488	0.844108492663406
IPR012163	Sialyltransferase	12	0.540572112776641	1	6	6	6741	7485	1.05513561582926
IPR012227	TNF receptor-associated factor TRAF	 5	0.451093636045012	1	3	2	6744	7489	1.26616273899511
IPR012317	Poly(ADP-ribose) polymerase, catalytic domain	15	0.621217899790023	1	7	8	6740	7483	0.98479324144064
IPR012337	Ribonuclease H-like domain	58	0.213308609107707	0.910155062580864	31	27	6716	7464	1.12790358933472
IPR012340	Nucleic acid-binding, OB-fold	65	0.0275904535231105	0.42819301889298	39	26	6708	7465	1.26616273899511
IPR012345	STAT transcription factor, DNA-binding, subdomain	 7	0.185910764499323	0.845680287938012	5	2	6742	7489	1.5073365940418
IPR012346	p53/RUNT-type transcription factor, DNA-binding domain	 5	1	1	0	5	6747	7486	0
IPR012461	Protein of unknown function DUF1669	 7	0.988855554331116	1	1	6	6746	7485	0.301467318808359
IPR012496	TMC	 5	0.959711673474999	1	1	4	6746	7487	0.422054246331703
IPR012674	Calycin	25	0.995581453791361	1	6	19	6741	7472	0.506465095598044
IPR012675	Beta-grasp domain	13	0.228396290943016	0.934241159076989	8	5	6739	7486	1.29862845025139
IPR012676	TGS-like	 7	0.44299046303573	1	4	3	6743	7488	1.20586927523344
IPR012896	Integrin beta subunit, tail	 5	0.7781801260834	1	2	3	6745	7488	0.844108492663406
IPR012919	SUN domain	 5	0.451093636045012	1	3	2	6744	7489	1.26616273899511
IPR012921	Spen paralogue and orthologue SPOC, C-terminal	 6	0.0867087878537095	0.700306179451134	5	1	6742	7490	1.75855935971543
IPR012947	Threonyl/alanyl tRNA synthetase, SAD	 5	0.451093636045012	1	3	2	6744	7489	1.26616273899511
IPR012983	PHR	 5	0.959711673474999	1	1	4	6746	7487	0.422054246331703
IPR012990	Sec23/Sec24 beta-sandwich	 6	0.296087778157783	0.996215854772117	4	2	6743	7489	1.40684748777234
IPR013017	NHL repeat, subgroup	 7	0.44299046303573	1	4	3	6743	7488	1.20586927523344
IPR013019	MAD homology, MH1	 8	0.307721488076794	0.996215854772117	5	3	6742	7488	1.31891951978657
IPR013041	Coatomer/clathrin adaptor appendage, Ig-like subdomain	13	0.000933569466873655	0.164204496229	12	1	6735	7490	1.94794267537709
IPR013057	Amino acid transporter, transmembrane domain	13	0.821296993728656	1	5	8	6742	7483	0.811642781407121
IPR013078	Histidine phosphatase superfamily, clade-1	10	0.314500257499634	0.996215854772117	6	4	6741	7487	1.26616273899511
IPR013088	Zinc finger, NHR/GATA-type	51	0.945213097831773	1	19	32	6728	7459	0.786179478461015
IPR013092	Connexin, N-terminal	15	0.971750526562492	1	4	11	6743	7480	0.562738995108937
IPR013099	Potassium channel domain	20	0.988966001218804	1	5	15	6742	7476	0.527567807914629
IPR013105	Tetratricopeptide repeat 2	13	0.640693632462334	1	6	7	6741	7484	0.973971337688545
IPR013111	EGF-like domain, extracellular	17	0.241300442408668	0.962162721241616	10	7	6737	7484	1.24133601862266
IPR013122	Polycystin cation channel, PKD1/PKD2	 5	0.451093636045012	1	3	2	6744	7489	1.26616273899511
IPR013126	Heat shock protein 70 family	12	0.540572112776641	1	6	6	6741	7485	1.05513561582926
IPR013128	Peptidase C1A	13	0.997002331611534	1	2	11	6745	7480	0.324657112562848
IPR013130	Ferric reductase transmembrane component-like domain	 9	0.996918035182955	1	1	8	6746	7483	0.234474581295391
IPR013144	CRA domain	 6	0.0867087878537095	0.700306179451134	5	1	6742	7490	1.75855935971543
IPR013149	Alcohol dehydrogenase, C-terminal	13	0.228396290943016	0.934241159076989	8	5	6739	7486	1.29862845025139
IPR013151	Immunoglobulin	57	0.999097530041947	1	16	41	6731	7450	0.592356836956776
IPR013154	Alcohol dehydrogenase, N-terminal	13	0.0964724174428019	0.737757665758239	9	4	6738	7487	1.46095700653282
IPR013155	Methionyl/Valyl/Leucyl/Isoleucyl-tRNA synthetase, anticodon-binding	 6	0.0113099877671744	0.331550196952537	6	0	6741	7491	2.11027123165852
IPR013162	CD80-like, immunoglobulin C2-set	24	0.777427531599741	1	10	14	6737	7477	0.879279679857714
IPR013164	Cadherin, N-terminal	34	0.893472012644049	1	13	21	6734	7470	0.806868412104726
IPR013201	Cathepsin propeptide inhibitor domain (I29)	 7	0.988855554331116	1	1	6	6746	7485	0.301467318808359
IPR013216	Methyltransferase type 11	10	0.314500257499634	0.996215854772117	6	4	6741	7487	1.26616273899511
IPR013273	Peptidase M12B, ADAM-TS	19	0.948366339717334	1	6	13	6741	7478	0.666401441576373
IPR013315	Spectrin alpha chain, SH3 domain	12	0.540572112776641	1	6	6	6741	7485	1.05513561582926
IPR013328	6-phosphogluconate dehydrogenase, domain 2	10	0.781996958992377	1	4	6	6743	7485	0.844108492663406
IPR013517	FG-GAP repeat	13	0.932643324273574	1	4	9	6743	7482	0.649314225125697
IPR013518	Potassium channel, inwardly rectifying, Kir, cytoplasmic	14	0.526563311510249	1	7	7	6740	7484	1.05513561582926
IPR013519	Integrin alpha beta-propellor	13	0.932643324273574	1	4	9	6743	7482	0.649314225125697
IPR013520	Exonuclease, RNase T/DNA polymerase III	 9	0.205164220540816	0.889516885075412	6	3	6741	7488	1.40684748777234
IPR013548	Plexin, cytoplasmic RasGAP domain	 8	0.578259437994666	1	4	4	6743	7487	1.05513561582926
IPR013568	SEFIR domain	 6	0.86422044215898	1	2	4	6745	7487	0.703423743886172
IPR013579	FAST kinase-like protein, subdomain 2	 6	0.296087778157783	0.996215854772117	4	2	6743	7489	1.40684748777234
IPR013584	RAP domain	 6	0.296087778157783	0.996215854772117	4	2	6743	7489	1.40684748777234
IPR013594	Dynein heavy chain, domain-1	 6	0.606099493932241	1	3	3	6744	7488	1.05513561582926
IPR013598	Exportin-1/Importin-beta-like	 6	0.0113099877671744	0.331550196952537	6	0	6741	7491	2.11027123165852
IPR013602	Dynein heavy chain, domain-2	10	0.132273529234937	0.806571393258297	7	3	6740	7488	1.47718986216096
IPR013606	IMD/I-BAR domain	 5	0.7781801260834	1	2	3	6745	7488	0.844108492663406
IPR013625	Tensin/EPS8 phosphotyrosine-binding domain	 8	0.951870028050764	1	2	6	6745	7485	0.527567807914629
IPR013632	DNA recombination and repair protein Rad51-like, C-terminal	 5	0.156501784621734	0.806571393258297	4	1	6743	7490	1.68821698532681
IPR013649	Integrin alpha-2	12	0.898382914875138	1	4	8	6743	7483	0.703423743886172
IPR013655	PAS fold-3	10	0.998379418036325	1	1	9	6746	7482	0.211027123165852
IPR013662	RyR/IP3R Homology associated domain	 6	0.296087778157783	0.996215854772117	4	2	6743	7489	1.40684748777234
IPR013684	Mitochondrial Rho-like	 8	0.11282433035284	0.800900963894823	6	2	6741	7489	1.58270342374389
IPR013694	VIT domain	 9	0.996918035182955	1	1	8	6746	7483	0.234474581295391
IPR013750	GHMP kinase, C-terminal domain	 5	0.7781801260834	1	2	3	6745	7488	0.844108492663406
IPR013763	Cyclin-like	38	0.208596975243523	0.894875370760156	21	17	6726	7474	1.16620252275865
IPR013766	Thioredoxin domain	32	0.118537801375081	0.806571393258297	19	13	6728	7478	1.25297354379724
IPR013767	PAS fold	18	0.503894207576696	1	9	9	6738	7482	1.05513561582926
IPR013768	Intercellular adhesion molecule, N-terminal	 5	0.959711673474999	1	1	4	6746	7487	0.422054246331703
IPR013769	Band 3 cytoplasmic domain	 6	0.606099493932241	1	3	3	6744	7488	1.05513561582926
IPR013785	Aldolase-type TIM barrel	35	0.852274102948921	1	14	21	6733	7470	0.844108492663406
IPR013786	Acyl-CoA dehydrogenase/oxidase, N-terminal	11	0.218609653443	0.910681793158603	7	4	6740	7487	1.34289987469178
IPR013787	S100/CaBP-9k-type, calcium binding, subdomain	18	0.998659092555025	1	3	15	6744	7476	0.351711871943086
IPR013790	Dwarfin	 8	0.307721488076794	0.996215854772117	5	3	6742	7488	1.31891951978657
IPR013799	STAT transcription factor, protein interaction	 7	0.185910764499323	0.845680287938012	5	2	6742	7489	1.5073365940418
IPR013800	STAT transcription factor, all-alpha domain	 7	0.185910764499323	0.845680287938012	5	2	6742	7489	1.5073365940418
IPR013801	STAT transcription factor, DNA-binding	 7	0.185910764499323	0.845680287938012	5	2	6742	7489	1.5073365940418
IPR013806	Kringle-like fold	20	0.811712983546889	1	8	12	6739	7479	0.844108492663406
IPR013808	Transglutaminase, active site	 7	0.988855554331116	1	1	6	6746	7485	0.301467318808359
IPR013809	ENTH  domain	 9	0.0666543852588519	0.639451333797848	7	2	6740	7489	1.64132206906773
IPR013815	ATP-grasp fold, subdomain 1	14	0.158970483067965	0.806571393258297	9	5	6738	7486	1.35660293463762
IPR013818	Lipase/vitellogenin	 5	0.959711673474999	1	1	4	6746	7487	0.422054246331703
IPR013819	Lipoxygenase, C-terminal	 5	0.959711673474999	1	1	4	6746	7487	0.422054246331703
IPR013821	Potassium channel, voltage dependent, KCNQ, C-terminal	 5	0.7781801260834	1	2	3	6745	7488	0.844108492663406
IPR013830	SGNH hydrolase-type esterase domain	 6	0.606099493932241	1	3	3	6744	7488	1.05513561582926
IPR013838	Beta tubulin, autoregulation binding site	 6	0.296087778157783	0.996215854772117	4	2	6743	7489	1.40684748777234
IPR013847	POU domain	 8	0.951870028050764	1	2	6	6745	7485	0.527567807914629
IPR013977	Glycine cleavage T-protein, C-terminal barrel domain	 5	0.451093636045012	1	3	2	6744	7489	1.26616273899511
IPR013979	Translation initiation factor, beta propellor-like domain	 5	0.451093636045012	1	3	2	6744	7489	1.26616273899511
IPR014001	Helicase superfamily 1/2, ATP-binding domain	95	0.0402171678410574	0.506606094790691	54	41	6693	7450	1.19952259483747
IPR014009	PIK-related kinase	 6	0.0113099877671744	0.331550196952537	6	0	6741	7491	2.11027123165852
IPR014014	RNA helicase, DEAD-box type, Q motif	30	0.457483642404989	1	15	15	6732	7476	1.05513561582926
IPR014020	Tensin phosphatase, C2 domain	 6	0.296087778157783	0.996215854772117	4	2	6743	7489	1.40684748777234
IPR014044	CAP domain	 6	1	1	0	6	6747	7485	0
IPR014352	FERM/acyl-CoA-binding protein, 3-helical bundle	45	0.0608144553535274	0.62262586120625	27	18	6720	7473	1.26616273899511
IPR014710	RmlC-like jelly roll fold	43	0.4839016782896	1	21	22	6726	7469	1.03059757825183
IPR014715	Fibrinogen, alpha/beta/gamma chain, C-terminal globular, subdomain 2	17	0.999706119467108	1	2	15	6745	7476	0.248267203724531
IPR014716	Fibrinogen, alpha/beta/gamma chain, C-terminal globular, subdomain 1	21	0.998395649865949	1	4	17	6743	7474	0.401956425077812
IPR014720	Double-stranded RNA-binding domain	24	0.321808393417566	0.996215854772117	13	11	6734	7480	1.14306358381503
IPR014721	Ribosomal protein S5 domain 2-type fold, subgroup	20	0.0875977828771641	0.703894874591628	13	7	6734	7484	1.37167630057803
IPR014722	Ribosomal protein L2 domain 2	12	0.147212368789038	0.806571393258297	8	4	6739	7487	1.40684748777234
IPR014729	Rossmann-like alpha/beta/alpha sandwich fold	40	0.0187314665072509	0.400696547198938	26	14	6721	7477	1.37167630057803
IPR014743	Chloride channel, core	 8	0.11282433035284	0.800900963894823	6	2	6741	7489	1.58270342374389
IPR014745	MHC class II, alpha/beta chain, N-terminal	 8	0.951870028050764	1	2	6	6745	7485	0.527567807914629
IPR014756	Immunoglobulin E-set	88	0.939029809912746	1	35	53	6712	7438	0.839312421682364
IPR014764	Defective-in-cullin neddylation protein	 5	0.156501784621734	0.806571393258297	4	1	6743	7490	1.68821698532681
IPR014767	Diaphanous autoregulatory (DAD) domain	 8	0.307721488076794	0.996215854772117	5	3	6742	7488	1.31891951978657
IPR014768	Rho GTPase-binding/formin homology 3 (GBD/FH3) domain	11	0.429568982367594	1	6	5	6741	7486	1.1510570354501
IPR014770	Munc13 homology 1	 7	0.44299046303573	1	4	3	6743	7488	1.20586927523344
IPR014772	Mammalian uncoordinated homology 13, domain 2	 5	0.451093636045012	1	3	2	6744	7489	1.26616273899511
IPR014775	L27 domain, C-terminal	 9	0.435918072496767	1	5	4	6742	7487	1.17237290647695
IPR014782	Peptidase M1, membrane alanine aminopeptidase, N-terminal	11	0.952585381968349	1	3	8	6744	7483	0.57552851772505
IPR014811	Argonaute, linker 1 domain	 6	0.296087778157783	0.996215854772117	4	2	6743	7489	1.40684748777234
IPR014821	Inositol 1,4,5-trisphosphate/ryanodine receptor	 6	0.296087778157783	0.996215854772117	4	2	6743	7489	1.40684748777234
IPR014847	FERM adjacent (FA)	12	0.0508017172795473	0.547068833017165	9	3	6738	7488	1.58270342374389
IPR014853	Uncharacterised domain, cysteine-rich	11	0.952585381968349	1	3	8	6744	7483	0.57552851772505
IPR014868	Cadherin prodomain	 5	1	1	0	5	6747	7486	0
IPR014873	Voltage-dependent calcium channel, alpha-1 subunit, IQ domain	 7	0.918536112180723	1	2	5	6745	7486	0.602934637616719
IPR015048	Domain of unknown function DUF1899	 7	0.918536112180723	1	2	5	6745	7486	0.602934637616719
IPR015153	EF-hand domain, type 1	 5	0.0238764544482636	0.400696547198938	5	0	6742	7491	2.11027123165852
IPR015154	EF-hand domain, type 2	 5	0.0238764544482636	0.400696547198938	5	0	6742	7491	2.11027123165852
IPR015321	Type I cytokine receptor, cytokine-binding domain	10	0.983765589502622	1	2	8	6745	7483	0.422054246331703
IPR015338	Exostosin , C-terminal	 5	0.451093636045012	1	3	2	6744	7489	1.26616273899511
IPR015359	Phosphoinositide-specific phospholipase C, EF-hand-like domain	11	0.999147907388934	1	1	10	6746	7481	0.191842839241683
IPR015373	Interferon/interleukin receptor domain	 9	0.881735281659405	1	3	6	6744	7485	0.703423743886172
IPR015404	Sorting nexin Vps5-like, C-terminal	 5	0.451093636045012	1	3	2	6744	7489	1.26616273899511
IPR015415	Vps4 oligomerisation, C-terminal	 7	0.44299046303573	1	4	3	6743	7488	1.20586927523344
IPR015421	Pyridoxal phosphate-dependent transferase, major region, subdomain 1	33	0.257603773551075	0.989333404834788	18	15	6729	7476	1.1510570354501
IPR015422	Pyridoxal phosphate-dependent transferase, subdomain 2	29	0.256206834784657	0.989333404834788	16	13	6731	7478	1.16428757608746
IPR015424	Pyridoxal phosphate-dependent transferase	33	0.257603773551075	0.989333404834788	18	15	6729	7476	1.1510570354501
IPR015425	Formin, FH2 domain	14	0.526563311510249	1	7	7	6740	7484	1.05513561582926
IPR015433	Phosphatidylinositol kinase	 9	0.692132530392986	1	4	5	6743	7486	0.937898325181562
IPR015500	Peptidase S8, subtilisin-related	10	0.781996958992377	1	4	6	6743	7485	0.844108492663406
IPR015505	Coronin	 7	0.918536112180723	1	2	5	6745	7486	0.602934637616719
IPR015526	Frizzled/secreted frizzled-related protein	16	0.851614188512573	1	6	10	6741	7481	0.791351711871943
IPR015590	Aldehyde dehydrogenase domain	16	0.704217300302988	1	7	9	6740	7482	0.9232436638506
IPR015615	Transforming growth factor-beta-related	25	0.999794832659233	1	4	21	6743	7470	0.337643397065362
IPR015621	Interleukin-1 receptor family	 9	1	1	0	9	6747	7482	0
IPR015655	Protein phosphatase 2C family	15	0.418386639190508	1	8	7	6739	7484	1.12547799021787
IPR015720	TMP21-related	 8	0.818534364570598	1	3	5	6744	7486	0.791351711871943
IPR015797	NUDIX hydrolase domain-like	26	0.105640980737879	0.788819209943689	16	10	6731	7481	1.29862845025139
IPR015812	Integrin beta subunit	 7	0.728431267104624	1	3	4	6744	7487	0.904401956425078
IPR015847	Exoribonuclease, phosphorolytic domain 2	 7	0.185910764499323	0.845680287938012	5	2	6742	7489	1.5073365940418
IPR015894	Guanylate-binding protein, N-terminal	 8	0.578259437994666	1	4	4	6743	7487	1.05513561582926
IPR015898	G-protein gamma-like domain	12	0.0508017172795473	0.547068833017165	9	3	6738	7488	1.58270342374389
IPR015915	Kelch-type beta propeller	44	0.0219865467940135	0.400696547198938	28	16	6719	7475	1.34289987469178
IPR015916	Galactose oxidase, beta-propeller	26	0.320925305316826	0.996215854772117	14	12	6733	7479	1.13629989396997
IPR015917	Peptidase C14A, caspase catalytic domain	10	0.924480277088131	1	3	7	6744	7484	0.633081369497555
IPR015919	Cadherin-like	74	0.999898099341264	1	20	54	6727	7437	0.570343576123923
IPR015925	Ryanodine receptor-related	 6	0.296087778157783	0.996215854772117	4	2	6743	7489	1.40684748777234
IPR015940	Ubiquitin-associated domain	38	0.0170644869311355	0.400696547198938	25	13	6722	7478	1.38833633661744
IPR015947	PUA-like domain	16	0.0238513580169886	0.400696547198938	12	4	6735	7487	1.58270342374389
IPR015955	Lactate dehydrogenase/glycoside hydrolase, family 4, C-terminal	 6	0.296087778157783	0.996215854772117	4	2	6743	7489	1.40684748777234
IPR015988	STAT transcription factor, coiled coil	 7	0.185910764499323	0.845680287938012	5	2	6742	7489	1.5073365940418
IPR016017	GDNF/GAS1	 5	1	1	0	5	6747	7486	0
IPR016035	Acyl transferase/acyl hydrolase/lysophospholipase	13	0.821296993728656	1	5	8	6742	7483	0.811642781407121
IPR016039	Thiolase-like	 9	0.0666543852588519	0.639451333797848	7	2	6740	7489	1.64132206906773
IPR016050	Proteasome beta-type subunit, conserved site	10	0.5573358874939	1	5	5	6742	7486	1.05513561582926
IPR016054	Ly-6 antigen/uPA receptor-like	15	0.993490982124601	1	3	12	6744	7479	0.422054246331703
IPR016055	Alpha-D-phosphohexomutase, alpha/beta/alpha I/II/III	 5	0.451093636045012	1	3	2	6744	7489	1.26616273899511
IPR016064	NAD kinase/diacylglycerol kinase-like domain	15	0.0387245875579589	0.498382293530479	11	4	6736	7487	1.54753223654958
IPR016090	Phospholipase A2 domain	 9	0.996918035182955	1	1	8	6746	7483	0.234474581295391
IPR016093	MIR motif	 9	0.205164220540816	0.889516885075412	6	3	6741	7488	1.40684748777234
IPR016129	Peptidase family C14A, His active site	 9	0.971908527019724	1	2	7	6745	7484	0.468949162590781
IPR016130	Protein-tyrosine phosphatase, active site	65	0.00777786448035714	0.331550196952537	41	24	6706	7467	1.33109416150768
IPR016135	Ubiquitin-conjugating enzyme/RWD-like	46	0.136817810323101	0.806571393258297	26	20	6721	7471	1.19276200050264
IPR016137	RGS domain	34	0.445843929944517	1	17	17	6730	7474	1.05513561582926
IPR016152	Phosphotransferase/anion transporter	 7	0.728431267104624	1	3	4	6744	7487	0.904401956425078
IPR016156	FAD/NAD-linked reductase, dimerisation domain	 6	0.606099493932241	1	3	3	6744	7488	1.05513561582926
IPR016157	Cullin, conserved site	 7	0.00535698619579275	0.331550196952537	7	0	6740	7491	2.11027123165852
IPR016158	Cullin homology	 9	0.0132220292527637	0.348841205118748	8	1	6739	7490	1.87579665036312
IPR016159	Cullin repeat-like-containing domain	13	0.0964724174428019	0.737757665758239	9	4	6738	7487	1.46095700653282
IPR016160	Aldehyde dehydrogenase, cysteine active site	13	0.821296993728656	1	5	8	6742	7483	0.811642781407121
IPR016161	Aldehyde/histidinol dehydrogenase	16	0.704217300302988	1	7	9	6740	7482	0.9232436638506
IPR016162	Aldehyde dehydrogenase N-terminal domain	16	0.704217300302988	1	7	9	6740	7482	0.9232436638506
IPR016166	FAD-binding, type 2	 6	0.606099493932241	1	3	3	6744	7488	1.05513561582926
IPR016167	FAD-binding, type 2, subdomain 1	 5	0.7781801260834	1	2	3	6745	7488	0.844108492663406
IPR016169	CO dehydrogenase flavoprotein-like, FAD-binding, subdomain 2	 6	0.606099493932241	1	3	3	6744	7488	1.05513561582926
IPR016177	DNA-binding domain	11	0.0218793801836401	0.400696547198938	9	2	6738	7489	1.72658555317515
IPR016179	Insulin-like	 5	0.7781801260834	1	2	3	6745	7488	0.844108492663406
IPR016181	Acyl-CoA N-acyltransferase	38	0.208596975243523	0.894875370760156	21	17	6726	7474	1.16620252275865
IPR016185	Pre-ATP-grasp domain	13	0.0964724174428019	0.737757665758239	9	4	6738	7487	1.46095700653282
IPR016186	C-type lectin-like/link domain	60	0.999990404253644	1	13	47	6734	7444	0.457225433526012
IPR016187	C-type lectin fold	67	0.999993830491756	1	15	52	6732	7439	0.47244878320713
IPR016192	APOBEC/CMP deaminase, zinc-binding	 8	0.818534364570598	1	3	5	6744	7486	0.791351711871943
IPR016193	Cytidine deaminase-like	10	0.924480277088131	1	3	7	6744	7484	0.633081369497555
IPR016194	SPOC-like, C-terminal domain	 5	0.156501784621734	0.806571393258297	4	1	6743	7490	1.68821698532681
IPR016197	Chromo domain-like	28	0.463837741497859	1	14	14	6733	7477	1.05513561582926
IPR016201	PSI domain	36	0.125126227266167	0.806571393258297	21	15	6726	7476	1.2309915518008
IPR016239	Ribosomal protein S6 kinase II	 6	0.606099493932241	1	3	3	6744	7488	1.05513561582926
IPR016257	Ephrin receptor type-A /type-B	12	0.751834162472378	1	5	7	6742	7484	0.879279679857714
IPR016272	Lipase, LIPH-type	 5	0.959711673474999	1	1	4	6746	7487	0.422054246331703
IPR016332	Alpha-1B-glycoprotein/leukocyte immunoglobulin-like receptor	 6	1	1	0	6	6747	7485	0
IPR016346	Guanine nucleotide-binding protein, beta subunit	 5	0.7781801260834	1	2	3	6745	7488	0.844108492663406
IPR016439	Ceramide synthase component Lag1/Lac1	 6	0.86422044215898	1	2	4	6745	7487	0.703423743886172
IPR016449	Potassium channel, inwardly rectifying, Kir	14	0.526563311510249	1	7	7	6740	7484	1.05513561582926
IPR016469	Carbohydrate sulfotransferase	 5	0.959711673474999	1	1	4	6746	7487	0.422054246331703
IPR016491	Septin	11	0.218609653443	0.910681793158603	7	4	6740	7487	1.34289987469178
IPR016635	Adaptor protein complex, sigma subunit	 5	0.451093636045012	1	3	2	6744	7489	1.26616273899511
IPR017096	BTB-kelch protein	33	0.15891051591846	0.806571393258297	19	14	6728	7477	1.21500464853066
IPR017448	SRCR-like domain	22	0.999999279486306	1	1	21	6746	7470	0.0959214196208416
IPR017455	Zinc finger, FYVE-related	32	0.00436391932941564	0.331550196952537	23	9	6724	7482	1.51675744775456
IPR017849	Alkaline phosphatase-like, alpha/beta/alpha	28	0.747586302770199	1	12	16	6735	7475	0.904401956425078
IPR017850	Alkaline-phosphatase-like, core domain	29	0.676804805102135	1	13	16	6734	7475	0.945983655571058
IPR017853	Glycoside hydrolase superfamily	40	0.980788523316526	1	13	27	6734	7464	0.685838150289017
IPR017854	Metallothionein domain	 7	0.918536112180723	1	2	5	6745	7486	0.602934637616719
IPR017855	SMAD domain-like	15	0.912946663336211	1	5	10	6742	7481	0.703423743886172
IPR017857	Coagulation factor, subgroup, Gla domain	11	0.952585381968349	1	3	8	6744	7483	0.57552851772505
IPR017868	Filamin/ABP280 repeat-like	11	0.849533330740884	1	4	7	6743	7484	0.767371356966733
IPR017871	ABC transporter, conserved site	38	0.208596975243523	0.894875370760156	21	17	6726	7474	1.16620252275865
IPR017877	Myb-like domain	 8	0.307721488076794	0.996215854772117	5	3	6742	7488	1.31891951978657
IPR017878	TB domain	 7	0.988855554331116	1	1	6	6746	7485	0.301467318808359
IPR017884	SANT domain	25	0.553727479428808	1	12	13	6735	7478	1.01293019119609
IPR017891	Insulin-like growth factor binding protein, N-terminal, Cys-rich conserved site	10	1	1	0	10	6747	7481	0
IPR017892	Protein kinase, C-terminal	30	0.457483642404989	1	15	15	6732	7476	1.05513561582926
IPR017897	Thrombospondin, type 3 repeat	 5	1	1	0	5	6747	7486	0
IPR017901	C-CAP/cofactor C-like domain	 5	0.451093636045012	1	3	2	6744	7489	1.26616273899511
IPR017903	COS domain	 9	0.205164220540816	0.889516885075412	6	3	6741	7488	1.40684748777234
IPR017920	COMM domain	10	0.314500257499634	0.996215854772117	6	4	6741	7487	1.26616273899511
IPR017923	Transcription factor IIS, N-terminal	 7	0.0470279971954641	0.527980989790211	6	1	6741	7490	1.80880391285016
IPR017926	Glutamine amidotransferase	 6	0.606099493932241	1	3	3	6744	7488	1.05513561582926
IPR017927	Ferredoxin reductase-type FAD-binding domain	16	0.851614188512573	1	6	10	6741	7481	0.791351711871943
IPR017930	Myb domain	 8	0.578259437994666	1	4	4	6743	7487	1.05513561582926
IPR017937	Thioredoxin, conserved site	14	0.526563311510249	1	7	7	6740	7484	1.05513561582926
IPR017938	Riboflavin synthase-like beta-barrel	16	0.851614188512573	1	6	10	6741	7481	0.791351711871943
IPR017942	Lipid-binding serum glycoprotein, N-terminal	 9	0.996918035182955	1	1	8	6746	7483	0.234474581295391
IPR017943	Bactericidal permeability-increasing protein, alpha/beta domain	 9	0.996918035182955	1	1	8	6746	7483	0.234474581295391
IPR017946	PLC-like phosphodiesterase, TIM beta/alpha-barrel domain	22	0.984157354545405	1	6	16	6741	7475	0.57552851772505
IPR017948	Transforming growth factor beta, conserved site	25	0.999794832659233	1	4	21	6743	7470	0.337643397065362
IPR017956	AT hook, DNA-binding motif	 5	0.7781801260834	1	2	3	6745	7488	0.844108492663406
IPR017957	P-type trefoil, conserved site	 5	0.959711673474999	1	1	4	6746	7487	0.422054246331703
IPR017972	Cytochrome P450, conserved site	32	0.952168301580737	1	11	21	6736	7470	0.725405735882614
IPR017974	Claudin, conserved site	13	0.999764475660496	1	1	12	6746	7479	0.162328556281424
IPR017975	Tubulin, conserved site	16	0.168402871096864	0.838307374045079	10	6	6737	7485	1.31891951978657
IPR017977	Zona pellucida domain, conserved site	 6	0.86422044215898	1	2	4	6745	7487	0.703423743886172
IPR017978	GPCR family 3, C-terminal	17	0.774081062321046	1	7	10	6740	7481	0.868935213035859
IPR017979	GPCR, family 3, conserved site	10	0.781996958992377	1	4	6	6743	7485	0.844108492663406
IPR017981	GPCR, family 2-like	42	0.953821626720694	1	15	27	6732	7464	0.753668297020898
IPR017983	GPCR, family 2, secretin-like, conserved site	23	0.989551167093213	1	6	17	6741	7474	0.550505538693526
IPR017984	Chromo domain subgroup	 8	0.307721488076794	0.996215854772117	5	3	6742	7488	1.31891951978657
IPR017990	Connexin, conserved site	15	0.971750526562492	1	4	11	6743	7480	0.562738995108937
IPR017998	Chaperone tailless complex polypeptide 1 (TCP-1)	10	0.0385318949833867	0.498382293530479	8	2	6739	7489	1.68821698532681
IPR018000	Neurotransmitter-gated ion-channel, conserved site	27	0.952749714801846	1	9	18	6738	7473	0.703423743886172
IPR018011	Carbohydrate sulfotransferase 8-10	 6	0.296087778157783	0.996215854772117	4	2	6743	7489	1.40684748777234
IPR018039	Intermediate filament protein, conserved site	40	0.999921538961261	1	8	32	6739	7459	0.422054246331703
IPR018045	Sulphate anion transporter, conserved site	 6	0.606099493932241	1	3	3	6744	7488	1.05513561582926
IPR018048	CXC chemokine, conserved site	 9	0.971908527019724	1	2	7	6745	7484	0.468949162590781
IPR018056	Kringle, conserved site	12	0.898382914875138	1	4	8	6743	7483	0.703423743886172
IPR018064	Metallothionein, vertebrate, metal binding site	 7	0.918536112180723	1	2	5	6745	7486	0.602934637616719
IPR018073	Proteinase inhibitor I25, cystatin, conserved site	 8	1	1	0	8	6747	7483	0
IPR018097	EGF-like calcium-binding, conserved site	81	0.961409072903368	1	31	50	6716	7441	0.807634668906345
IPR018107	Sodium:dicarboxylate symporter, conserved site	 7	0.185910764499323	0.845680287938012	5	2	6742	7489	1.5073365940418
IPR018108	Mitochondrial substrate/solute carrier	45	0.257399583904716	0.989333404834788	24	21	6723	7470	1.12547799021787
IPR018114	Serine proteases, trypsin family, histidine active site	62	0.999999999998152	1	5	57	6742	7434	0.170183163843429
IPR018122	Fork head domain conserved site1	21	0.992945773587864	1	5	16	6742	7475	0.502445531347265
IPR018123	WWE domain, subgroup	 5	0.7781801260834	1	2	3	6745	7488	0.844108492663406
IPR018143	Folate receptor-like	 6	0.86422044215898	1	2	4	6745	7487	0.703423743886172
IPR018159	Spectrin/alpha-actinin	26	0.195767782789117	0.877904816303602	15	11	6732	7480	1.21746417211068
IPR018161	Wnt protein, conserved site	15	0.999053970109399	1	2	13	6745	7478	0.281369497554469
IPR018163	Threonyl/alanyl tRNA synthetase, class II-like, putative editing domain	 6	0.296087778157783	0.996215854772117	4	2	6743	7489	1.40684748777234
IPR018170	Aldo/keto reductase, conserved site	 7	0.988855554331116	1	1	6	6746	7485	0.301467318808359
IPR018181	Heat shock protein 70, conserved site	12	0.540572112776641	1	6	6	6741	7485	1.05513561582926
IPR018184	Integrin alpha chain, C-terminal cytoplasmic region, conserved site	11	0.849533330740884	1	4	7	6743	7484	0.767371356966733
IPR018186	Transcription factor, T-box, conserved site	14	0.989142891012179	1	3	11	6744	7480	0.452200978212539
IPR018200	Ubiquitin specific protease, conserved site	44	0.00163683416804997	0.185079177715936	31	13	6716	7478	1.48678200412304
IPR018212	Sodium/solute symporter, conserved site	 6	0.978809919738203	1	1	5	6746	7486	0.351711871943086
IPR018222	Nuclear transport factor 2, eukaryote	 5	0.7781801260834	1	2	3	6745	7488	0.844108492663406
IPR018240	Clathrin adaptor, mu subunit, conserved site	 6	0.296087778157783	0.996215854772117	4	2	6743	7489	1.40684748777234
IPR018244	Allergen V5/Tpx-1-related, conserved site	 5	1	1	0	5	6747	7486	0
IPR018252	Annexin repeat, conserved site	11	0.849533330740884	1	4	7	6743	7484	0.767371356966733
IPR018253	DnaJ domain, conserved site	23	0.841941593690198	1	9	14	6738	7477	0.825758308040288
IPR018297	Adenylyl cyclase class-4/guanylyl cyclase, conserved site	15	0.971750526562492	1	4	11	6743	7480	0.562738995108937
IPR018303	P-type ATPase, phosphorylation site	34	0.122001332868948	0.806571393258297	20	14	6727	7477	1.24133601862266
IPR018316	Tubulin/FtsZ, 2-layer sandwich domain	15	0.235719255914089	0.951896893142864	9	6	6738	7485	1.26616273899511
IPR018338	Carbonic anhydrase, alpha-class, conserved site	10	0.983765589502622	1	2	8	6745	7483	0.422054246331703
IPR018358	Disintegrin, conserved site	11	0.663808308432488	1	5	6	6742	7485	0.959214196208416
IPR018359	Bromodomain, conserved site	24	0.00148411188121338	0.180719162150829	19	5	6728	7486	1.67063139172966
IPR018376	Enoyl-CoA hydratase/isomerase, conserved site	 8	0.578259437994666	1	4	4	6743	7487	1.05513561582926
IPR018378	C-type lectin, conserved site	25	0.99891534826843	1	5	20	6742	7471	0.422054246331703
IPR018379	BEN domain	 8	0.818534364570598	1	3	5	6744	7486	0.791351711871943
IPR018392	LysM domain	 6	0.296087778157783	0.996215854772117	4	2	6743	7489	1.40684748777234
IPR018422	Cation/H+ exchanger, CPA1 family	 8	0.818534364570598	1	3	5	6744	7486	0.791351711871943
IPR018459	RII binding domain	 5	0.451093636045012	1	3	2	6744	7489	1.26616273899511
IPR018486	Hemopexin, conserved site	10	0.983765589502622	1	2	8	6745	7483	0.422054246331703
IPR018487	Hemopexin-like repeats	14	0.989142891012179	1	3	11	6744	7480	0.452200978212539
IPR018488	Cyclic nucleotide-binding, conserved site	15	0.971750526562492	1	4	11	6743	7480	0.562738995108937
IPR018490	Cyclic nucleotide-binding-like	34	0.709221925770198	1	15	19	6732	7472	0.931002013966992
IPR018491	SLC12A transporter, C-terminal	 7	0.728431267104624	1	3	4	6744	7487	0.904401956425078
IPR018494	Oxysterol-binding protein, conserved site	12	0.0508017172795473	0.547068833017165	9	3	6738	7488	1.58270342374389
IPR018497	Peptidase M13, C-terminal domain	 5	1	1	0	5	6747	7486	0
IPR018499	Tetraspanin/Peripherin	31	0.996007054552106	1	8	23	6739	7468	0.544586124298972
IPR018502	Annexin repeat	11	0.849533330740884	1	4	7	6743	7484	0.767371356966733
IPR018503	Tetraspanin, conserved site	20	0.964745817786683	1	6	14	6741	7477	0.633081369497555
IPR018506	Cytochrome b5, heme-binding site	 5	0.156501784621734	0.806571393258297	4	1	6743	7490	1.68821698532681
IPR018525	Mini-chromosome maintenance, conserved site	 6	0.86422044215898	1	2	4	6745	7487	0.703423743886172
IPR018629	XK-related protein	 5	0.959711673474999	1	1	4	6746	7487	0.422054246331703
IPR018933	Netrin module, non-TIMP type	15	0.993490982124601	1	3	12	6744	7479	0.422054246331703
IPR018936	Phosphatidylinositol 3/4-kinase, conserved site	14	0.158970483067965	0.806571393258297	9	5	6738	7486	1.35660293463762
IPR018955	Branched-chain alpha-ketoacid dehydrogenase kinase/Pyruvate dehydrogenase kinase, N-terminal	 5	0.451093636045012	1	3	2	6744	7489	1.26616273899511
IPR018957	Zinc finger, C3HC4 RING-type	25	0.143771550836479	0.806571393258297	15	10	6732	7481	1.26616273899511
IPR018979	FERM, N-terminal	26	0.00710668887117026	0.331550196952537	19	7	6728	7484	1.54212128467353
IPR018980	FERM, C-terminal PH-like domain	24	0.0173974348673038	0.400696547198938	17	7	6730	7484	1.49477545575811
IPR018997	PUB domain	 5	0.959711673474999	1	1	4	6746	7487	0.422054246331703
IPR019018	Rab-binding domain FIP-RBD	 6	0.0867087878537095	0.700306179451134	5	1	6742	7490	1.75855935971543
IPR019402	Frag1/DRAM/Sfk1	 5	0.959711673474999	1	1	4	6746	7487	0.422054246331703
IPR019410	Lysine methyltransferase	 8	0.578259437994666	1	4	4	6743	7487	1.05513561582926
IPR019471	Interferon regulatory factor-3	 6	1	1	0	6	6747	7485	0
IPR019479	Peroxiredoxin, C-terminal	 5	0.451093636045012	1	3	2	6744	7489	1.26616273899511
IPR019542	Enhancer of polycomb-like, N-terminal	 8	0.11282433035284	0.800900963894823	6	2	6741	7489	1.58270342374389
IPR019558	Mammalian uncoordinated homology 13, subgroup, domain 2	 5	0.451093636045012	1	3	2	6744	7489	1.26616273899511
IPR019559	Cullin protein, neddylation domain	 8	0.0250958861430055	0.400696547198938	7	1	6740	7490	1.8464873277012
IPR019565	Alpha-2-macroglobulin, thiol-ester bond-forming	 6	0.978809919738203	1	1	5	6746	7486	0.351711871943086
IPR019570	Gap junction protein, cysteine-rich domain	15	0.971750526562492	1	4	11	6743	7480	0.562738995108937
IPR019577	SPARC/Testican, calcium-binding domain	 7	0.44299046303573	1	4	3	6743	7488	1.20586927523344
IPR019594	Ionotropic glutamate receptor, L-glutamate and glycine-binding domain	15	0.796340355433979	1	6	9	6741	7482	0.844108492663406
IPR019742	Alpha-2-macroglobulin, conserved site	 6	0.978809919738203	1	1	5	6746	7486	0.351711871943086
IPR019747	FERM conserved site	23	0.00904576258659652	0.331550196952537	17	6	6730	7485	1.55976569296499
IPR019748	FERM central domain	45	0.032257105562757	0.455919625945039	28	17	6719	7474	1.31305765525419
IPR019749	Band 4.1 domain	46	0.0235649509022819	0.400696547198938	29	17	6718	7474	1.33038838517602
IPR019762	Dynamin, GTPase region, conserved site	 5	0.451093636045012	1	3	2	6744	7489	1.26616273899511
IPR019765	Ephrin, conserved site	 8	0.951870028050764	1	2	6	6745	7485	0.527567807914629
IPR019786	Zinc finger, PHD-type, conserved site	64	0.00107215076861495	0.169008569285149	43	21	6704	7470	1.41783848377056
IPR019787	Zinc finger, PHD-finger	74	0.000352101394199045	0.145440073294157	50	24	6697	7467	1.42585894030981
IPR019791	Haem peroxidase, animal	 8	0.951870028050764	1	2	6	6745	7485	0.527567807914629
IPR019803	Glypican, conserved site	 6	0.86422044215898	1	2	4	6745	7487	0.703423743886172
IPR019804	Ras guanine-nucleotide exchange factor, conserved site	12	0.540572112776641	1	6	6	6741	7485	1.05513561582926
IPR019807	Hexokinase, binding site	 5	0.959711673474999	1	1	4	6746	7487	0.422054246331703
IPR019808	Histidine triad, conserved site	 5	0.451093636045012	1	3	2	6744	7489	1.26616273899511
IPR019817	Interferon regulatory factor, conserved site	 8	0.994139200942595	1	1	7	6746	7484	0.263783903957314
IPR019818	Isocitrate/isopropylmalate dehydrogenase, conserved site	 5	0.156501784621734	0.806571393258297	4	1	6743	7490	1.68821698532681
IPR019819	Carboxylesterase type B, conserved site	11	0.429568982367594	1	6	5	6741	7486	1.1510570354501
IPR019821	Kinesin motor domain, conserved site	29	0.256206834784657	0.989333404834788	16	13	6731	7478	1.16428757608746
IPR019826	Carboxylesterase type B, active site	 6	0.0867087878537095	0.700306179451134	5	1	6742	7490	1.75855935971543
IPR019828	Lysyl oxidase, conserved site	 5	0.959711673474999	1	1	4	6746	7487	0.422054246331703
IPR019844	Cold-shock conserved site	 5	0.7781801260834	1	2	3	6745	7488	0.844108492663406
IPR019954	Ubiquitin conserved site	 8	0.11282433035284	0.800900963894823	6	2	6741	7489	1.58270342374389
IPR019956	Ubiquitin	 8	0.307721488076794	0.996215854772117	5	3	6742	7488	1.31891951978657
IPR020003	ATPase, alpha/beta subunit, nucleotide-binding domain, active site	 5	0.156501784621734	0.806571393258297	4	1	6743	7490	1.68821698532681
IPR020067	Frizzled domain	18	0.925417639802123	1	6	12	6741	7479	0.703423743886172
IPR020084	NUDIX hydrolase, conserved site	12	0.318565851958547	0.996215854772117	7	5	6740	7486	1.2309915518008
IPR020103	Pseudouridine synthase, catalytic domain	13	0.821296993728656	1	5	8	6742	7483	0.811642781407121
IPR020417	Atypical dual specificity phosphatase	11	0.849533330740884	1	4	7	6743	7484	0.767371356966733
IPR020422	Dual specificity protein phosphatase domain	32	0.451501381964712	1	16	16	6731	7475	1.05513561582926
IPR020454	Diacylglycerol/phorbol-ester binding	25	0.0305894811629588	0.436244582711385	17	8	6730	7483	1.43498443752779
IPR020471	Aldo/keto reductase	 7	0.988855554331116	1	1	6	6746	7485	0.301467318808359
IPR020472	G-protein beta WD-40 repeat	80	0.000499645476432355	0.145440073294157	53	27	6694	7464	1.39805469097377
IPR020479	Homeobox domain, metazoa	45	0.999999999988967	1	2	43	6745	7448	0.0937898325181562
IPR020550	Inositol monophosphatase, conserved site	 5	0.7781801260834	1	2	3	6745	7488	0.844108492663406
IPR020568	Ribosomal protein S5 domain 2-type fold	32	0.0119979435804475	0.339889572335004	22	10	6725	7481	1.45081147176523
IPR020588	DNA recombination and repair protein RecA-like, ATP-binding domain	 5	0.156501784621734	0.806571393258297	4	1	6743	7490	1.68821698532681
IPR020590	Guanylate kinase, conserved site	15	0.235719255914089	0.951896893142864	9	6	6738	7485	1.26616273899511
IPR020613	Thiolase, conserved site	 5	0.156501784621734	0.806571393258297	4	1	6743	7490	1.68821698532681
IPR020616	Thiolase, N-terminal	 5	0.156501784621734	0.806571393258297	4	1	6743	7490	1.68821698532681
IPR020617	Thiolase, C-terminal	 5	0.156501784621734	0.806571393258297	4	1	6743	7490	1.68821698532681
IPR020635	Tyrosine-protein kinase, catalytic domain	74	0.977926918254652	1	27	47	6720	7444	0.769963827767296
IPR020636	Calcium/calmodulin-dependent/calcium-dependent protein kinase	27	0.0762904761225086	0.700306179451134	17	10	6730	7481	1.32868929400721
IPR020717	Apoptosis regulator, Bcl-2, BH1 motif, conserved site	 8	0.578259437994666	1	4	4	6743	7487	1.05513561582926
IPR020726	Apoptosis regulator, Bcl-2, BH2 motif, conserved site	 8	0.578259437994666	1	4	4	6743	7487	1.05513561582926
IPR020728	Apoptosis regulator, Bcl-2, BH3 motif, conserved site	 8	0.307721488076794	0.996215854772117	5	3	6742	7488	1.31891951978657
IPR020821	Extracellular Endonuclease, subunit A	 5	0.156501784621734	0.806571393258297	4	1	6743	7490	1.68821698532681
IPR020833	Lipoxygenase, iron binding site	 5	0.959711673474999	1	1	4	6746	7487	0.422054246331703
IPR020834	Lipoxygenase, conserved site	 5	0.959711673474999	1	1	4	6746	7487	0.422054246331703
IPR020837	Fibrinogen, conserved site	14	0.999876186220681	1	1	13	6746	7478	0.15073365940418
IPR020843	Polyketide synthase, enoylreductase domain	14	0.0617512698732667	0.62262586120625	10	4	6737	7487	1.5073365940418
IPR020845	AMP-binding, conserved site	19	0.408621506536301	1	10	9	6737	7482	1.11066906929396
IPR020849	Small GTPase superfamily, Ras type	33	0.771523921174409	1	14	19	6733	7472	0.895266583127855
IPR020850	GTPase effector domain	 6	0.296087778157783	0.996215854772117	4	2	6743	7489	1.40684748777234
IPR020863	Membrane attack complex component/perforin domain, conserved site	 5	0.959711673474999	1	1	4	6746	7487	0.422054246331703
IPR020864	Membrane attack complex component/perforin (MACPF) domain	11	0.990694524510238	1	2	9	6745	7482	0.383685678483366
IPR020892	Cyclophilin-type peptidyl-prolyl cis-trans isomerase, conserved site	14	0.0180045716960344	0.400696547198938	11	3	6736	7488	1.65807025344598
IPR020894	Cadherin conserved site	67	0.999823812004765	1	18	49	6729	7442	0.566938539848556
IPR020901	Proteinase inhibitor I2, Kunitz, conserved site	12	0.898382914875138	1	4	8	6743	7483	0.703423743886172
IPR020902	Actin/actin-like conserved site	11	0.218609653443	0.910681793158603	7	4	6740	7487	1.34289987469178
IPR020903	Epithelial sodium channel, conserved site	 7	0.728431267104624	1	3	4	6744	7487	0.904401956425078
IPR020904	Short-chain dehydrogenase/reductase, conserved site	28	0.613030438975792	1	13	15	6734	7476	0.979768786127168
IPR021040	LRRC8, pannexin-like TM region	 5	0.156501784621734	0.806571393258297	4	1	6743	7490	1.68821698532681
IPR021109	Aspartic peptidase domain	 9	0.692132530392986	1	4	5	6743	7486	0.937898325181562
IPR021133	HEAT, type 2	17	0.0463935769314538	0.527980989790211	12	5	6735	7486	1.48960322234719
IPR021156	Transcription elongation factor A-like/Brain expressed X-linked	11	0.0218793801836401	0.400696547198938	9	2	6738	7489	1.72658555317515
IPR021158	Peptidase M10A, cysteine switch, zinc binding site	 9	0.971908527019724	1	2	7	6745	7484	0.468949162590781
IPR021184	Tumour necrosis factor, conserved site	 8	0.994139200942595	1	1	7	6746	7484	0.263783903957314
IPR021190	Peptidase M10A	15	0.993490982124601	1	3	12	6744	7479	0.422054246331703
IPR021816	Dedicator of cytokinesis C/D, N-terminal	 6	0.606099493932241	1	3	3	6744	7488	1.05513561582926
IPR021852	Domain of unknown function DUF3456	 5	0.7781801260834	1	2	3	6745	7488	0.844108492663406
IPR021869	Ribonuclease Zc3h12a-like, NYN domain	 6	0.86422044215898	1	2	4	6745	7487	0.703423743886172
IPR021893	Protein of unknown function DUF3504	 5	0.451093636045012	1	3	2	6744	7489	1.26616273899511
IPR022049	FAM69, protein-kinase domain	 6	0.606099493932241	1	3	3	6744	7488	1.05513561582926
IPR022097	Transcription factor SOX	 5	0.959711673474999	1	1	4	6746	7487	0.422054246331703
IPR022137	Protein of unknown function DUF3669, zinc finger protein	 6	0.606099493932241	1	3	3	6744	7488	1.05513561582926
IPR022164	Kinesin-like	 6	0.0113099877671744	0.331550196952537	6	0	6741	7491	2.11027123165852
IPR022168	Domain of unknown function DUF3699	 6	0.86422044215898	1	2	4	6745	7487	0.703423743886172
IPR022272	Lipocalin family conserved site	 7	0.918536112180723	1	2	5	6745	7486	0.602934637616719
IPR022321	Insulin-like growth factor-binding protein family 1-6, chordata	 6	1	1	0	6	6747	7485	0
IPR022353	Insulin, conserved site	 5	0.7781801260834	1	2	3	6745	7488	0.844108492663406
IPR022357	Major intrinsic protein, conserved site	 8	1	1	0	8	6747	7483	0
IPR022383	Lactate/malate dehydrogenase, C-terminal	 5	0.156501784621734	0.806571393258297	4	1	6743	7490	1.68821698532681
IPR022398	Peptidase S8, subtilisin, His-active site	 9	0.692132530392986	1	4	5	6743	7486	0.937898325181562
IPR022408	Acyl-CoA-binding protein, ACBP, conserved site	 5	0.7781801260834	1	2	3	6745	7488	0.844108492663406
IPR022409	PKD/Chitinase domain	 7	0.44299046303573	1	4	3	6743	7488	1.20586927523344
IPR022613	Calmodulin-regulated spectrin-associated protein, CH domain	 5	0.7781801260834	1	2	3	6745	7488	0.844108492663406
IPR022617	Rad60/SUMO-like domain	 5	0.451093636045012	1	3	2	6744	7489	1.26616273899511
IPR022672	Hexokinase, N-terminal	 5	0.959711673474999	1	1	4	6746	7487	0.422054246331703
IPR022673	Hexokinase, C-terminal	 5	0.959711673474999	1	1	4	6746	7487	0.422054246331703
IPR022682	Peptidase C2, calpain, large subunit, domain III	 8	0.578259437994666	1	4	4	6743	7487	1.05513561582926
IPR022683	Peptidase C2, calpain, domain III	 7	0.728431267104624	1	3	4	6744	7487	0.904401956425078
IPR022684	Peptidase C2, calpain family	 9	0.692132530392986	1	4	5	6743	7486	0.937898325181562
IPR022735	Domain of unknown function DUF3585	 7	0.0470279971954641	0.527980989790211	6	1	6741	7490	1.80880391285016
IPR022742	Serine aminopeptidase, S33	 7	0.728431267104624	1	3	4	6744	7487	0.904401956425078
IPR022755	Zinc finger, double-stranded RNA binding	13	0.640693632462334	1	6	7	6741	7484	0.973971337688545
IPR022764	Peptidase S54, rhomboid domain	 9	0.692132530392986	1	4	5	6743	7486	0.937898325181562
IPR022775	AP complex, mu/sigma subunit	14	0.320964034776418	0.996215854772117	8	6	6739	7485	1.20586927523344
IPR022812	Dynamin superfamily	13	0.228396290943016	0.934241159076989	8	5	6739	7486	1.29862845025139
IPR022967	RNA-binding domain, S1	 9	0.435918072496767	1	5	4	6742	7487	1.17237290647695
IPR023088	3'5'-cyclic nucleotide phosphodiesterase	18	0.322822594532801	0.996215854772117	10	8	6737	7483	1.17237290647695
IPR023152	Ras GTPase-activating protein, conserved site	11	0.218609653443	0.910681793158603	7	4	6740	7487	1.34289987469178
IPR023174	3'5'-cyclic nucleotide phosphodiesterase, conserved site	20	0.322841903662727	0.996215854772117	11	9	6736	7482	1.16064917741218
IPR023210	NADP-dependent oxidoreductase domain	12	0.898382914875138	1	4	8	6743	7483	0.703423743886172
IPR023214	HAD-like domain	73	0.124456974336586	0.806571393258297	40	33	6707	7458	1.1563130036485
IPR023267	RNA (C5-cytosine) methyltransferase	 5	0.156501784621734	0.806571393258297	4	1	6743	7490	1.68821698532681
IPR023271	Aquaporin-like	10	0.998379418036325	1	1	9	6746	7482	0.211027123165852
IPR023298	P-type ATPase,  transmembrane domain	15	0.621217899790023	1	7	8	6740	7483	0.98479324144064
IPR023299	P-type ATPase, cytoplasmic domain N	34	0.122001332868948	0.806571393258297	20	14	6727	7477	1.24133601862266
IPR023313	Ubiquitin-conjugating enzyme, active site	23	0.39985901184056	1	12	11	6735	7480	1.10101107738705
IPR023332	Proteasome alpha-type subunit	 5	0.7781801260834	1	2	3	6745	7488	0.844108492663406
IPR023333	Proteasome B-type subunit	 9	0.435918072496767	1	5	4	6742	7487	1.17237290647695
IPR023340	UMA domain	 5	0.7781801260834	1	2	3	6745	7488	0.844108492663406
IPR023341	MABP domain	 5	0.451093636045012	1	3	2	6744	7489	1.26616273899511
IPR023346	Lysozyme-like domain	 5	1	1	0	5	6747	7486	0
IPR023352	Membrane associated eicosanoid/glutathione metabolism-like domain	 7	0.988855554331116	1	1	6	6746	7485	0.301467318808359
IPR023362	PH-BEACH domain	 8	0.307721488076794	0.996215854772117	5	3	6742	7488	1.31891951978657
IPR023393	START-like domain	20	0.182408576511681	0.845680287938012	12	8	6735	7483	1.26616273899511
IPR023394	Sec7 domain, alpha orthogonal bundle	15	0.235719255914089	0.951896893142864	9	6	6738	7485	1.26616273899511
IPR023395	Mitochondrial carrier domain	45	0.257399583904716	0.989333404834788	24	21	6723	7470	1.12547799021787
IPR023409	14-3-3 protein, conserved site	 7	0.185910764499323	0.845680287938012	5	2	6742	7489	1.5073365940418
IPR023410	14-3-3 domain	 7	0.185910764499323	0.845680287938012	5	2	6742	7489	1.5073365940418
IPR023411	Ribonuclease A, active site	 5	0.7781801260834	1	2	3	6745	7488	0.844108492663406
IPR023412	Ribonuclease A-domain	 5	0.7781801260834	1	2	3	6745	7488	0.844108492663406
IPR023415	Low-density lipoprotein (LDL) receptor class A, conserved site	33	0.653081757802243	1	15	18	6732	7473	0.959214196208416
IPR023561	Carbonic anhydrase, alpha-class	13	0.821296993728656	1	5	8	6742	7483	0.811642781407121
IPR023566	Peptidyl-prolyl cis-trans isomerase, FKBP-type	16	0.851614188512573	1	6	10	6741	7481	0.791351711871943
IPR023578	Ras guanine nucleotide exchange factor domain	27	0.811579669872116	1	11	16	6736	7475	0.859740131416432
IPR023581	Platelet-derived growth factor, conserved site	 6	0.86422044215898	1	2	4	6745	7487	0.703423743886172
IPR023587	Metallothionein domain, vertebrate	 7	0.918536112180723	1	2	5	6745	7486	0.602934637616719
IPR023608	Protein-glutamine gamma-glutamyltransferase, eukaryota	 7	0.988855554331116	1	1	6	6746	7485	0.301467318808359
IPR023610	Phosphatidylinositol-4-phosphate 5-kinase	 7	0.728431267104624	1	3	4	6744	7487	0.904401956425078
IPR023753	FAD/NAD(P)-binding domain	51	0.0670555410047017	0.639451333797848	30	21	6717	7470	1.24133601862266
IPR023779	Chromo domain, conserved site	16	0.168402871096864	0.838307374045079	10	6	6737	7485	1.31891951978657
IPR023780	Chromo domain	22	0.187666313620401	0.851219984129211	13	9	6734	7482	1.24697845507094
IPR023795	Serpin, conserved site	20	0.999546086947303	1	3	17	6744	7474	0.316540684748777
IPR023796	Serpin domain	22	0.999849221111008	1	3	19	6744	7472	0.287764258862525
IPR023801	Histone deacetylase domain	11	0.663808308432488	1	5	6	6742	7485	0.959214196208416
IPR023827	Peptidase S8, subtilisin,  Asp-active site	 6	0.978809919738203	1	1	5	6746	7486	0.351711871943086
IPR023828	Peptidase S8, subtilisin, Ser-active site	 9	0.692132530392986	1	4	5	6743	7486	0.937898325181562
IPR024066	RGS, subdomain 1	20	0.91014755755552	1	7	13	6740	7478	0.73859493108048
IPR024079	Metallopeptidase, catalytic domain	55	0.934620646321676	1	21	34	6726	7457	0.805739924815069
IPR024084	Isopropylmalate dehydrogenase-like domain	 5	0.156501784621734	0.806571393258297	4	1	6743	7490	1.68821698532681
IPR024096	NO signalling/Golgi transport  ligand-binding domain	 6	0.0867087878537095	0.700306179451134	5	1	6742	7490	1.75855935971543
IPR024156	Small GTPase superfamily, ARF type	21	0.576463182978234	1	10	11	6737	7480	1.00489106269453
IPR024317	Dynein heavy chain, P-loop containing D4 domain	 9	0.205164220540816	0.889516885075412	6	3	6741	7488	1.40684748777234
IPR024395	CLASP N-terminal domain	 5	0.0238764544482636	0.400696547198938	5	0	6742	7491	2.11027123165852
IPR024571	ERAP1-like C-terminal domain	 7	0.918536112180723	1	2	5	6745	7486	0.602934637616719
IPR024583	Voltage-gated Na+ ion channel, cytoplasmic domain	 6	0.86422044215898	1	2	4	6745	7487	0.703423743886172
IPR024607	Sulfatase, conserved site	14	0.989142891012179	1	3	11	6744	7480	0.452200978212539
IPR024610	Inhibitor of growth protein, N-terminal histone-binding	 5	0.7781801260834	1	2	3	6745	7488	0.844108492663406
IPR024678	Serine/threonine-protein kinase OSR1/WNK, CCT domain	 6	0.0867087878537095	0.700306179451134	5	1	6742	7490	1.75855935971543
IPR024704	Structural maintenance of chromosomes protein	 5	0.451093636045012	1	3	2	6744	7489	1.26616273899511
IPR024731	EGF domain	10	0.924480277088131	1	3	7	6744	7484	0.633081369497555
IPR024743	Dynein heavy chain, coiled coil stalk	10	0.132273529234937	0.806571393258297	7	3	6740	7488	1.47718986216096
IPR024810	Mab-21 domain	 9	0.881735281659405	1	3	6	6744	7485	0.703423743886172
IPR024874	Transcription factor Maf family	 6	0.86422044215898	1	2	4	6745	7487	0.703423743886172
IPR024931	Importin subunit alpha	 5	0.7781801260834	1	2	3	6745	7488	0.844108492663406
IPR024936	Cyclophilin-type peptidyl-prolyl cis-trans isomerase	16	0.0714456925480936	0.66528547825666	11	5	6736	7486	1.45081147176523
IPR024950	Dual specificity phosphatase	28	0.613030438975792	1	13	15	6734	7476	0.979768786127168
IPR024964	CTLH/CRA C-terminal to LisH motif domain	 6	0.0867087878537095	0.700306179451134	5	1	6742	7490	1.75855935971543
IPR024977	Anaphase-promoting complex subunit 4, WD40 domain	22	0.0403236689473323	0.506606094790691	15	7	6732	7484	1.43882129431262
IPR025110	AMP-binding enzyme C-terminal domain	13	0.821296993728656	1	5	8	6742	7483	0.811642781407121
IPR025202	Phospholipase D-like domain	 5	0.451093636045012	1	3	2	6744	7489	1.26616273899511
IPR025398	Domain of unknown function DUF4371	 5	0.959711673474999	1	1	4	6746	7487	0.422054246331703
IPR025659	Tubby C-terminal-like domain	 6	0.606099493932241	1	3	3	6744	7488	1.05513561582926
IPR025660	Cysteine peptidase, histidine active site	11	0.990694524510238	1	2	9	6745	7482	0.383685678483366
IPR025661	Cysteine peptidase, asparagine active site	10	0.983765589502622	1	2	8	6745	7483	0.422054246331703
IPR025714	Methyltransferase domain	 5	0.451093636045012	1	3	2	6744	7489	1.26616273899511
IPR025799	Protein arginine N-methyltransferase	 9	0.205164220540816	0.889516885075412	6	3	6741	7488	1.40684748777234
IPR025875	Leucine rich repeat 4	13	0.0964724174428019	0.737757665758239	9	4	6738	7487	1.46095700653282
IPR025995	RNA binding activity-knot of a chromodomain	 6	0.978809919738203	1	1	5	6746	7486	0.351711871943086
IPR026075	Small proline-rich protein/late cornified envelope protein	 8	1	1	0	8	6747	7483	0
IPR026082	ABC transporter A, ABCA	 8	0.11282433035284	0.800900963894823	6	2	6741	7489	1.58270342374389
IPR026298	Blc2 family	11	0.849533330740884	1	4	7	6743	7484	0.767371356966733
IPR026307	Transmembrane protein 132	 5	0.451093636045012	1	3	2	6744	7489	1.26616273899511
IPR026523	Paraneoplastic antigen Ma	10	0.00689456282010794	0.331550196952537	9	1	6738	7490	1.89924410849266
IPR026590	Sirtuin family, catalytic core domain	 7	0.44299046303573	1	4	3	6743	7488	1.20586927523344
IPR026591	Sirtuin family, catalytic core small domain	 6	0.296087778157783	0.996215854772117	4	2	6743	7489	1.40684748777234
IPR026613	KRAB domain C2H2 zinc finger family	14	0.158970483067965	0.806571393258297	9	5	6738	7486	1.35660293463762
IPR026739	AP complex subunit beta	 5	0.156501784621734	0.806571393258297	4	1	6743	7490	1.68821698532681
IPR026791	Dedicator of cytokinesis	11	0.429568982367594	1	6	5	6741	7486	1.1510570354501
IPR026823	Complement Clr-like EGF domain	24	0.998248569373016	1	5	19	6742	7472	0.439639839928857
IPR026845	Neurexophilin/NXPE	 7	0.918536112180723	1	2	5	6745	7486	0.602934637616719
IPR026854	Vacuolar protein sorting-associated protein 13, N-terminal domain	 7	0.185910764499323	0.845680287938012	5	2	6742	7489	1.5073365940418
IPR026906	Leucine rich repeat 5	 9	0.881735281659405	1	3	6	6744	7485	0.703423743886172
IPR026910	Shisa family	 7	0.44299046303573	1	4	3	6743	7488	1.20586927523344
IPR026983	Dynein heavy chain	10	0.132273529234937	0.806571393258297	7	3	6740	7488	1.47718986216096
IPR027007	DHR-1 domain	11	0.429568982367594	1	6	5	6741	7486	1.1510570354501
IPR027214	Cystatin	10	1	1	0	10	6747	7481	0
IPR027231	Semaphorin	18	0.322822594532801	0.996215854772117	10	8	6737	7483	1.17237290647695
IPR027267	Arfaptin homology (AH) domain/BAR domain	29	0.534538911435677	1	14	15	6733	7476	1.01875162907652
IPR027309	P2X purinoreceptor extracellular domain	 6	0.86422044215898	1	2	4	6745	7487	0.703423743886172
IPR027357	DHR-2 domain	11	0.429568982367594	1	6	5	6741	7486	1.1510570354501
IPR027370	RING-type zinc-finger, LisH dimerisation motif	31	0.664560346534947	1	14	17	6733	7474	0.9530257175232
IPR027397	Catenin binding domain	25	0.99891534826843	1	5	20	6742	7471	0.422054246331703
IPR027408	PNPase/RNase PH domain	 6	0.296087778157783	0.996215854772117	4	2	6743	7489	1.40684748777234
IPR027409	GroEL-like apical domain	14	0.0617512698732667	0.62262586120625	10	4	6737	7487	1.5073365940418
IPR027413	GroEL-like equatorial domain	13	0.0964724174428019	0.737757665758239	9	4	6738	7487	1.46095700653282
IPR027450	Alpha-ketoglutarate-dependent dioxygenase AlkB-like	 8	0.578259437994666	1	4	4	6743	7487	1.05513561582926
IPR027483	Phosphatidylinositol-4-phosphate 5-kinase, C-terminal	 8	0.578259437994666	1	4	4	6743	7487	1.05513561582926
IPR027484	Phosphatidylinositol-4-phosphate 5-kinase, N-terminal domain	 8	0.578259437994666	1	4	4	6743	7487	1.05513561582926
IPR027775	C2H2- zinc finger protein family subset	22	0.485794894899752	1	11	11	6736	7480	1.05513561582926
IPR027789	Syndecan/Neurexin domain	 7	0.728431267104624	1	3	4	6744	7487	0.904401956425078
IPR027791	Galactosyltransferase, C-terminal	 9	0.881735281659405	1	3	6	6744	7485	0.703423743886172
IPR027925	MCM N-terminal domain	 6	0.86422044215898	1	2	4	6745	7487	0.703423743886172
IPR027936	Ephrin receptor, transmembrane domain	12	0.751834162472378	1	5	7	6742	7484	0.879279679857714
IPR027995	Galactosyltransferase, N-terminal	 7	0.728431267104624	1	3	4	6744	7487	0.904401956425078
IPR028002	Myb/SANT-like DNA-binding domain	 5	0.959711673474999	1	1	4	6746	7487	0.422054246331703
IPR028082	Periplasmic binding protein-like I	30	0.839891301121539	1	12	18	6735	7473	0.844108492663406
IPR028325	Voltage-gated potassium channel	29	0.944223849333801	1	10	19	6737	7472	0.72767973505466
IPR028375	KA1 domain/Ssp2, C-terminal	 7	0.44299046303573	1	4	3	6743	7488	1.20586927523344
IPR028435	Plakophilin/Delta catenin	 7	0.918536112180723	1	2	5	6745	7486	0.602934637616719
IPR028565	Mu homology domain	13	0.228396290943016	0.934241159076989	8	5	6739	7486	1.29862845025139
IPR028651	ING family	 5	0.7781801260834	1	2	3	6745	7488	0.844108492663406
IPR028889	Ubiquitin specific protease domain	49	0.000551257384564083	0.145440073294157	35	14	6712	7477	1.5073365940418
IPR028939	Pyrroline-5-carboxylate reductase, catalytic, N-terminal	 5	0.7781801260834	1	2	3	6745	7488	0.844108492663406
IPR028974	TSP type-3 repeat	 5	1	1	0	5	6747	7486	0
IPR029000	Cyclophilin-like domain	17	0.0463935769314538	0.527980989790211	12	5	6735	7486	1.48960322234719
IPR029006	ADF-H/Gelsolin-like domain	23	0.841941593690198	1	9	14	6738	7477	0.825758308040288
IPR029016	GAF domain-like	 7	0.44299046303573	1	4	3	6743	7488	1.20586927523344
IPR029021	Protein-tyrosine phosphatase-like	91	0.00824173938071916	0.331550196952537	55	36	6692	7455	1.2754386564969
IPR029023	Tensin-type phosphatase domain	 6	0.296087778157783	0.996215854772117	4	2	6743	7489	1.40684748777234
IPR029028	Alpha/beta knot methyltransferases	 6	0.606099493932241	1	3	3	6744	7488	1.05513561582926
IPR029030	Caspase-like domain	11	0.849533330740884	1	4	7	6743	7484	0.767371356966733
IPR029033	Histidine phosphatase superfamily	16	0.0238513580169886	0.400696547198938	12	4	6735	7487	1.58270342374389
IPR029034	Cystine-knot cytokine	48	0.999585866043204	1	12	36	6735	7455	0.527567807914629
IPR029035	DHS-like NAD/FAD-binding domain	12	0.147212368789038	0.806571393258297	8	4	6739	7487	1.40684748777234
IPR029039	Flavoprotein-like domain	 8	0.818534364570598	1	3	5	6744	7486	0.791351711871943
IPR029044	Nucleotide-diphospho-sugar transferases	85	0.394542937177692	1	42	43	6705	7448	1.04272225564303
IPR029045	ClpP/crotonase-like domain	19	0.408621506536301	1	10	9	6737	7482	1.11066906929396
IPR029047	Heat shock protein 70kD, peptide-binding domain	11	0.663808308432488	1	5	6	6742	7485	0.959214196208416
IPR029048	Heat shock protein 70kD, C-terminal domain	12	0.540572112776641	1	6	6	6741	7485	1.05513561582926
IPR029052	Metallo-dependent phosphatase-like	26	0.195767782789117	0.877904816303602	15	11	6732	7480	1.21746417211068
IPR029055	Nucleophile aminohydrolases, N-terminal	24	0.777427531599741	1	10	14	6737	7477	0.879279679857714
IPR029056	Ribokinase-like	 6	0.296087778157783	0.996215854772117	4	2	6743	7489	1.40684748777234
IPR029057	Phosphoribosyltransferase-like	11	0.663808308432488	1	5	6	6742	7485	0.959214196208416
IPR029058	Alpha/Beta hydrolase fold	99	0.611665977598467	1	46	53	6701	7438	0.98053006723527
IPR029060	PIN domain-like	12	0.147212368789038	0.806571393258297	8	4	6739	7487	1.40684748777234
IPR029061	Thiamin diphosphate-binding fold	10	0.314500257499634	0.996215854772117	6	4	6741	7487	1.26616273899511
IPR029062	Class I glutamine amidotransferase-like	11	0.218609653443	0.910681793158603	7	4	6740	7487	1.34289987469178
IPR029064	50S ribosomal protein L30e-like	13	0.423763673143334	1	7	6	6740	7485	1.13629989396997
IPR029068	Glyoxalase/Bleomycin resistance protein/Dihydroxybiphenyl dioxygenase	 6	0.606099493932241	1	3	3	6744	7488	1.05513561582926
IPR029069	HotDog domain	 8	0.00253714334619093	0.23625281864825	8	0	6739	7491	2.11027123165852
IPR029070	Chitinase insertion domain	 5	0.959711673474999	1	1	4	6746	7487	0.422054246331703
IPR029149	Creatinase/Aminopeptidase P/Spt16, N-terminal	 5	0.156501784621734	0.806571393258297	4	1	6743	7490	1.68821698532681
IPR029273	Cdc42 effector	 5	0.7781801260834	1	2	3	6745	7488	0.844108492663406
IPR029485	Cationic amino acid transporter, C-terminal	 5	0.7781801260834	1	2	3	6745	7488	0.844108492663406
IPR029510	Aldehyde dehydrogenase, glutamic acid active site	13	0.821296993728656	1	5	8	6742	7483	0.811642781407121
IPR029515	LAR-interacting protein, Liprin	 6	0.0867087878537095	0.700306179451134	5	1	6742	7490	1.75855935971543
IPR029526	PiggyBac transposable element-derived protein	 5	0.451093636045012	1	3	2	6744	7489	1.26616273899511
IPR029759	Glutathione peroxidase active site	 5	0.959711673474999	1	1	4	6746	7487	0.422054246331703
IPR029760	Glutathione peroxidase conserved site	 6	0.978809919738203	1	1	5	6746	7486	0.351711871943086
IPR029787	Nucleotide cyclase	16	0.982059015088883	1	4	12	6743	7479	0.527567807914629
IPR030378	Circularly permuted (CP)-type guanine nucleotide-binding (G) domain	 6	0.0867087878537095	0.700306179451134	5	1	6742	7490	1.75855935971543
IPR030379	Septin-type guanine nucleotide-binding (G) domain	10	0.132273529234937	0.806571393258297	7	3	6740	7488	1.47718986216096
IPR030381	Dynamin-type guanine nucleotide-binding (G) domain	13	0.228396290943016	0.934241159076989	8	5	6739	7486	1.29862845025139
IPR030386	GB1/RHD3-type guanine nucleotide-binding (G) domain	 8	0.578259437994666	1	4	4	6743	7487	1.05513561582926
IPR030395	Glycerophosphodiester phosphodiesterase domain	 6	0.606099493932241	1	3	3	6744	7488	1.05513561582926
IPR030417	Membrane-spanning 4-domains subfamily A	10	0.983765589502622	1	2	8	6745	7483	0.422054246331703
IPR030456	Fork head domain conserved site 2	31	0.988331716984779	1	9	22	6738	7469	0.612659389836343
IPR030492	Rel homology domain, conserved site	 5	0.959711673474999	1	1	4	6746	7487	0.422054246331703
IPR030564	Myotubularin family	13	0.0964724174428019	0.737757665758239	9	4	6738	7487	1.46095700653282
IPR030672	Adenylate cyclase	 8	0.994139200942595	1	1	7	6746	7484	0.263783903957314
IPR031107	Small heat shock protein HSP20	 7	0.988855554331116	1	1	6	6746	7485	0.301467318808359
IPR031127	E3 ubiquitin ligase RBR family	10	0.0385318949833867	0.498382293530479	8	2	6739	7489	1.68821698532681
IPR031148	Plexin family	 9	0.692132530392986	1	4	5	6743	7486	0.937898325181562
IPR031157	Tr-type G domain, conserved site	 8	0.307721488076794	0.996215854772117	5	3	6742	7488	1.31891951978657
IPR031160	F-BAR domain	21	0.858375596348842	1	8	13	6739	7478	0.803912850155625
IPR031167	OBG-type guanine nucleotide-binding (G) domain	 6	0.0867087878537095	0.700306179451134	5	1	6742	7490	1.75855935971543
IPR031176	ELL/occludin family	 5	0.7781801260834	1	2	3	6745	7488	0.844108492663406
IPR031259	Intracellular lipid binding protein	13	0.932643324273574	1	4	9	6743	7482	0.649314225125697
IPR031315	LNS2/PITP	 6	0.86422044215898	1	2	4	6745	7487	0.703423743886172
IPR031320	GAGE	 5	1	1	0	5	6747	7486	0
IPR031327	Mini-chromosome maintenance protein	 8	0.578259437994666	1	4	4	6743	7487	1.05513561582926
IPR031328	Ephrin	 8	0.951870028050764	1	2	6	6745	7485	0.527567807914629
IPR031435	Transmembrane protein TMEM132, N-terminal	 5	0.451093636045012	1	3	2	6744	7489	1.26616273899511
IPR031436	Transmembrane protein TMEM132, C-terminal	 5	0.451093636045012	1	3	2	6744	7489	1.26616273899511
IPR031437	Transmembrane protein family 132, middle domain	 5	0.451093636045012	1	3	2	6744	7489	1.26616273899511
IPR031481	Fucosyltransferase, N-terminal	 6	0.86422044215898	1	2	4	6745	7487	0.703423743886172
IPR031570	Domain of unknown function DUF4704	 5	0.451093636045012	1	3	2	6744	7489	1.26616273899511
IPR031649	Voltage-dependent L-type calcium channel, IQ-associated domain	 7	0.918536112180723	1	2	5	6745	7486	0.602934637616719
IPR031692	EH domain-containing protein, N-terminal	 5	0.451093636045012	1	3	2	6744	7489	1.26616273899511
IPR031701	Homeobox protein SIX1, N-terminal SD domain	 6	1	1	0	6	6747	7485	0
IPR031777	Sortilin, C-terminal	 5	0.156501784621734	0.806571393258297	4	1	6743	7490	1.68821698532681
IPR031778	Sortilin, N-terminal	 5	0.156501784621734	0.806571393258297	4	1	6743	7490	1.68821698532681
IPR031847	Domain of unknown function DUF4749	 6	0.606099493932241	1	3	3	6744	7488	1.05513561582926
IPR031904	Cadherin, C-terminal catenin-binding domain	13	0.640693632462334	1	6	7	6741	7484	0.973971337688545
IPR032098	Acyltransferase, C-terminal domain	 5	0.0238764544482636	0.400696547198938	5	0	6742	7491	2.11027123165852
IPR032376	Dedicator of cytokinesis, N-terminal domain	 5	0.451093636045012	1	3	2	6744	7489	1.26616273899511
IPR032394	Anoctamin, dimerisation domain	 7	0.728431267104624	1	3	4	6744	7487	0.904401956425078
IPR032397	Rel homology dimerisation domain	 9	0.881735281659405	1	3	6	6744	7485	0.703423743886172
IPR032405	Kinesin-associated	 5	0.156501784621734	0.806571393258297	4	1	6743	7490	1.68821698532681
IPR032413	Atypical Arm repeat	 5	0.7781801260834	1	2	3	6745	7488	0.844108492663406
IPR032425	Talin, N-terminal F0 domain	 5	0.451093636045012	1	3	2	6744	7489	1.26616273899511
IPR032443	RAWUL domain	 5	0.959711673474999	1	1	4	6746	7487	0.422054246331703
IPR032444	Keratin type II head	17	0.999706119467108	1	2	15	6745	7476	0.248267203724531
IPR032453	Homeobox protein PKNOX/Meis, N-terminal	 5	0.156501784621734	0.806571393258297	4	1	6743	7490	1.68821698532681
IPR032454	Histone H2A, C-terminal domain	 9	0.881735281659405	1	3	6	6744	7485	0.703423743886172
IPR032455	Cadherin, cytoplasmic C-terminal domain	23	0.719289809202321	1	10	13	6737	7478	0.917509231155876
IPR032458	Histone H2A conserved site	 7	0.918536112180723	1	2	5	6745	7486	0.602934637616719
IPR032466	Metal-dependent hydrolase	21	0.248941062915496	0.985184256488074	12	9	6735	7482	1.20586927523344
IPR032471	GAIN domain, N-terminal	 9	0.692132530392986	1	4	5	6743	7486	0.937898325181562
IPR032474	Protein argonaute, N-terminal	 5	0.0238764544482636	0.400696547198938	5	0	6742	7491	2.11027123165852
IPR032549	Domain of unknown function DUF4939	 7	0.728431267104624	1	3	4	6744	7487	0.904401956425078
IPR032567	LDOC1-related	 7	0.728431267104624	1	3	4	6744	7487	0.904401956425078
IPR032628	Adenylate cyclase, N-terminal	 8	0.994139200942595	1	1	7	6746	7484	0.263783903957314
IPR032630	P-type ATPase, C-terminal	12	0.147212368789038	0.806571393258297	8	4	6739	7487	1.40684748777234
IPR032631	P-type ATPase, N-terminal	12	0.147212368789038	0.806571393258297	8	4	6739	7487	1.40684748777234
IPR032695	Integrin domain	17	0.893904984617043	1	6	11	6741	7480	0.744801611173593
IPR032710	NTF2-like domain	13	0.640693632462334	1	6	7	6741	7484	0.973971337688545
IPR032778	Growth factor receptor domain 4	 6	0.86422044215898	1	2	4	6745	7487	0.703423743886172
IPR032815	Peptidase S8, pro-domain	 7	0.918536112180723	1	2	5	6745	7486	0.602934637616719
IPR032942	BPI/LBP/Plunc family	 9	0.996918035182955	1	1	8	6746	7483	0.234474581295391
IPR033113	Phospholipase A2, histidine active site	 7	0.988855554331116	1	1	6	6746	7485	0.301467318808359
IPR033116	Serine proteases, trypsin family, serine active site	58	0.999999999998534	1	4	54	6743	7437	0.145535947010932
IPR033121	Peptidase family A1 domain	 5	0.959711673474999	1	1	4	6746	7487	0.422054246331703
IPR033139	Peptidase family C14A, cysteine active site	 9	0.971908527019724	1	2	7	6745	7484	0.468949162590781
IPR033275	E3 ubiquitin-protein ligase MARCH-like	 8	0.818534364570598	1	3	5	6744	7486	0.791351711871943
IPR033614	C-terminal RASSF family	 5	0.0238764544482636	0.400696547198938	5	0	6742	7491	2.11027123165852
IPR033690	Adenylate kinase, conserved site	 5	0.7781801260834	1	2	3	6745	7488	0.844108492663406
IPR033760	Integrin beta N-terminal	 7	0.44299046303573	1	4	3	6743	7488	1.20586927523344
IPR033762	MCM OB domain	 8	0.578259437994666	1	4	4	6743	7487	1.05513561582926
IPR033772	UPA domain	 5	0.451093636045012	1	3	2	6744	7489	1.26616273899511
IPR033773	CBX family C-terminal motif	 5	0.7781801260834	1	2	3	6745	7488	0.844108492663406
