Term	Accession	Genes (tot)	Stat (non-dir.) p	p adj (non-dir.)	Significant..in.gene.set.	Non.significant..in.gene.set.	Significant..not.in.gene.set.	Non.significant..not.in.gene.set.	effect.size
IPR000001	Kringle	  8	1	1	0	8	2219	7898	0
IPR000006	Metallothionein, vertebrate	  7	1	1	0	7	2219	7899	0
IPR000010	Cystatin domain	  6	1	1	0	6	2219	7900	0
IPR000014	PAS domain	 23	0.224211351990502	1	7	16	2212	7890	1.38869839528185
IPR000033	LDLR class B repeat	 10	0.380546254047252	1	3	7	2216	7899	1.36885984677783
IPR000034	Laminin IV	  5	0.709805979093015	1	1	4	2218	7902	0.912573231185219
IPR000047	Helix-turn-helix motif	  9	1	1	0	9	2219	7897	0
IPR000048	IQ motif, EF-hand binding site	 43	0.474961188847378	1	10	33	2209	7873	1.06113166416886
IPR000058	Zinc finger, AN1-type	  6	1	1	0	6	2219	7900	0
IPR000061	SWAP/Surp	  5	0.00949538537636216	0.369707424169972	4	1	2215	7905	3.65029292474087
IPR000072	PDGF/VEGF domain	  8	0.861911680778881	1	1	7	2218	7899	0.570358269490762
IPR000073	Alpha/beta hydrolase fold-1	 17	0.914113969866565	1	2	15	2217	7891	0.536807783050129
IPR000082	SEA domain	  6	1	1	0	6	2219	7900	0
IPR000086	NUDIX hydrolase domain	 16	0.262304715437964	1	5	11	2214	7895	1.4258956737269
IPR000089	Biotin/lipoyl attachment	  7	0.475337159710437	1	2	5	2217	7901	1.30367604455031
IPR000095	CRIB domain	 15	0.670437858376869	1	3	12	2216	7894	0.912573231185219
IPR000152	EGF-type aspartate/asparagine hydroxylation site	 64	0.959136021261825	1	9	55	2210	7851	0.641653053177107
IPR000156	Ran binding domain	  5	0.709805979093015	1	1	4	2218	7902	0.912573231185219
IPR000157	Toll/interleukin-1 receptor homology (TIR) domain	 12	0.94872022890821	1	1	11	2218	7895	0.380238846327174
IPR000159	Ras-associating (RA) domain	 30	0.818820548556711	1	5	25	2214	7881	0.760477692654349
IPR000169	Cysteine peptidase, cysteine active site	 12	0.775765479746437	1	2	10	2217	7896	0.760477692654349
IPR000175	Sodium:neurotransmitter symporter	 10	0.915845830136643	1	1	9	2218	7897	0.456286615592609
IPR000182	GNAT domain	 16	0.478183231908334	1	4	12	2215	7894	1.14071653898152
IPR000194	ATPase, F1/V1/A1 complex, alpha/beta subunit, nucleotide-binding domain	  5	1	1	0	5	2219	7901	0
IPR000195	Rab-GTPase-TBC domain	 27	0.873547291082952	1	4	23	2215	7883	0.67598017124831
IPR000198	Rho GTPase-activating protein domain	 45	0.269975004575719	1	12	33	2207	7873	1.21676430824696
IPR000203	GPS motif	 16	0.478183231908334	1	4	12	2215	7894	1.14071653898152
IPR000209	Peptidase S8/S53 domain	  8	0.246621512499529	1	3	5	2216	7901	1.71107480847228
IPR000215	Serpin family	 14	1	1	0	14	2219	7892	0
IPR000217	Tubulin	 14	0.968755884502962	1	1	13	2218	7893	0.325919011137578
IPR000219	Dbl homology (DH) domain	 45	0.396699809513228	1	11	34	2208	7872	1.11536728255971
IPR000222	PPM-type phosphatase, divalent cation binding	  9	0.31344798805112	1	3	6	2216	7900	1.5209553853087
IPR000225	Armadillo	 23	0.589519856325972	1	5	18	2214	7888	0.991927425201324
IPR000233	Cadherin, cytoplasmic domain	 13	0.959972064372729	1	1	12	2218	7894	0.350989704302007
IPR000237	GRIP domain	  5	0.00949538537636216	0.369707424169972	4	1	2215	7905	3.65029292474087
IPR000242	PTP type protein phosphatase	 30	0.818820548556711	1	5	25	2214	7881	0.760477692654349
IPR000243	Peptidase T1A, proteasome beta-subunit	  5	0.302351833058719	1	2	3	2217	7903	1.82514646237044
IPR000253	Forkhead-associated (FHA) domain	 26	0.703951283516076	1	5	21	2214	7885	0.877474260755018
IPR000261	EH domain	 11	0.446044178306205	1	3	8	2216	7898	1.2444180425253
IPR000270	PB1 domain	  8	0.55157570878074	1	2	6	2217	7900	1.14071653898152
IPR000286	Histone deacetylase superfamily	 10	0.380546254047252	1	3	7	2216	7899	1.36885984677783
IPR000294	Gamma-carboxyglutamic acid-rich (GLA) domain	  8	0.861911680778881	1	1	7	2218	7899	0.570358269490762
IPR000299	FERM domain	 39	0.00556581020956239	0.369707424169972	16	23	2203	7883	1.8719450896107
IPR000300	Inositol polyphosphate-related phosphatase	  6	0.773436466483588	1	1	5	2218	7901	0.760477692654349
IPR000301	Tetraspanin	 19	0.94258296566969	1	2	17	2217	7889	0.480301700623799
IPR000306	FYVE zinc finger	 21	0.30453009912868	1	6	15	2213	7891	1.30367604455031
IPR000308	14-3-3 protein	  6	1	1	0	6	2219	7900	0
IPR000313	PWWP domain	 16	0.0422226244429989	0.84838322906845	7	9	2212	7897	1.99625394321767
IPR000315	B-box-type zinc finger	 30	0.194028782389107	1	9	21	2210	7885	1.36885984677783
IPR000326	Phosphatidic acid phosphatase type 2/haloperoxidase	 12	0.94872022890821	1	1	11	2218	7895	0.380238846327174
IPR000330	SNF2-related, N-terminal domain	 21	0.00801480996882679	0.369707424169972	10	11	2209	7895	2.17279340758385
IPR000331	Rap GTPase activating protein domain	 10	0.380546254047252	1	3	7	2216	7899	1.36885984677783
IPR000333	Ser/Thr protein kinase, TGFB receptor	 11	1	1	0	11	2219	7895	0
IPR000337	GPCR, family 3	  7	1	1	0	7	2219	7899	0
IPR000340	Dual specificity phosphatase, catalytic domain	 30	0.329024456942443	1	8	22	2211	7884	1.21676430824696
IPR000357	HEAT repeat	  9	0.619612200417774	1	2	7	2217	7899	1.01397025687247
IPR000372	Leucine-rich repeat N-terminal domain	 34	0.47631326116033	1	8	26	2211	7880	1.07361556610026
IPR000375	Dynamin central domain	  5	0.709805979093015	1	1	4	2218	7902	0.912573231185219
IPR000387	Tyrosine specific protein phosphatases domain	 63	0.646018991117507	1	13	50	2206	7856	0.941543809953003
IPR000403	Phosphatidylinositol 3-/4-kinase, catalytic domain	 13	0.135221236843926	1	5	8	2214	7898	1.75494852151004
IPR000407	Nucleoside phosphatase GDA1/CD39	  5	0.709805979093015	1	1	4	2218	7902	0.912573231185219
IPR000408	Regulator of chromosome condensation, RCC1	 17	0.309606220431718	1	5	12	2214	7894	1.34201945762532
IPR000409	BEACH domain	  7	0.182444498214428	1	3	4	2216	7902	1.95551406682547
IPR000413	Integrin alpha chain	  9	0.112968561396348	1	4	5	2215	7901	2.02794051374493
IPR000418	Ets domain	 17	0.914113969866565	1	2	15	2217	7891	0.536807783050129
IPR000421	Coagulation factor 5/8 C-terminal domain	 12	0.775765479746437	1	2	10	2217	7896	0.760477692654349
IPR000433	Zinc finger, ZZ-type	 16	0.478183231908334	1	4	12	2215	7894	1.14071653898152
IPR000436	Sushi/SCR/CCP domain	 32	0.996396502208684	1	2	30	2217	7876	0.285179134745381
IPR000451	NF-kappa-B/Dorsal	  5	1	1	0	5	2219	7901	0
IPR000460	Neuroligin	  5	1	1	0	5	2219	7901	0
IPR000463	Cytosolic fatty-acid binding	  9	0.619612200417774	1	2	7	2217	7899	1.01397025687247
IPR000467	G-patch domain	 16	0.0422226244429989	0.84838322906845	7	9	2212	7897	1.99625394321767
IPR000472	Activin types I and II receptor domain	  9	1	1	0	9	2219	7897	0
IPR000483	Cysteine-rich flanking region, C-terminal	 51	0.998125811343278	1	4	47	2215	7859	0.357871855366752
IPR000488	Death domain	 25	0.66845793236727	1	5	20	2214	7886	0.912573231185218
IPR000494	Receptor L-domain	  6	0.391653542140149	1	2	4	2217	7902	1.5209553853087
IPR000500	Connexin	  9	0.892199115824019	1	1	8	2218	7898	0.506985128436233
IPR000535	Major sperm protein (MSP) domain	  5	0.302351833058719	1	2	3	2217	7903	1.82514646237044
IPR000536	Nuclear hormone receptor, ligand-binding domain	 26	0.33802680531417	1	7	19	2212	7887	1.22846396505703
IPR000538	Link domain	  9	0.892199115824019	1	1	8	2218	7898	0.506985128436233
IPR000539	Frizzled protein	  8	0.861911680778881	1	1	7	2218	7899	0.570358269490762
IPR000547	Clathrin, heavy chain/VPS, 7-fold repeat	  6	0.773436466483588	1	1	5	2218	7901	0.760477692654349
IPR000555	JAB1/MPN/MOV34 metalloenzyme domain	  9	0.619612200417774	1	2	7	2217	7899	1.01397025687247
IPR000557	Calponin repeat	  5	1	1	0	5	2219	7901	0
IPR000560	Histidine phosphatase superfamily, clade-2	  6	0.391653542140149	1	2	4	2217	7902	1.5209553853087
IPR000562	Fibronectin, type II, collagen-binding	  7	0.823119684279113	1	1	6	2218	7900	0.651838022275156
IPR000566	Lipocalin/cytosolic fatty-acid binding domain	 14	0.845782402679702	1	2	12	2217	7894	0.651838022275156
IPR000569	HECT domain	 27	0.873547291082952	1	4	23	2215	7883	0.67598017124831
IPR000571	Zinc finger, CCCH-type	 37	0.020239765028362	0.604590751459735	14	23	2205	7883	1.7264898968369
IPR000585	Hemopexin-like domain	  7	1	1	0	7	2219	7899	0
IPR000591	DEP domain	 17	0.309606220431718	1	5	12	2214	7894	1.34201945762532
IPR000594	THIF-type NAD/FAD binding fold	  8	0.55157570878074	1	2	6	2217	7900	1.14071653898152
IPR000595	Cyclic nucleotide-binding domain	 19	0.820195102951484	1	3	16	2216	7890	0.720452550935699
IPR000601	PKD domain	 10	0.679378687010405	1	2	8	2217	7898	0.912573231185219
IPR000608	Ubiquitin-conjugating enzyme E2	 30	0.670257615882273	1	6	24	2213	7882	0.912573231185219
IPR000626	Ubiquitin domain	 33	0.878951423918976	1	5	28	2214	7878	0.691343356958499
IPR000629	ATP-dependent RNA helicase DEAD-box, conserved site	 15	0.424213602790741	1	4	11	2215	7895	1.21676430824696
IPR000639	Epoxide hydrolase-like	  6	1	1	0	6	2219	7900	0
IPR000640	Translation elongation factor EFG, V domain	  5	0.709805979093015	1	1	4	2218	7902	0.912573231185219
IPR000644	CBS domain	 11	0.934307333144729	1	1	10	2218	7896	0.414806014175099
IPR000648	Oxysterol-binding protein	 10	0.679378687010405	1	2	8	2217	7898	0.912573231185219
IPR000651	Ras-like guanine nucleotide exchange factor, N-terminal	 19	0.820195102951484	1	3	16	2216	7890	0.720452550935699
IPR000668	Peptidase C1A, papain C-terminal	  7	0.475337159710437	1	2	5	2217	7901	1.30367604455031
IPR000679	Zinc finger, GATA-type	  9	0.892199115824019	1	1	8	2218	7898	0.506985128436233
IPR000697	WH1/EVH1 domain	  9	0.112968561396348	1	4	5	2215	7901	2.02794051374493
IPR000699	RIH (RyR and IP3R Homology) domain	  6	0.391653542140149	1	2	4	2217	7902	1.5209553853087
IPR000700	PAS-associated, C-terminal	  5	0.709805979093015	1	1	4	2218	7902	0.912573231185219
IPR000716	Thyroglobulin type-1	 10	0.679378687010405	1	2	8	2217	7898	0.912573231185219
IPR000717	Proteasome component (PCI) domain	 15	0.975612841508988	1	1	14	2218	7892	0.30419107706174
IPR000727	Target SNARE coiled-coil homology domain	 22	0.189594414231174	1	7	15	2212	7891	1.45182104961285
IPR000731	Sterol-sensing domain	  6	0.391653542140149	1	2	4	2217	7902	1.5209553853087
IPR000738	WHEP-TRS domain	  5	1	1	0	5	2219	7901	0
IPR000756	Diacylglycerol kinase, accessory domain	  7	0.823119684279113	1	1	6	2218	7900	0.651838022275156
IPR000772	Ricin B, lectin domain	 19	0.406417388847219	1	5	14	2214	7892	1.2007542515595
IPR000795	Transcription factor, GTP-binding domain	 15	0.424213602790741	1	4	11	2215	7895	1.21676430824696
IPR000798	Ezrin/radixin/moesin-like	 17	0.0585805185280644	0.979653214422437	7	10	2212	7896	1.87882724067545
IPR000800	Notch domain	  6	1	1	0	6	2219	7900	0
IPR000827	CC chemokine, conserved site	  5	0.709805979093015	1	1	4	2218	7902	0.912573231185219
IPR000832	GPCR, family 2, secretin-like	 22	0.546404854954054	1	5	17	2214	7889	1.03701503543775
IPR000834	Peptidase M14, carboxypeptidase A	  8	0.55157570878074	1	2	6	2217	7900	1.14071653898152
IPR000837	AP-1 transcription factor	  6	0.773436466483588	1	1	5	2218	7901	0.760477692654349
IPR000850	Adenylate kinase/UMP-CMP kinase	  7	0.475337159710437	1	2	5	2217	7901	1.30367604455031
IPR000857	MyTH4 domain	  7	0.00708410048765289	0.369707424169972	5	2	2214	7904	3.25919011137578
IPR000859	CUB domain	 29	0.99924248148192	1	1	28	2218	7878	0.157340212273314
IPR000863	Sulfotransferase domain	 14	0.845782402679702	1	2	12	2217	7894	0.651838022275156
IPR000866	Alkyl hydroperoxide reductase subunit C/ Thiol specific antioxidant	  5	0.709805979093015	1	1	4	2218	7902	0.912573231185219
IPR000867	Insulin-like growth factor-binding protein, IGFBP	 12	0.94872022890821	1	1	11	2218	7895	0.380238846327174
IPR000873	AMP-dependent synthetase/ligase	 17	0.754393859719995	1	3	14	2216	7892	0.805211674575193
IPR000884	Thrombospondin type-1 (TSP1) repeat	 32	0.982237402034069	1	3	29	2216	7877	0.427768702118071
IPR000885	Fibrillar collagen, C-terminal	  6	0.773436466483588	1	1	5	2218	7901	0.760477692654349
IPR000904	Sec7 domain	 13	0.313297073561014	1	4	9	2215	7897	1.40395881720803
IPR000906	ZU5 domain	  9	0.619612200417774	1	2	7	2217	7899	1.01397025687247
IPR000909	Phosphatidylinositol-specific phospholipase C, X domain	 15	0.975612841508988	1	1	14	2218	7892	0.30419107706174
IPR000917	Sulfatase, N-terminal	  9	0.619612200417774	1	2	7	2217	7899	1.01397025687247
IPR000938	CAP Gly-rich domain	 10	0.915845830136643	1	1	9	2218	7897	0.456286615592609
IPR000949	ELM2 domain	  8	0.861911680778881	1	1	7	2218	7899	0.570358269490762
IPR000953	Chromo/chromo shadow domain	 17	0.309606220431718	1	5	12	2214	7894	1.34201945762532
IPR000961	AGC-kinase, C-terminal	 39	0.344520508069512	1	10	29	2209	7877	1.16996568100669
IPR000980	SH2 domain	 66	0.810347990901853	1	12	54	2207	7852	0.829612028350199
IPR000994	Peptidase M24	  8	0.861911680778881	1	1	7	2218	7899	0.570358269490762
IPR000998	MAM domain	  5	1	1	0	5	2219	7901	0
IPR001005	SANT/Myb domain	 32	0.0131339013435646	0.495394341302578	13	19	2206	7887	1.85366437584498
IPR001007	VWFC domain	 20	1	1	0	20	2219	7886	0
IPR001012	UBX domain	  9	0.112968561396348	1	4	5	2215	7901	2.02794051374493
IPR001019	Guanine nucleotide binding protein (G-protein), alpha subunit	 12	0.100646351235543	1	5	7	2214	7899	1.90119423163587
IPR001024	PLAT/LH2 domain	  6	1	1	0	6	2219	7900	0
IPR001025	Bromo adjacent homology (BAH) domain	  7	0.823119684279113	1	1	6	2218	7900	0.651838022275156
IPR001039	MHC class I alpha chain, alpha1 alpha2 domains	  6	1	1	0	6	2219	7900	0
IPR001054	Adenylyl cyclase class-3/4/guanylyl cyclase	 13	0.813698203333979	1	2	11	2217	7895	0.701979408604014
IPR001060	FCH domain	 14	0.845782402679702	1	2	12	2217	7894	0.651838022275156
IPR001067	Nuclear translocator	  5	0.302351833058719	1	2	3	2217	7903	1.82514646237044
IPR001071	Cellular retinaldehyde binding/alpha-tocopherol transport	  6	0.773436466483588	1	1	5	2218	7901	0.760477692654349
IPR001073	C1q domain	 14	0.845782402679702	1	2	12	2217	7894	0.651838022275156
IPR001079	Galectin, carbohydrate recognition domain	  6	1	1	0	6	2219	7900	0
IPR001089	CXC chemokine	  6	1	1	0	6	2219	7900	0
IPR001090	Ephrin receptor ligand binding domain	 10	1	1	0	10	2219	7896	0
IPR001101	Plectin repeat	  5	0.302351833058719	1	2	3	2217	7903	1.82514646237044
IPR001107	Band 7 domain	  6	0.773436466483588	1	1	5	2218	7901	0.760477692654349
IPR001111	TGF-beta, propeptide	  7	1	1	0	7	2219	7899	0
IPR001128	Cytochrome P450	 19	0.94258296566969	1	2	17	2217	7889	0.480301700623799
IPR001132	SMAD domain, Dwarfin-type	  7	0.182444498214428	1	3	4	2216	7902	1.95551406682547
IPR001134	Netrin domain	 13	1	1	0	13	2219	7893	0
IPR001148	Alpha carbonic anhydrase	 11	0.731230800055783	1	2	9	2217	7897	0.829612028350199
IPR001163	LSM domain, eukaryotic/archaea-type	 10	0.679378687010405	1	2	8	2217	7898	0.912573231185219
IPR001164	Arf GTPase activating protein	 22	0.743059870240953	1	4	18	2215	7888	0.829612028350199
IPR001173	Glycosyltransferase 2-like	 17	0.0585805185280644	0.979653214422437	7	10	2212	7896	1.87882724067545
IPR001179	FKBP-type peptidyl-prolyl cis-trans isomerase domain	 11	1	1	0	11	2219	7895	0
IPR001180	Citron homology (CNH) domain	 13	0.135221236843926	1	5	8	2214	7898	1.75494852151004
IPR001190	SRCR domain	 14	0.845782402679702	1	2	12	2217	7894	0.651838022275156
IPR001192	Phosphoinositide phospholipase C family	 10	0.915845830136643	1	1	9	2218	7897	0.456286615592609
IPR001194	DENN domain	 13	0.313297073561014	1	4	9	2215	7897	1.40395881720803
IPR001199	Cytochrome b5-like heme/steroid binding domain	 13	0.813698203333979	1	2	11	2217	7895	0.701979408604014
IPR001202	WW domain	 47	0.326228045355576	1	12	35	2207	7871	1.1649871036407
IPR001206	Diacylglycerol kinase, catalytic domain	 11	0.934307333144729	1	1	10	2218	7896	0.414806014175099
IPR001208	MCM domain	  6	0.773436466483588	1	1	5	2218	7901	0.760477692654349
IPR001214	SET domain	 29	0.0368743323061022	0.789623099014136	11	18	2208	7888	1.73074233500645
IPR001217	Transcription factor STAT	  6	0.391653542140149	1	2	4	2217	7902	1.5209553853087
IPR001236	Lactate/malate dehydrogenase, N-terminal	  5	0.0736454441167817	0.979653214422437	3	2	2216	7904	2.73771969355566
IPR001245	Serine-threonine/tyrosine-protein kinase, catalytic domain	 89	0.943623315398937	1	14	75	2205	7831	0.717754226774891
IPR001247	Exoribonuclease, phosphorolytic domain 1	  7	0.475337159710437	1	2	5	2217	7901	1.30367604455031
IPR001251	CRAL-TRIO lipid binding domain	 19	0.0386615816167984	0.804560845025444	8	11	2211	7895	1.9212068024952
IPR001254	Serine proteases, trypsin domain	 37	0.998811817215887	1	2	35	2217	7871	0.246641413833843
IPR001258	NHL repeat	  6	0.773436466483588	1	1	5	2218	7901	0.760477692654349
IPR001263	Phosphoinositide 3-kinase, accessory (PIK) domain	  6	0.391653542140149	1	2	4	2217	7902	1.5209553853087
IPR001279	Metallo-beta-lactamase	 17	0.914113969866565	1	2	15	2217	7891	0.536807783050129
IPR001293	Zinc finger, TRAF-type	  9	1	1	0	9	2219	7897	0
IPR001298	Filamin/ABP280 repeat	  6	0.773436466483588	1	1	5	2218	7901	0.760477692654349
IPR001300	Peptidase C2, calpain, catalytic domain	  5	1	1	0	5	2219	7901	0
IPR001304	C-type lectin-like	 28	0.962280271964013	1	3	25	2216	7881	0.488878516706367
IPR001309	Peptidase C14,  p20 domain	  9	0.31344798805112	1	3	6	2216	7900	1.5209553853087
IPR001314	Peptidase S1A, chymotrypsin family	 34	0.997682960977737	1	2	32	2217	7874	0.268403891525064
IPR001315	CARD domain	 15	0.670437858376869	1	3	12	2216	7894	0.912573231185219
IPR001320	Ionotropic glutamate receptor	 12	0.94872022890821	1	1	11	2218	7895	0.380238846327174
IPR001331	Guanine-nucleotide dissociation stimulator, CDC24, conserved site	 16	0.980965473031397	1	1	15	2218	7891	0.285179134745381
IPR001345	Phosphoglycerate/bisphosphoglycerate mutase, active site	  5	1	1	0	5	2219	7901	0
IPR001346	Interferon regulatory factor DNA-binding domain	  6	0.773436466483588	1	1	5	2218	7901	0.760477692654349
IPR001353	Proteasome, subunit alpha/beta	 13	0.813698203333979	1	2	11	2217	7895	0.701979408604014
IPR001356	Homeobox domain	 75	0.979197942897838	1	10	65	2209	7841	0.608382154123479
IPR001357	BRCT domain	 14	0.174228157169119	1	5	9	2214	7897	1.62959505568789
IPR001368	TNFR/NGFR cysteine-rich region	 14	1	1	0	14	2219	7892	0
IPR001370	BIR repeat	  5	0.709805979093015	1	1	4	2218	7902	0.912573231185219
IPR001373	Cullin, N-terminal	  8	0.55157570878074	1	2	6	2217	7900	1.14071653898152
IPR001374	R3H domain	  7	0.0454869704711032	0.84838322906845	4	3	2215	7903	2.60735208910062
IPR001375	Peptidase S9, prolyl oligopeptidase, catalytic domain	  8	0.55157570878074	1	2	6	2217	7900	1.14071653898152
IPR001382	Glycoside hydrolase family 47	  6	0.12374841489586	1	3	3	2216	7903	2.28143307796305
IPR001388	Synaptobrevin	 12	0.508557401602509	1	3	9	2216	7897	1.14071653898152
IPR001390	Gamma-aminobutyric-acid A receptor, alpha subunit	  5	1	1	0	5	2219	7901	0
IPR001394	Peptidase C19, ubiquitin carboxyl-terminal hydrolase	 41	0.0228401771870249	0.604590751459735	15	26	2204	7880	1.66934127655833
IPR001401	Dynamin, GTPase domain	  6	0.773436466483588	1	1	5	2218	7901	0.760477692654349
IPR001408	G-protein alpha subunit, group I	  5	0.709805979093015	1	1	4	2218	7902	0.912573231185219
IPR001412	Aminoacyl-tRNA synthetase, class I, conserved site	 11	0.446044178306205	1	3	8	2216	7898	1.2444180425253
IPR001426	Tyrosine-protein kinase, receptor class V, conserved site	 10	1	1	0	10	2219	7896	0
IPR001427	Pancreatic ribonuclease	  5	0.709805979093015	1	1	4	2218	7902	0.912573231185219
IPR001431	Peptidase M16, zinc-binding site	  5	0.0736454441167817	0.979653214422437	3	2	2216	7904	2.73771969355566
IPR001433	Oxidoreductase FAD/NAD(P)-binding	  7	0.475337159710437	1	2	5	2217	7901	1.30367604455031
IPR001436	Alpha crystallin/Heat shock protein	  6	1	1	0	6	2219	7900	0
IPR001440	Tetratricopeptide repeat 1	 21	0.30453009912868	1	6	15	2213	7891	1.30367604455031
IPR001461	Aspartic peptidase A1 family	  5	0.709805979093015	1	1	4	2218	7902	0.912573231185219
IPR001464	Annexin	  8	0.861911680778881	1	1	7	2218	7899	0.570358269490762
IPR001487	Bromodomain	 35	0.000118108260211258	0.142556670074989	18	17	2201	7889	2.34661688019056
IPR001494	Importin-beta, N-terminal domain	 11	0.731230800055783	1	2	9	2217	7897	0.829612028350199
IPR001496	SOCS box domain	 13	0.813698203333979	1	2	11	2217	7895	0.701979408604014
IPR001508	Ionotropic glutamate receptor, metazoa	 12	0.94872022890821	1	1	11	2218	7895	0.380238846327174
IPR001509	NAD-dependent epimerase/dehydratase	  5	0.709805979093015	1	1	4	2218	7902	0.912573231185219
IPR001557	L-lactate/malate dehydrogenase	  5	0.0736454441167817	0.979653214422437	3	2	2216	7904	2.73771969355566
IPR001565	Synaptotagmin	 13	0.959972064372729	1	1	12	2218	7894	0.350989704302007
IPR001589	Actinin-type actin-binding domain, conserved site	 21	0.30453009912868	1	6	15	2213	7891	1.30367604455031
IPR001590	Peptidase M12B, ADAM/reprolysin	 18	0.357913481756731	1	5	13	2214	7893	1.26746282109058
IPR001594	Palmitoyltransferase, DHHC domain	 18	0.0783286283854817	0.995185836434489	7	11	2212	7895	1.77444794952681
IPR001599	Alpha-2-macroglobulin	  5	1	1	0	5	2219	7901	0
IPR001604	DNA/RNA non-specific endonuclease	  5	0.302351833058719	1	2	3	2217	7903	1.82514646237044
IPR001605	Pleckstrin homology domain, spectrin-type	  7	1	1	0	7	2219	7899	0
IPR001606	ARID DNA-binding domain	 13	0.567135500014957	1	3	10	2216	7896	1.05296911290602
IPR001607	Zinc finger, UBP-type	 11	0.205885122690044	1	4	7	2215	7899	1.6592240567004
IPR001609	Myosin head, motor domain	 18	0.0275477744664086	0.678574771039901	8	10	2211	7896	2.02794051374493
IPR001610	PAC motif	 11	0.446044178306205	1	3	8	2216	7898	1.2444180425253
IPR001619	Sec1-like protein	  5	0.302351833058719	1	2	3	2217	7903	1.82514646237044
IPR001623	DnaJ domain	 35	0.908810553843666	1	5	30	2214	7876	0.651838022275156
IPR001627	Sema domain	 23	0.775384083696739	1	4	19	2215	7887	0.79354194016106
IPR001628	Zinc finger, nuclear hormone receptor-type	 26	0.33802680531417	1	7	19	2212	7887	1.22846396505703
IPR001650	Helicase, C-terminal	 69	0.102988129521535	1	20	49	2199	7857	1.32256990026843
IPR001660	Sterile alpha motif domain	 63	0.910197945906448	1	10	53	2209	7853	0.724264469194618
IPR001664	Intermediate filament protein	 16	0.89532336867285	1	2	14	2217	7892	0.570358269490762
IPR001666	Phosphatidylinositol transfer protein	  6	0.391653542140149	1	2	4	2217	7902	1.5209553853087
IPR001675	Glycosyl transferase family 29	 13	0.813698203333979	1	2	11	2217	7895	0.701979408604014
IPR001683	Phox homologous domain	 40	0.247130481803914	1	11	29	2208	7877	1.25478819287968
IPR001696	Voltage gated sodium channel, alpha subunit	  5	1	1	0	5	2219	7901	0
IPR001699	Transcription factor, T-box	  5	1	1	0	5	2219	7901	0
IPR001709	Flavoprotein pyridine nucleotide cytochrome reductase	  6	0.391653542140149	1	2	4	2217	7902	1.5209553853087
IPR001711	Phospholipase C, phosphatidylinositol-specific, Y domain	 10	0.915845830136643	1	1	9	2218	7897	0.456286615592609
IPR001715	Calponin homology domain	 56	0.230955545396983	1	15	41	2204	7865	1.22219629176592
IPR001723	Nuclear hormone receptor	 25	0.298882782279106	1	7	18	2212	7888	1.27760252365931
IPR001736	Phospholipase D/Transphosphatidylase	  7	0.823119684279113	1	1	6	2218	7900	0.651838022275156
IPR001739	Methyl-CpG DNA binding	 10	0.0470933524006513	0.84838322906845	5	5	2214	7901	2.28143307796305
IPR001751	S100/Calbindin-D9k, conserved site	 12	1	1	0	12	2219	7894	0
IPR001752	Kinesin motor domain	 24	0.630273099607129	1	5	19	2214	7887	0.950597115817936
IPR001753	Crotonase superfamily	  9	0.31344798805112	1	3	6	2216	7900	1.5209553853087
IPR001757	P-type ATPase	 26	0.19263471975536	1	8	18	2211	7888	1.40395881720803
IPR001759	Pentraxin-related	  5	1	1	0	5	2219	7901	0
IPR001762	Disintegrin domain	  8	0.0754828077392598	0.979653214422437	4	4	2215	7902	2.28143307796305
IPR001763	Rhodanese-like domain	 19	0.625320740552394	1	4	15	2215	7891	0.960603401247598
IPR001766	Fork head domain	 21	0.707304412916063	1	4	17	2215	7889	0.869117363033541
IPR001770	G-protein, gamma subunit	  8	1	1	0	8	2219	7898	0
IPR001781	Zinc finger, LIM-type	 47	0.458840341989372	1	11	36	2208	7870	1.06790484500398
IPR001791	Laminin G domain	 39	0.78226888103637	1	7	32	2212	7874	0.818975976704683
IPR001806	Small GTPase superfamily	 94	0.983039847839238	1	13	81	2206	7825	0.631034681138715
IPR001807	Chloride channel, voltage gated	  6	1	1	0	6	2219	7900	0
IPR001810	F-box domain	 44	0.148579727603499	1	13	31	2206	7875	1.34811954606907
IPR001811	Chemokine interleukin-8-like domain	 14	0.968755884502962	1	1	13	2218	7893	0.325919011137578
IPR001818	Peptidase M10, metallopeptidase	  7	1	1	0	7	2219	7899	0
IPR001824	Tyrosine-protein kinase, receptor class III, conserved site	  5	1	1	0	5	2219	7901	0
IPR001828	Receptor, ligand binding region	 19	0.990950756922267	1	1	18	2218	7888	0.2401508503119
IPR001839	Transforming growth factor-beta, C-terminal	 11	0.934307333144729	1	1	10	2218	7896	0.414806014175099
IPR001846	von Willebrand factor, type D domain	  7	1	1	0	7	2219	7899	0
IPR001870	B30.2/SPRY domain	 39	0.949782619087418	1	5	34	2214	7872	0.584982840503345
IPR001875	Death effector domain	  5	0.709805979093015	1	1	4	2218	7902	0.912573231185219
IPR001876	Zinc finger, RanBP2-type	 18	0.0783286283854817	0.995185836434489	7	11	2212	7895	1.77444794952681
IPR001878	Zinc finger, CCHC-type	 21	0.0689303145852814	0.979653214422437	8	13	2211	7893	1.73823472606708
IPR001879	GPCR, family 2, extracellular hormone receptor domain	 13	0.313297073561014	1	4	9	2215	7897	1.40395881720803
IPR001881	EGF-like calcium-binding domain	 73	0.9879055538276	1	9	64	2210	7842	0.562545142511436
IPR001895	Ras guanine-nucleotide exchange factors catalytic domain	 24	0.922440857155266	1	3	21	2216	7885	0.570358269490762
IPR001902	SLC26A/SulP transporter	  5	0.709805979093015	1	1	4	2218	7902	0.912573231185219
IPR001930	Peptidase M1, alanine aminopeptidase/leukotriene A4 hydrolase	  6	1	1	0	6	2219	7900	0
IPR001932	PPM-type phosphatase domain	 13	0.567135500014957	1	3	10	2216	7896	1.05296911290602
IPR001936	Ras GTPase-activating protein	 14	0.621193007259644	1	3	11	2216	7895	0.977757033412734
IPR001965	Zinc finger, PHD-type	 64	0.0287798112800587	0.6791314801358	21	43	2198	7863	1.49719045741325
IPR001969	Aspartic peptidase, active site	  5	0.709805979093015	1	1	4	2218	7902	0.912573231185219
IPR001991	Sodium:dicarboxylate symporter	  5	0.302351833058719	1	2	3	2217	7903	1.82514646237044
IPR002004	Polyadenylate-binding protein/Hyperplastic disc protein	  5	0.302351833058719	1	2	3	2217	7903	1.82514646237044
IPR002011	Tyrosine-protein kinase, receptor class II, conserved site	  8	0.55157570878074	1	2	6	2217	7900	1.14071653898152
IPR002014	VHS domain	  6	0.391653542140149	1	2	4	2217	7902	1.5209553853087
IPR002017	Spectrin repeat	 20	0.127884206329256	1	7	13	2212	7893	1.59700315457413
IPR002018	Carboxylesterase, type B	  9	0.619612200417774	1	2	7	2217	7899	1.01397025687247
IPR002030	Mitochondrial brown fat uncoupling protein	  5	1	1	0	5	2219	7901	0
IPR002035	von Willebrand factor, type A	 53	0.259208598974288	1	14	39	2205	7867	1.20528539967859
IPR002049	Laminin EGF domain	 26	0.945665977734371	1	3	23	2216	7883	0.526484556453011
IPR002058	PAP/25A-associated	  7	0.475337159710437	1	2	5	2217	7901	1.30367604455031
IPR002067	Mitochondrial carrier protein	 21	0.870333808588759	1	3	18	2216	7888	0.651838022275156
IPR002068	Alpha crystallin/Hsp20 domain	  6	1	1	0	6	2219	7900	0
IPR002073	3'5'-cyclic nucleotide phosphodiesterase, catalytic domain	 16	0.00288324485961926	0.316656565736196	9	7	2210	7899	2.56661221270843
IPR002076	ELO family	  5	0.0736454441167817	0.979653214422437	3	2	2216	7904	2.73771969355566
IPR002077	Voltage-dependent calcium channel, alpha-1 subunit	  6	0.773436466483588	1	1	5	2218	7901	0.760477692654349
IPR002083	MATH/TRAF domain	  7	0.475337159710437	1	2	5	2217	7901	1.30367604455031
IPR002087	Anti-proliferative protein	  5	0.302351833058719	1	2	3	2217	7903	1.82514646237044
IPR002108	Actin-depolymerising factor homology domain	  6	0.773436466483588	1	1	5	2218	7901	0.760477692654349
IPR002119	Histone H2A	  5	0.709805979093015	1	1	4	2218	7902	0.912573231185219
IPR002123	Phospholipid/glycerol acyltransferase	 12	0.775765479746437	1	2	10	2217	7896	0.760477692654349
IPR002125	Cytidine and deoxycytidylate deaminases, zinc-binding	  5	0.709805979093015	1	1	4	2218	7902	0.912573231185219
IPR002126	Cadherin	 42	0.923263110362036	1	6	36	2213	7870	0.651838022275156
IPR002130	Cyclophilin-type peptidyl-prolyl cis-trans isomerase domain	 13	0.135221236843926	1	5	8	2214	7898	1.75494852151004
IPR002138	Peptidase C14, caspase non-catalytic subunit p10	  7	0.823119684279113	1	1	6	2218	7900	0.651838022275156
IPR002155	Thiolase	  5	0.302351833058719	1	2	3	2217	7903	1.82514646237044
IPR002164	Nucleosome assembly protein (NAP)	  9	1	1	0	9	2219	7897	0
IPR002165	Plexin repeat	 20	0.953198417975075	1	2	18	2217	7888	0.456286615592609
IPR002172	Low-density lipoprotein (LDL) receptor class A repeat	 24	0.630273099607129	1	5	19	2214	7887	0.950597115817936
IPR002181	Fibrinogen, alpha/beta/gamma chain, C-terminal globular domain	 17	0.914113969866565	1	2	15	2217	7891	0.536807783050129
IPR002190	MAGE homology domain	  7	1	1	0	7	2219	7899	0
IPR002194	Chaperonin TCP-1, conserved site	  8	1	1	0	8	2219	7898	0
IPR002209	Fibroblast growth factor family	  6	0.391653542140149	1	2	4	2217	7902	1.5209553853087
IPR002219	Protein kinase C-like, phorbol ester/diacylglycerol-binding domain	 52	0.956966182155798	1	7	45	2212	7861	0.614231982528513
IPR002223	Pancreatic trypsin inhibitor Kunitz domain	  7	1	1	0	7	2219	7899	0
IPR002231	5-hydroxytryptamine receptor family	  5	1	1	0	5	2219	7901	0
IPR002293	Amino acid/polyamine transporter I	  9	0.619612200417774	1	2	7	2217	7899	1.01397025687247
IPR002300	Aminoacyl-tRNA synthetase, class Ia	  5	0.302351833058719	1	2	3	2217	7903	1.82514646237044
IPR002314	Aminoacyl-tRNA synthetase, class II (G/ P/ S/T)	  5	0.709805979093015	1	1	4	2218	7902	0.912573231185219
IPR002343	Paraneoplastic encephalomyelitis antigen	  8	0.246621512499529	1	3	5	2216	7901	1.71107480847228
IPR002347	Short-chain dehydrogenase/reductase SDR	 33	0.168284467586947	1	10	23	2209	7883	1.382686713917
IPR002350	Kazal domain	 19	0.406417388847219	1	5	14	2214	7892	1.2007542515595
IPR002369	Integrin beta subunit, VWA domain	  6	1	1	0	6	2219	7900	0
IPR002401	Cytochrome P450, E-class, group I	 14	0.968755884502962	1	1	13	2218	7893	0.325919011137578
IPR002404	IRS-type PTB domain	  7	0.182444498214428	1	3	4	2216	7902	1.95551406682547
IPR002420	Phosphatidylinositol 3-kinase, C2 domain	  5	0.709805979093015	1	1	4	2218	7902	0.912573231185219
IPR002423	Chaperonin Cpn60/TCP-1 family	 12	0.94872022890821	1	1	11	2218	7895	0.380238846327174
IPR002453	Beta tubulin	  6	1	1	0	6	2219	7900	0
IPR002464	DNA/RNA helicase, ATP-dependent, DEAH-box type, conserved site	 14	0.621193007259644	1	3	11	2216	7895	0.977757033412734
IPR002469	Dipeptidylpeptidase IV, N-terminal domain	  5	0.709805979093015	1	1	4	2218	7902	0.912573231185219
IPR002475	Bcl2-like	  7	0.823119684279113	1	1	6	2218	7900	0.651838022275156
IPR002477	Peptidoglycan binding-like	  7	1	1	0	7	2219	7899	0
IPR002483	PWI domain	  6	0.023542473337703	0.604590751459735	4	2	2215	7904	3.0419107706174
IPR002495	Glycosyl transferase, family 8	  7	0.823119684279113	1	1	6	2218	7900	0.651838022275156
IPR002498	Phosphatidylinositol-4-phosphate 5-kinase, core	  8	0.861911680778881	1	1	7	2218	7899	0.570358269490762
IPR002515	Zinc finger, C2HC-type	  5	0.0736454441167817	0.979653214422437	3	2	2216	7904	2.73771969355566
IPR002524	Cation efflux protein	  8	0.55157570878074	1	2	6	2217	7900	1.14071653898152
IPR002553	Clathrin/coatomer adaptor, adaptin-like, N-terminal	 12	0.94872022890821	1	1	11	2218	7895	0.380238846327174
IPR002554	Protein phosphatase 2A, regulatory B subunit, B56	  5	0.302351833058719	1	2	3	2217	7903	1.82514646237044
IPR002589	Macro domain	  8	0.246621512499529	1	3	5	2216	7901	1.71107480847228
IPR002591	Type I phosphodiesterase/nucleotide pyrophosphatase/phosphate transferase	  9	0.31344798805112	1	3	6	2216	7900	1.5209553853087
IPR002645	STAS domain	  5	0.709805979093015	1	1	4	2218	7902	0.912573231185219
IPR002652	Importin-alpha, importin-beta-binding domain	  5	0.709805979093015	1	1	4	2218	7902	0.912573231185219
IPR002653	Zinc finger, A20-type	  6	1	1	0	6	2219	7900	0
IPR002659	Glycosyl transferase, family 31	  9	0.892199115824019	1	1	8	2218	7898	0.506985128436233
IPR002710	Dilute domain	  5	0.709805979093015	1	1	4	2218	7902	0.912573231185219
IPR002713	FF domain	  6	0.391653542140149	1	2	4	2217	7902	1.5209553853087
IPR002857	Zinc finger, CXXC-type	 10	0.380546254047252	1	3	7	2216	7899	1.36885984677783
IPR002867	IBR domain	 10	0.380546254047252	1	3	7	2216	7899	1.36885984677783
IPR002870	Peptidase M12B, propeptide	 17	0.309606220431718	1	5	12	2214	7894	1.34201945762532
IPR002884	Proprotein convertase, P	  5	0.302351833058719	1	2	3	2217	7903	1.82514646237044
IPR002885	Pentatricopeptide repeat	  7	0.475337159710437	1	2	5	2217	7901	1.30367604455031
IPR002890	Alpha-2-macroglobulin, N-terminal	  5	1	1	0	5	2219	7901	0
IPR002893	Zinc finger, MYND-type	 14	0.174228157169119	1	5	9	2214	7897	1.62959505568789
IPR002909	IPT domain	 21	0.994488557814674	1	1	20	2218	7886	0.217279340758385
IPR002913	START domain	 10	0.679378687010405	1	2	8	2217	7898	0.912573231185219
IPR002919	Trypsin Inhibitor-like, cysteine rich domain	  5	1	1	0	5	2219	7901	0
IPR002934	Polymerase, nucleotidyl transferase domain	  9	0.619612200417774	1	2	7	2217	7899	1.01397025687247
IPR002937	Amine oxidase	  8	0.861911680778881	1	1	7	2218	7899	0.570358269490762
IPR002938	FAD-binding domain	  5	0.302351833058719	1	2	3	2217	7903	1.82514646237044
IPR002939	Chaperone DnaJ, C-terminal	  7	1	1	0	7	2219	7899	0
IPR002957	Keratin, type I	  7	1	1	0	7	2219	7899	0
IPR002999	Tudor domain	 18	0.00190218288684691	0.316656565736196	10	8	2209	7898	2.53492564218116
IPR003006	Immunoglobulin/major histocompatibility complex, conserved site	 19	0.94258296566969	1	2	17	2217	7889	0.480301700623799
IPR003008	Tubulin/FtsZ, GTPase domain	 14	0.968755884502962	1	1	13	2218	7893	0.325919011137578
IPR003010	Carbon-nitrogen hydrolase	  5	0.709805979093015	1	1	4	2218	7902	0.912573231185219
IPR003019	Metallothionein	  7	1	1	0	7	2219	7899	0
IPR003020	Bicarbonate transporter, eukaryotic	  5	0.302351833058719	1	2	3	2217	7903	1.82514646237044
IPR003029	S1 domain	  6	0.12374841489586	1	3	3	2216	7903	2.28143307796305
IPR003034	SAP domain	 17	0.148781103452951	1	6	11	2213	7895	1.61042334915039
IPR003096	Smooth muscle protein/calponin	  7	0.823119684279113	1	1	6	2218	7900	0.651838022275156
IPR003100	PAZ domain	  6	0.12374841489586	1	3	3	2216	7903	2.28143307796305
IPR003107	HAT (Half-A-TPR) repeat	  8	0.55157570878074	1	2	6	2217	7900	1.14071653898152
IPR003108	Gas2-related domain	  5	0.00949538537636216	0.369707424169972	4	1	2215	7905	3.65029292474087
IPR003109	GoLoco motif	  5	0.709805979093015	1	1	4	2218	7902	0.912573231185219
IPR003110	Phosphorylated immunoreceptor signalling ITAM	  5	1	1	0	5	2219	7901	0
IPR003111	Lon, substrate-binding domain	  5	0.709805979093015	1	1	4	2218	7902	0.912573231185219
IPR003112	Olfactomedin-like domain	 10	0.380546254047252	1	3	7	2216	7899	1.36885984677783
IPR003116	Raf-like Ras-binding	  7	0.823119684279113	1	1	6	2218	7900	0.651838022275156
IPR003117	cAMP-dependent protein kinase regulatory subunit, dimerization-anchoring domain	  8	0.55157570878074	1	2	6	2217	7900	1.14071653898152
IPR003118	Pointed domain	  6	0.773436466483588	1	1	5	2218	7901	0.760477692654349
IPR003123	VPS9 domain	  7	1	1	0	7	2219	7899	0
IPR003124	WH2 domain	 14	0.621193007259644	1	3	11	2216	7895	0.977757033412734
IPR003126	Zinc finger, UBR-type	  6	0.12374841489586	1	3	3	2216	7903	2.28143307796305
IPR003128	Villin headpiece	  5	1	1	0	5	2219	7901	0
IPR003130	Dynamin GTPase effector	  5	0.709805979093015	1	1	4	2218	7902	0.912573231185219
IPR003131	Potassium channel tetramerisation-type BTB domain	 32	0.402686836003778	1	8	24	2211	7882	1.14071653898152
IPR003137	PA domain	 12	0.258504508417295	1	4	8	2215	7898	1.5209553853087
IPR003152	FATC domain	  5	0.302351833058719	1	2	3	2217	7903	1.82514646237044
IPR003191	Guanylate-binding protein, C-terminal	  6	1	1	0	6	2219	7900	0
IPR003280	Two pore domain potassium channel	  6	0.12374841489586	1	3	3	2216	7903	2.28143307796305
IPR003307	W2 domain	  5	0.709805979093015	1	1	4	2218	7902	0.912573231185219
IPR003309	SCAN domain	 28	0.140534611744171	1	9	19	2210	7887	1.4666355501191
IPR003323	OTU domain	 11	0.934307333144729	1	1	10	2218	7896	0.414806014175099
IPR003347	JmjC domain	 24	0.434657531857575	1	6	18	2213	7888	1.14071653898152
IPR003349	JmjN domain	  8	0.55157570878074	1	2	6	2217	7900	1.14071653898152
IPR003350	CUT domain	  5	0.0736454441167817	0.979653214422437	3	2	2216	7904	2.73771969355566
IPR003378	Fringe-like	  5	1	1	0	5	2219	7901	0
IPR003395	RecF/RecN/SMC, N-terminal	  6	0.00247184139569171	0.316656565736196	5	1	2214	7905	3.80238846327174
IPR003397	Mitochondrial inner membrane translocase subunit Tim17/Tim22/Tim23/peroxisomal protein PMP24	  6	0.773436466483588	1	1	5	2218	7901	0.760477692654349
IPR003409	MORN motif	  8	1	1	0	8	2219	7898	0
IPR003439	ABC transporter-like	 28	0.00341055124653733	0.316656565736196	13	15	2206	7891	2.11847357239426
IPR003527	Mitogen-activated protein (MAP) kinase, conserved site	  9	0.892199115824019	1	1	8	2218	7898	0.506985128436233
IPR003529	Long hematopoietin receptor, Gp130 family 2, conserved site	  7	0.475337159710437	1	2	5	2217	7901	1.30367604455031
IPR003585	Neurexin/syndecan/glycophorin C	 13	0.813698203333979	1	2	11	2217	7895	0.701979408604014
IPR003591	Leucine-rich repeat, typical subtype	100	0.909122668129844	1	17	83	2202	7823	0.775687246507436
IPR003593	AAA+ ATPase domain	 87	0.00913765315877912	0.369707424169972	29	58	2190	7848	1.5209553853087
IPR003594	Histidine kinase-like ATPase, C-terminal domain	 18	0.184007340986686	1	6	12	2213	7894	1.5209553853087
IPR003595	Protein-tyrosine phosphatase, catalytic	 50	0.797564402937657	1	9	41	2210	7865	0.821315908066697
IPR003597	Immunoglobulin C1-set	 22	0.969070139921367	1	2	20	2217	7886	0.414806014175099
IPR003603	U2A'/phosphoprotein 32 family A, C-terminal	  5	0.0736454441167817	0.979653214422437	3	2	2216	7904	2.73771969355566
IPR003604	Matrin/U1-C-like, C2H2-type zinc finger	 23	0.391190850015152	1	6	17	2213	7889	1.19031291024159
IPR003605	GS domain	  7	1	1	0	7	2219	7899	0
IPR003607	HD/PDEase domain	 16	0.00288324485961926	0.316656565736196	9	7	2210	7899	2.56661221270843
IPR003613	U box domain	  7	0.823119684279113	1	1	6	2218	7900	0.651838022275156
IPR003616	Post-SET domain	 11	0.0711357956244884	0.979653214422437	5	6	2214	7900	2.0740300708755
IPR003619	MAD homology 1, Dwarfin-type	 11	0.446044178306205	1	3	8	2216	7898	1.2444180425253
IPR003644	Na-Ca exchanger/integrin-beta4	  8	1	1	0	8	2219	7898	0
IPR003645	Follistatin-like, N-terminal	  7	0.475337159710437	1	2	5	2217	7901	1.30367604455031
IPR003649	B-box, C-terminal	 10	0.380546254047252	1	3	7	2216	7899	1.36885984677783
IPR003650	Orange domain	  9	1	1	0	9	2219	7897	0
IPR003653	Ulp1 protease family, C-terminal catalytic domain	  6	0.12374841489586	1	3	3	2216	7903	2.28143307796305
IPR003654	OAR domain	  6	1	1	0	6	2219	7900	0
IPR003656	Zinc finger, BED-type	  6	0.023542473337703	0.604590751459735	4	2	2215	7904	3.0419107706174
IPR003663	Sugar/inositol transporter	  8	1	1	0	8	2219	7898	0
IPR003689	Zinc/iron permease	 12	0.775765479746437	1	2	10	2217	7896	0.760477692654349
IPR003859	Beta-1,4-galactosyltransferase	  5	1	1	0	5	2219	7901	0
IPR003877	SPRY domain	 37	0.851743439328782	1	6	31	2213	7875	0.739924241501529
IPR003879	Butyrophylin-like	 17	0.754393859719995	1	3	14	2216	7892	0.805211674575193
IPR003887	LEM domain	  5	1	1	0	5	2219	7901	0
IPR003890	MIF4G-like, type 3	  7	0.823119684279113	1	1	6	2218	7900	0.651838022275156
IPR003892	Ubiquitin system component Cue	 10	0.380546254047252	1	3	7	2216	7899	1.36885984677783
IPR003894	TAFH/NHR1	  5	0.302351833058719	1	2	3	2217	7903	1.82514646237044
IPR003903	Ubiquitin interacting motif	 17	0.148781103452951	1	6	11	2213	7895	1.61042334915039
IPR003938	Potassium channel, voltage-dependent, EAG/ELK/ERG	  7	0.823119684279113	1	1	6	2218	7900	0.651838022275156
IPR003954	RNA recognition motif domain, eukaryote	 17	0.0188542043214767	0.604590751459735	8	9	2211	7897	2.14723113220051
IPR003958	Transcription factor CBF/NF-Y/archaeal histone domain	  6	0.773436466483588	1	1	5	2218	7901	0.760477692654349
IPR003959	ATPase, AAA-type, core	 39	0.492676738071747	1	9	30	2210	7876	1.05296911290602
IPR003960	ATPase, AAA-type, conserved site	 23	0.391190850015152	1	6	17	2213	7889	1.19031291024159
IPR003968	Potassium channel, voltage dependent, Kv	 18	0.579235824403936	1	4	14	2215	7892	1.01397025687247
IPR003971	Potassium channel, voltage dependent, Kv9	  5	1	1	0	5	2219	7901	0
IPR003987	Intercellular adhesion molecule/vascular cell adhesion molecule, N-terminal	  5	1	1	0	5	2219	7901	0
IPR004000	Actin family	 15	0.975612841508988	1	1	14	2218	7892	0.30419107706174
IPR004001	Actin, conserved site	  9	1	1	0	9	2219	7897	0
IPR004012	RUN domain	 12	0.775765479746437	1	2	10	2217	7896	0.760477692654349
IPR004014	Cation-transporting P-type ATPase, N-terminal	 11	0.731230800055783	1	2	9	2217	7897	0.829612028350199
IPR004018	RPEL repeat	  5	0.709805979093015	1	1	4	2218	7902	0.912573231185219
IPR004020	DAPIN domain	  6	1	1	0	6	2219	7900	0
IPR004031	PMP-22/EMP/MP20/Claudin superfamily	 19	0.94258296566969	1	2	17	2217	7889	0.480301700623799
IPR004045	Glutathione S-transferase, N-terminal	 11	1	1	0	11	2219	7895	0
IPR004046	Glutathione S-transferase, C-terminal	 10	0.915845830136643	1	1	9	2218	7897	0.456286615592609
IPR004061	Sphingosine 1-phosphate receptor	  5	1	1	0	5	2219	7901	0
IPR004087	K Homology domain	 24	0.434657531857575	1	6	18	2213	7888	1.14071653898152
IPR004088	K Homology domain, type 1	 27	0.377768124512192	1	7	20	2212	7886	1.18296529968454
IPR004092	Mbt repeat	  7	0.00708410048765289	0.369707424169972	5	2	2214	7904	3.25919011137578
IPR004099	Pyridine nucleotide-disulphide oxidoreductase, dimerisation domain	  5	0.709805979093015	1	1	4	2218	7902	0.912573231185219
IPR004100	ATPase, F1/V1/A1 complex, alpha/beta subunit, N-terminal domain	  5	1	1	0	5	2219	7901	0
IPR004148	BAR domain	 13	0.135221236843926	1	5	8	2214	7898	1.75494852151004
IPR004154	Anticodon-binding	  9	0.619612200417774	1	2	7	2217	7899	1.01397025687247
IPR004156	Organic anion transporter polypeptide OATP	  5	0.302351833058719	1	2	3	2217	7903	1.82514646237044
IPR004160	Translation elongation factor EFTu/EF1A, C-terminal	  5	0.709805979093015	1	1	4	2218	7902	0.912573231185219
IPR004161	Translation elongation factor EFTu-like, domain 2	 11	0.731230800055783	1	2	9	2217	7897	0.829612028350199
IPR004170	WWE domain	 13	0.959972064372729	1	1	12	2218	7894	0.350989704302007
IPR004172	L27 domain	  9	0.619612200417774	1	2	7	2217	7899	1.01397025687247
IPR004177	DDHD domain	  6	0.773436466483588	1	1	5	2218	7901	0.760477692654349
IPR004182	GRAM domain	 17	0.914113969866565	1	2	15	2217	7891	0.536807783050129
IPR004198	Zinc finger, C5HC2-type	  5	1	1	0	5	2219	7901	0
IPR004241	Autophagy protein Atg8 ubiquitin-like	  5	1	1	0	5	2219	7901	0
IPR004254	AdipoR/Haemolysin-III-related	  8	0.861911680778881	1	1	7	2218	7899	0.570358269490762
IPR004273	Dynein heavy chain domain	  6	0.023542473337703	0.604590751459735	4	2	2215	7904	3.0419107706174
IPR004274	FCP1 homology domain	  7	0.475337159710437	1	2	5	2217	7901	1.30367604455031
IPR004299	Membrane bound O-acyl transferase, MBOAT	  5	0.302351833058719	1	2	3	2217	7903	1.82514646237044
IPR004328	BRO1 domain	  5	0.302351833058719	1	2	3	2217	7903	1.82514646237044
IPR004344	Tubulin-tyrosine ligase/Tubulin polyglutamylase	  7	0.823119684279113	1	1	6	2218	7900	0.651838022275156
IPR004345	TB2/DP1/HVA22-related protein	  5	0.302351833058719	1	2	3	2217	7903	1.82514646237044
IPR004365	OB-fold nucleic acid binding domain, AA-tRNA synthetase-type	  7	1	1	0	7	2219	7899	0
IPR004367	Cyclin, C-terminal domain	 10	0.679378687010405	1	2	8	2217	7898	0.912573231185219
IPR004749	Organic cation transport protein/SVOP	  6	1	1	0	6	2219	7900	0
IPR004826	Basic leucine zipper domain, Maf-type	  7	0.823119684279113	1	1	6	2218	7900	0.651838022275156
IPR004827	Basic-leucine zipper domain	 39	0.645897528656629	1	8	31	2211	7875	0.935972544805352
IPR004837	Sodium/calcium exchanger membrane region	  6	0.773436466483588	1	1	5	2218	7901	0.760477692654349
IPR004839	Aminotransferase, class I/classII	 10	0.156885367393478	1	4	6	2215	7900	1.82514646237044
IPR004841	Amino acid permease/ SLC12A domain	  6	0.773436466483588	1	1	5	2218	7901	0.760477692654349
IPR004843	Calcineurin-like phosphoesterase domain, ApaH type	 18	0.789425466783207	1	3	15	2216	7891	0.760477692654349
IPR004853	Sugar phosphate transporter domain	  8	0.246621512499529	1	3	5	2216	7901	1.71107480847228
IPR004875	DDE superfamily endonuclease domain	  6	0.391653542140149	1	2	4	2217	7902	1.5209553853087
IPR004910	Yippee/Mis18/Cereblon	  7	1	1	0	7	2219	7899	0
IPR004939	APC10/DOC domain	  5	0.709805979093015	1	1	4	2218	7902	0.912573231185219
IPR005024	Snf7 family	  7	0.475337159710437	1	2	5	2217	7901	1.30367604455031
IPR005108	HELP	  6	0.12374841489586	1	3	3	2216	7903	2.28143307796305
IPR005112	dDENN domain	 13	0.313297073561014	1	4	9	2215	7897	1.40395881720803
IPR005113	uDENN domain	 13	0.313297073561014	1	4	9	2215	7897	1.40395881720803
IPR005123	Oxoglutarate/iron-dependent dioxygenase	 14	0.968755884502962	1	1	13	2218	7893	0.325919011137578
IPR005135	Endonuclease/exonuclease/phosphatase	 13	0.813698203333979	1	2	11	2217	7895	0.701979408604014
IPR005176	Potentiating neddylation domain	  5	0.302351833058719	1	2	3	2217	7903	1.82514646237044
IPR005331	Sulfotransferase	  8	0.861911680778881	1	1	7	2218	7899	0.570358269490762
IPR005467	Histidine kinase domain	  5	0.709805979093015	1	1	4	2218	7902	0.912573231185219
IPR005475	Transketolase-like, pyrimidine-binding domain	  7	0.823119684279113	1	1	6	2218	7900	0.651838022275156
IPR005479	Carbamoyl-phosphate synthetase large subunit-like, ATP-binding domain	  5	0.709805979093015	1	1	4	2218	7902	0.912573231185219
IPR005522	Inositol polyphosphate kinase	  6	0.773436466483588	1	1	5	2218	7901	0.760477692654349
IPR005804	Fatty acid desaturase domain	  6	0.391653542140149	1	2	4	2217	7902	1.5209553853087
IPR005817	Wnt	  6	0.773436466483588	1	1	5	2218	7901	0.760477692654349
IPR005818	Linker histone H1/H5, domain H15	  6	0.391653542140149	1	2	4	2217	7902	1.5209553853087
IPR005821	Ion transport domain	 60	0.226948535187953	1	16	44	2203	7862	1.21676430824696
IPR005828	Major facilitator,  sugar transporter-like	 22	0.969070139921367	1	2	20	2217	7886	0.414806014175099
IPR005829	Sugar transporter, conserved site	 19	0.990950756922267	1	1	18	2218	7888	0.2401508503119
IPR005843	Alpha-D-phosphohexomutase, C-terminal	  5	0.302351833058719	1	2	3	2217	7903	1.82514646237044
IPR005844	Alpha-D-phosphohexomutase, alpha/beta/alpha domain I	  5	0.302351833058719	1	2	3	2217	7903	1.82514646237044
IPR005937	26S proteasome subunit P45	  5	1	1	0	5	2219	7901	0
IPR006011	Syntaxin, N-terminal domain	  9	0.619612200417774	1	2	7	2217	7899	1.01397025687247
IPR006012	Syntaxin/epimorphin, conserved site	 11	0.731230800055783	1	2	9	2217	7897	0.829612028350199
IPR006020	PTB/PI domain	 34	0.787061389194133	1	6	28	2213	7878	0.805211674575193
IPR006026	Peptidase, metallopeptidase	  9	1	1	0	9	2219	7897	0
IPR006028	Gamma-aminobutyric acid A receptor/Glycine receptor alpha	 11	0.731230800055783	1	2	9	2217	7897	0.829612028350199
IPR006029	Neurotransmitter-gated ion-channel transmembrane domain	 16	0.89532336867285	1	2	14	2217	7892	0.570358269490762
IPR006052	Tumour necrosis factor domain	  5	0.709805979093015	1	1	4	2218	7902	0.912573231185219
IPR006068	Cation-transporting P-type ATPase, C-terminal	 10	0.679378687010405	1	2	8	2217	7898	0.912573231185219
IPR006073	GTP binding domain	 18	0.0275477744664086	0.678574771039901	8	10	2211	7896	2.02794051374493
IPR006076	FAD dependent oxidoreductase	  7	0.182444498214428	1	3	4	2216	7902	1.95551406682547
IPR006077	Vinculin/alpha-catenin	  6	0.391653542140149	1	2	4	2217	7902	1.5209553853087
IPR006089	Acyl-CoA dehydrogenase, conserved site	  7	0.475337159710437	1	2	5	2217	7901	1.30367604455031
IPR006091	Acyl-CoA oxidase/dehydrogenase, central domain	 11	0.731230800055783	1	2	9	2217	7897	0.829612028350199
IPR006116	2-5-oligoadenylate synthetase, N-terminal	  5	1	1	0	5	2219	7901	0
IPR006153	Cation/H+ exchanger	  6	0.773436466483588	1	1	5	2218	7901	0.760477692654349
IPR006186	Serine/threonine-specific protein phosphatase/bis(5-nucleosyl)-tetraphosphatase	 10	0.915845830136643	1	1	9	2218	7897	0.456286615592609
IPR006187	Claudin	  5	1	1	0	5	2219	7901	0
IPR006195	Aminoacyl-tRNA synthetase, class II	 13	0.813698203333979	1	2	11	2217	7895	0.701979408604014
IPR006201	Neurotransmitter-gated ion-channel	 16	0.89532336867285	1	2	14	2217	7892	0.570358269490762
IPR006202	Neurotransmitter-gated ion-channel ligand-binding domain	 16	0.89532336867285	1	2	14	2217	7892	0.570358269490762
IPR006207	Cystine knot, C-terminal	 14	0.968755884502962	1	1	13	2218	7893	0.325919011137578
IPR006208	Glycoprotein hormone subunit beta, cystine knot	  6	1	1	0	6	2219	7900	0
IPR006211	Furin-like cysteine-rich domain	  6	0.391653542140149	1	2	4	2217	7902	1.5209553853087
IPR006212	Furin-like repeat	 14	0.368924640117772	1	4	10	2215	7896	1.30367604455031
IPR006214	Bax inhibitor 1-related	  6	0.391653542140149	1	2	4	2217	7902	1.5209553853087
IPR006439	HAD hydrolase, subfamily IA	  5	1	1	0	5	2219	7901	0
IPR006539	P-type ATPase, subfamily IV	 12	0.0298210177690119	0.6791314801358	6	6	2213	7900	2.28143307796305
IPR006553	Leucine-rich repeat, cysteine-containing subtype	 15	0.216879992767108	1	5	10	2214	7896	1.5209553853087
IPR006560	AWS domain	  5	0.709805979093015	1	1	4	2218	7902	0.912573231185219
IPR006561	DZF domain	  5	0.709805979093015	1	1	4	2218	7902	0.912573231185219
IPR006569	CID domain	  8	0.00203988085847661	0.316656565736196	6	2	2213	7904	3.42214961694457
IPR006574	SPRY-associated	 13	0.567135500014957	1	3	10	2216	7896	1.05296911290602
IPR006575	RWD domain	  9	0.892199115824019	1	1	8	2218	7898	0.506985128436233
IPR006581	VPS10	  5	0.709805979093015	1	1	4	2218	7902	0.912573231185219
IPR006586	ADAM, cysteine-rich	 11	0.446044178306205	1	3	8	2216	7898	1.2444180425253
IPR006594	LIS1 homology motif	 25	0.477533768566566	1	6	19	2213	7887	1.09508787742226
IPR006595	CTLH, C-terminal LisH motif	  9	0.31344798805112	1	3	6	2216	7900	1.5209553853087
IPR006597	Sel1-like repeat	  7	0.0454869704711032	0.84838322906845	4	3	2215	7903	2.60735208910062
IPR006600	HTH CenpB-type DNA-binding domain	  7	0.182444498214428	1	3	4	2216	7902	1.95551406682547
IPR006612	Zinc finger, C2CH-type	  7	0.823119684279113	1	1	6	2218	7900	0.651838022275156
IPR006615	Peptidase C19, ubiquitin-specific peptidase, DUSP domain	  7	0.182444498214428	1	3	4	2216	7902	1.95551406682547
IPR006620	Prolyl 4-hydroxylase, alpha subunit	 11	1	1	0	11	2219	7895	0
IPR006630	RNA-binding protein Lupus La	  7	0.00708410048765289	0.369707424169972	5	2	2214	7904	3.25919011137578
IPR006634	TRAM/LAG1/CLN8 homology domain	 14	0.621193007259644	1	3	11	2216	7895	0.977757033412734
IPR006636	Heat shock chaperonin-binding	  6	0.773436466483588	1	1	5	2218	7901	0.760477692654349
IPR006639	Presenilin/signal peptide peptidase	  6	0.12374841489586	1	3	3	2216	7903	2.28143307796305
IPR006652	Kelch repeat type 1	 40	0.89937196484307	1	6	34	2213	7872	0.684429923388914
IPR006671	Cyclin, N-terminal	 21	0.30453009912868	1	6	15	2213	7891	1.30367604455031
IPR006680	Amidohydrolase-related	  7	1	1	0	7	2219	7899	0
IPR006689	Small GTPase superfamily, ARF/SAR type	 17	0.530053081593445	1	4	13	2215	7893	1.07361556610026
IPR006694	Fatty acid hydroxylase	  5	1	1	0	5	2219	7901	0
IPR006703	AIG1-type guanine nucleotide-binding (G) domain	  6	1	1	0	6	2219	7900	0
IPR006903	RNA polymerase II-binding domain	  7	0.00708410048765289	0.369707424169972	5	2	2214	7904	3.25919011137578
IPR006911	Armadillo repeat-containing domain	  9	0.892199115824019	1	1	8	2218	7898	0.506985128436233
IPR006977	Yip1 domain	  5	0.709805979093015	1	1	4	2218	7902	0.912573231185219
IPR007052	CS domain	 12	0.508557401602509	1	3	9	2216	7897	1.14071653898152
IPR007053	LRAT-like domain	  6	0.391653542140149	1	2	4	2217	7902	1.5209553853087
IPR007111	NACHT nucleoside triphosphatase	  5	0.709805979093015	1	1	4	2218	7902	0.912573231185219
IPR007122	Villin/Gelsolin	  5	1	1	0	5	2219	7901	0
IPR007123	Gelsolin-like domain	  9	0.619612200417774	1	2	7	2217	7899	1.01397025687247
IPR007125	Histone H2A/H2B/H3	 12	0.258504508417295	1	4	8	2215	7898	1.5209553853087
IPR007237	CD20-like family	  9	1	1	0	9	2219	7897	0
IPR007330	MIT	 12	0.508557401602509	1	3	9	2216	7897	1.14071653898152
IPR007484	Peptidase M28	  6	0.391653542140149	1	2	4	2217	7902	1.5209553853087
IPR007502	Helicase-associated domain	 12	0.775765479746437	1	2	10	2217	7896	0.760477692654349
IPR007529	Zinc finger, HIT-type	  5	0.709805979093015	1	1	4	2218	7902	0.912573231185219
IPR007593	CD225/Dispanin family	  8	1	1	0	8	2219	7898	0
IPR007623	Brain-expressed X-linked protein	  5	0.709805979093015	1	1	4	2218	7902	0.912573231185219
IPR007632	Anoctamin	  5	0.709805979093015	1	1	4	2218	7902	0.912573231185219
IPR007863	Peptidase M16, C-terminal	  7	0.182444498214428	1	3	4	2216	7902	1.95551406682547
IPR007875	Sprouty	  5	0.709805979093015	1	1	4	2218	7902	0.912573231185219
IPR007889	DNA binding HTH domain, Psq-type	  7	0.182444498214428	1	3	4	2216	7902	1.95551406682547
IPR008011	Complex 1 LYR protein	  9	0.112968561396348	1	4	5	2215	7901	2.02794051374493
IPR008144	Guanylate kinase-like domain	 16	0.980965473031397	1	1	15	2218	7891	0.285179134745381
IPR008145	Guanylate kinase/L-type calcium channel beta subunit	 19	0.990950756922267	1	1	18	2218	7888	0.2401508503119
IPR008152	Clathrin adaptor, alpha/beta/gamma-adaptin, appendage, Ig-like subdomain	  7	1	1	0	7	2219	7899	0
IPR008160	Collagen triple helix repeat	 39	0.492676738071747	1	9	30	2210	7876	1.05296911290602
IPR008211	Laminin, N-terminal	 12	0.94872022890821	1	1	11	2218	7895	0.380238846327174
IPR008250	P-type ATPase, A  domain	 26	0.19263471975536	1	8	18	2211	7888	1.40395881720803
IPR008253	Marvel domain	 18	0.789425466783207	1	3	15	2216	7891	0.760477692654349
IPR008266	Tyrosine-protein kinase, active site	 56	0.945244535283333	1	8	48	2211	7858	0.651838022275156
IPR008280	Tubulin/FtsZ, C-terminal	 14	0.968755884502962	1	1	13	2218	7893	0.325919011137578
IPR008343	Mitogen-activated protein (MAP) kinase phosphatase	  9	0.619612200417774	1	2	7	2217	7899	1.01397025687247
IPR008405	Apolipoprotein L	  5	1	1	0	5	2219	7901	0
IPR008422	Homeobox KN domain	  7	0.475337159710437	1	2	5	2217	7901	1.30367604455031
IPR008428	Chondroitin N-acetylgalactosaminyltransferase	  6	1	1	0	6	2219	7900	0
IPR008598	Drought induced 19 protein type, zinc-binding domain	  7	0.182444498214428	1	3	4	2216	7902	1.95551406682547
IPR008916	Retrovirus capsid, C-terminal	 28	0.140534611744171	1	9	19	2210	7887	1.4666355501191
IPR008917	Transcription factor, Skn-1-like, DNA-binding domain	 10	0.915845830136643	1	1	9	2218	7897	0.456286615592609
IPR008921	DNA polymerase III, clamp loader complex, gamma/delta/delta subunit, C-terminal	  5	0.302351833058719	1	2	3	2217	7903	1.82514646237044
IPR008927	6-phosphogluconate dehydrogenase C-terminal domain-like	  7	0.475337159710437	1	2	5	2217	7901	1.30367604455031
IPR008928	Six-hairpin glycosidase-like	  5	0.709805979093015	1	1	4	2218	7902	0.912573231185219
IPR008930	Terpenoid cyclases/protein prenyltransferase alpha-alpha toroid	 10	0.679378687010405	1	2	8	2217	7898	0.912573231185219
IPR008936	Rho GTPase activation protein	 63	0.405736636471448	1	15	48	2204	7858	1.08639670379193
IPR008942	ENTH/VHS	 22	0.0034095149915416	0.316656565736196	11	11	2208	7895	2.28143307796305
IPR008949	Isoprenoid synthase domain	  5	0.709805979093015	1	1	4	2218	7902	0.912573231185219
IPR008952	Tetraspanin, EC2 domain	 19	0.94258296566969	1	2	17	2217	7889	0.480301700623799
IPR008954	Moesin tail domain	  5	0.0736454441167817	0.979653214422437	3	2	2216	7904	2.73771969355566
IPR008962	PapD-like	  8	0.246621512499529	1	3	5	2216	7901	1.71107480847228
IPR008967	p53-like transcription factor, DNA-binding	 25	0.830301203971307	1	4	21	2215	7885	0.730058584948175
IPR008969	Carboxypeptidase-like, regulatory domain	  8	0.861911680778881	1	1	7	2218	7899	0.570358269490762
IPR008971	HSP40/DnaJ peptide-binding	  7	1	1	0	7	2219	7899	0
IPR008972	Cupredoxin	  8	0.55157570878074	1	2	6	2217	7900	1.14071653898152
IPR008974	TRAF-like	 16	0.89532336867285	1	2	14	2217	7892	0.570358269490762
IPR008978	HSP20-like chaperone	 18	0.789425466783207	1	3	15	2216	7891	0.760477692654349
IPR008979	Galactose-binding domain-like	 52	0.607115764334535	1	11	41	2208	7865	0.96522168683052
IPR008983	Tumour necrosis factor-like domain	 20	0.847043894921231	1	3	17	2216	7889	0.684429923388914
IPR008984	SMAD/FHA domain	 38	0.458486838840462	1	9	29	2210	7877	1.08067882640355
IPR008993	Tissue inhibitor of metalloproteinases-like, OB-fold	 14	1	1	0	14	2219	7892	0
IPR008996	Cytokine IL1/FGF	  8	0.55157570878074	1	2	6	2217	7900	1.14071653898152
IPR009000	Translation protein, beta-barrel domain	 18	0.357913481756731	1	5	13	2214	7893	1.26746282109058
IPR009001	Translation elongation factor EF1A/initiation factor IF2gamma, C-terminal	  8	0.55157570878074	1	2	6	2217	7900	1.14071653898152
IPR009003	Peptidase S1, PA clan	 40	0.999394182072753	1	2	38	2217	7868	0.228143307796305
IPR009008	Valyl/Leucyl/Isoleucyl-tRNA synthetase, editing domain	  5	0.302351833058719	1	2	3	2217	7903	1.82514646237044
IPR009011	Mannose-6-phosphate receptor binding domain	  8	0.246621512499529	1	3	5	2216	7901	1.71107480847228
IPR009020	Protease propeptides/proteinase inhibitor I9	  7	0.475337159710437	1	2	5	2217	7901	1.30367604455031
IPR009028	Coatomer/calthrin adaptor appendage, C-terminal subdomain	  5	1	1	0	5	2219	7901	0
IPR009030	Growth factor receptor cysteine-rich domain	 90	0.972626176320998	1	13	77	2206	7829	0.659080666967102
IPR009038	GOLD domain	 12	0.508557401602509	1	3	9	2216	7897	1.14071653898152
IPR009048	Alpha-macroglobulin, receptor-binding	  5	1	1	0	5	2219	7901	0
IPR009060	UBA-like	 38	0.458486838840462	1	9	29	2210	7877	1.08067882640355
IPR009061	Putative DNA-binding domain	  6	0.391653542140149	1	2	4	2217	7902	1.5209553853087
IPR009068	S15/NS1, RNA-binding	  6	1	1	0	6	2219	7900	0
IPR009071	High mobility group box domain	 37	0.731390117919753	1	7	30	2212	7876	0.86324494841845
IPR009072	Histone-fold	 31	0.702839917312803	1	6	25	2213	7881	0.883135385017953
IPR009075	Acyl-CoA dehydrogenase/oxidase C-terminal	 11	0.731230800055783	1	2	9	2217	7897	0.829612028350199
IPR009078	Ferritin-like superfamily	  5	1	1	0	5	2219	7901	0
IPR009079	Four-helical cytokine-like, core	  7	1	1	0	7	2219	7899	0
IPR009080	Aminoacyl-tRNA synthetase, class Ia, anticodon-binding	 12	0.258504508417295	1	4	8	2215	7898	1.5209553853087
IPR009091	Regulator of chromosome condensation 1/beta-lactamase-inhibitor protein II	 19	0.101467739000547	1	7	12	2212	7894	1.6810559521833
IPR009100	Acyl-CoA dehydrogenase/oxidase, N-terminal and middle domain	 11	0.731230800055783	1	2	9	2217	7897	0.829612028350199
IPR009168	Insulin-like growth factor binding protein	  5	0.709805979093015	1	1	4	2218	7902	0.912573231185219
IPR009398	Adenylate cyclase, conserved domain	  6	1	1	0	6	2219	7900	0
IPR009818	Ataxin-2, C-terminal	  8	0.246621512499529	1	3	5	2216	7901	1.71107480847228
IPR010294	ADAM-TS Spacer 1	 12	0.94872022890821	1	1	11	2218	7895	0.380238846327174
IPR010472	Formin, FH3 domain	  6	0.391653542140149	1	2	4	2217	7902	1.5209553853087
IPR010473	Formin, GTPase-binding domain	  6	0.391653542140149	1	2	4	2217	7902	1.5209553853087
IPR010506	DMAP1-binding domain	  6	0.391653542140149	1	2	4	2217	7902	1.5209553853087
IPR010507	Zinc finger, MYM-type	  5	0.302351833058719	1	2	3	2217	7903	1.82514646237044
IPR010526	Sodium ion transport-associated	  5	1	1	0	5	2219	7901	0
IPR010569	Myotubularin-like phosphatase domain	 14	0.845782402679702	1	2	12	2217	7894	0.651838022275156
IPR010622	FAST kinase leucine-rich	  5	1	1	0	5	2219	7901	0
IPR010625	CHCH	  6	1	1	0	6	2219	7900	0
IPR010703	Dedicator of cytokinesis, C-terminal	  9	0.112968561396348	1	4	5	2215	7901	2.02794051374493
IPR010734	Copine	  8	0.55157570878074	1	2	6	2217	7900	1.14071653898152
IPR010908	Longin domain	  5	0.302351833058719	1	2	3	2217	7903	1.82514646237044
IPR010909	PLAC	 10	0.915845830136643	1	1	9	2218	7897	0.456286615592609
IPR010911	Rab-binding domain	  8	0.861911680778881	1	1	7	2218	7899	0.570358269490762
IPR010919	SAND domain-like	  5	0.709805979093015	1	1	4	2218	7902	0.912573231185219
IPR010920	LSM domain	 13	0.313297073561014	1	4	9	2215	7897	1.40395881720803
IPR010926	Class I myosin tail homology domain	  5	0.302351833058719	1	2	3	2217	7903	1.82514646237044
IPR010935	SMCs flexible hinge	  5	0.00949538537636216	0.369707424169972	4	1	2215	7905	3.65029292474087
IPR010982	Lambda repressor-like, DNA-binding domain	 10	0.156885367393478	1	4	6	2215	7900	1.82514646237044
IPR010987	Glutathione S-transferase, C-terminal-like	 20	0.847043894921231	1	3	17	2216	7889	0.684429923388914
IPR010989	SNARE	 14	0.621193007259644	1	3	11	2216	7895	0.977757033412734
IPR010994	RuvA domain 2-like	  5	0.709805979093015	1	1	4	2218	7902	0.912573231185219
IPR011004	Trimeric LpxA-like	  6	1	1	0	6	2219	7900	0
IPR011008	Dimeric alpha-beta barrel	  6	1	1	0	6	2219	7900	0
IPR011011	Zinc finger, FYVE/PHD-type	 98	0.0458963696140901	0.84838322906845	29	69	2190	7837	1.35023590328425
IPR011012	Longin-like domain	 21	0.501228974502052	1	5	16	2214	7890	1.08639670379193
IPR011013	Galactose mutarotase-like domain	  8	0.246621512499529	1	3	5	2216	7901	1.71107480847228
IPR011015	LEM/LEM-like domain	  5	1	1	0	5	2219	7901	0
IPR011016	Zinc finger, RING-CH-type	 14	0.174228157169119	1	5	9	2214	7897	1.62959505568789
IPR011017	TRASH domain	  6	0.391653542140149	1	2	4	2217	7902	1.5209553853087
IPR011021	Arrestin-like, N-terminal	  5	1	1	0	5	2219	7901	0
IPR011022	Arrestin C-terminal-like domain	  5	1	1	0	5	2219	7901	0
IPR011025	G protein alpha subunit, helical insertion	 12	0.100646351235543	1	5	7	2214	7899	1.90119423163587
IPR011029	Death-like domain	 49	0.776839023378493	1	9	40	2210	7866	0.838077457210915
IPR011032	GroES-like	  9	0.619612200417774	1	2	7	2217	7899	1.01397025687247
IPR011040	Sialidases	  6	0.773436466483588	1	1	5	2218	7901	0.760477692654349
IPR011041	Soluble quinoprotein glucose/sorbosone dehydrogenase	  6	0.391653542140149	1	2	4	2217	7902	1.5209553853087
IPR011042	Six-bladed beta-propeller, TolB-like	 30	0.329024456942443	1	8	22	2211	7884	1.21676430824696
IPR011043	Galactose oxidase/kelch, beta-propeller	 11	0.446044178306205	1	3	8	2216	7898	1.2444180425253
IPR011044	Quinoprotein amine dehydrogenase, beta chain-like	  8	0.861911680778881	1	1	7	2218	7899	0.570358269490762
IPR011047	Quinoprotein alcohol dehydrogenase-like superfamily	 30	0.194028782389107	1	9	21	2210	7885	1.36885984677783
IPR011051	RmlC-like cupin domain	  6	1	1	0	6	2219	7900	0
IPR011053	Single hybrid motif	  8	0.246621512499529	1	3	5	2216	7901	1.71107480847228
IPR011059	Metal-dependent hydrolase, composite domain	  7	1	1	0	7	2219	7899	0
IPR011074	CRAL/TRIO, N-terminal domain	  9	0.31344798805112	1	3	6	2216	7900	1.5209553853087
IPR011146	HIT-like domain	  8	1	1	0	8	2219	7898	0
IPR011161	MHC class I-like antigen recognition-like	 10	1	1	0	10	2219	7896	0
IPR011162	MHC classes I/II-like antigen recognition protein	 17	1	1	0	17	2219	7889	0
IPR011249	Metalloenzyme, LuxS/M16 peptidase-like	  7	0.182444498214428	1	3	4	2216	7902	1.95551406682547
IPR011330	Glycoside hydrolase/deacetylase, beta/alpha-barrel	  5	0.0736454441167817	0.979653214422437	3	2	2216	7904	2.73771969355566
IPR011489	EMI domain	  7	0.823119684279113	1	1	6	2218	7900	0.651838022275156
IPR011500	GPCR, family 3, nine cysteines domain	  6	1	1	0	6	2219	7900	0
IPR011511	Variant SH3 domain	 43	0.621533334197659	1	9	34	2210	7872	0.955018497751973
IPR011524	SARAH domain	  8	0.861911680778881	1	1	7	2218	7899	0.570358269490762
IPR011527	ABC transporter type 1, transmembrane domain	 17	0.0188542043214767	0.604590751459735	8	9	2211	7897	2.14723113220051
IPR011531	Bicarbonate transporter, C-terminal	  5	0.302351833058719	1	2	3	2217	7903	1.82514646237044
IPR011539	Rel homology domain (RHD), DNA-binding domain	  9	1	1	0	9	2219	7897	0
IPR011545	DEAD/DEAH box helicase domain	 43	0.474961188847378	1	10	33	2209	7873	1.06113166416886
IPR011547	SLC26A/SulP transporter domain	  5	0.709805979093015	1	1	4	2218	7902	0.912573231185219
IPR011598	Myc-type, basic helix-loop-helix (bHLH) domain	 54	0.866233940617667	1	9	45	2210	7861	0.760477692654349
IPR011625	Alpha-2-macroglobulin, N-terminal 2	  5	1	1	0	5	2219	7901	0
IPR011626	Alpha-macroglobulin complement component	  5	1	1	0	5	2219	7901	0
IPR011641	Tyrosine-protein kinase ephrin type A/B receptor-like	 17	0.914113969866565	1	2	15	2217	7891	0.536807783050129
IPR011701	Major facilitator superfamily	 38	0.757791971634878	1	7	31	2212	7875	0.840527976091649
IPR011704	ATPase, dynein-related, AAA domain	  5	0.00949538537636216	0.369707424169972	4	1	2215	7905	3.65029292474087
IPR011705	BTB/Kelch-associated	 41	0.825592960713514	1	7	34	2212	7872	0.779025929060552
IPR011709	Domain of unknown function DUF1605	 11	0.731230800055783	1	2	9	2217	7897	0.829612028350199
IPR011761	ATP-grasp fold	 11	0.205885122690044	1	4	7	2215	7899	1.6592240567004
IPR011765	Peptidase M16, N-terminal	  7	0.182444498214428	1	3	4	2216	7902	1.95551406682547
IPR011948	Dullard phosphatase domain, eukaryotic	  5	0.302351833058719	1	2	3	2217	7903	1.82514646237044
IPR012163	Sialyltransferase	  7	0.475337159710437	1	2	5	2217	7901	1.30367604455031
IPR012317	Poly(ADP-ribose) polymerase, catalytic domain	 12	0.94872022890821	1	1	11	2218	7895	0.380238846327174
IPR012336	Thioredoxin-like fold	 73	0.756767469220373	1	14	59	2205	7847	0.875070221684456
IPR012337	Ribonuclease H-like domain	 44	0.020262518292992	0.604590751459735	16	28	2203	7878	1.6592240567004
IPR012340	Nucleic acid-binding, OB-fold	 47	0.599300700958059	1	10	37	2209	7869	0.970822586367254
IPR012345	STAT transcription factor, DNA-binding, subdomain	  6	0.391653542140149	1	2	4	2217	7902	1.5209553853087
IPR012674	Calycin	 15	0.872758486418599	1	2	13	2217	7893	0.608382154123479
IPR012675	Beta-grasp domain	  9	0.892199115824019	1	1	8	2218	7898	0.506985128436233
IPR012676	TGS-like	  6	0.773436466483588	1	1	5	2218	7901	0.760477692654349
IPR012896	Integrin beta subunit, tail	  5	1	1	0	5	2219	7901	0
IPR012921	Spen paralogue and orthologue SPOC, C-terminal	  5	0.302351833058719	1	2	3	2217	7903	1.82514646237044
IPR012983	PHR	  5	0.302351833058719	1	2	3	2217	7903	1.82514646237044
IPR013017	NHL repeat, subgroup	  5	0.709805979093015	1	1	4	2218	7902	0.912573231185219
IPR013019	MAD homology, MH1	  7	0.182444498214428	1	3	4	2216	7902	1.95551406682547
IPR013026	Tetratricopeptide repeat-containing domain	 92	0.00307171335605849	0.316656565736196	32	60	2187	7846	1.58708388032212
IPR013041	Coatomer/clathrin adaptor appendage, Ig-like subdomain	 10	0.915845830136643	1	1	9	2218	7897	0.456286615592609
IPR013057	Amino acid transporter, transmembrane domain	 11	0.934307333144729	1	1	10	2218	7896	0.414806014175099
IPR013078	Histidine phosphatase superfamily, clade-1	  6	1	1	0	6	2219	7900	0
IPR013088	Zinc finger, NHR/GATA-type	 33	0.439663446780917	1	8	25	2211	7881	1.1061493711336
IPR013092	Connexin, N-terminal	  9	0.892199115824019	1	1	8	2218	7898	0.506985128436233
IPR013098	Immunoglobulin I-set	 84	0.85042435686227	1	15	69	2204	7837	0.814797527843945
IPR013099	Potassium channel domain	 13	0.313297073561014	1	4	9	2215	7897	1.40395881720803
IPR013105	Tetratricopeptide repeat 2	 13	0.813698203333979	1	2	11	2217	7895	0.701979408604014
IPR013106	Immunoglobulin V-set domain	 82	0.982099409603875	1	11	71	2208	7835	0.61209180140472
IPR013111	EGF-like domain, extracellular	 15	0.872758486418599	1	2	13	2217	7893	0.608382154123479
IPR013126	Heat shock protein 70 family	 12	0.94872022890821	1	1	11	2218	7895	0.380238846327174
IPR013128	Peptidase C1A	  7	0.475337159710437	1	2	5	2217	7901	1.30367604455031
IPR013130	Ferric reductase transmembrane component-like domain	  7	1	1	0	7	2219	7899	0
IPR013144	CRA domain	  5	0.709805979093015	1	1	4	2218	7902	0.912573231185219
IPR013149	Alcohol dehydrogenase, C-terminal	  6	0.773436466483588	1	1	5	2218	7901	0.760477692654349
IPR013151	Immunoglobulin	 38	0.941502022837345	1	5	33	2214	7873	0.600377125779749
IPR013154	Alcohol dehydrogenase, N-terminal	  7	0.823119684279113	1	1	6	2218	7900	0.651838022275156
IPR013155	Methionyl/Valyl/Leucyl/Isoleucyl-tRNA synthetase, anticodon-binding	  5	0.302351833058719	1	2	3	2217	7903	1.82514646237044
IPR013162	CD80-like, immunoglobulin C2-set	 17	0.530053081593445	1	4	13	2215	7893	1.07361556610026
IPR013164	Cadherin, N-terminal	 19	0.406417388847219	1	5	14	2214	7892	1.2007542515595
IPR013216	Methyltransferase type 11	  8	0.55157570878074	1	2	6	2217	7900	1.14071653898152
IPR013273	Peptidase M12B, ADAM-TS	 12	0.94872022890821	1	1	11	2218	7895	0.380238846327174
IPR013315	Spectrin alpha chain, SH3 domain	  8	0.55157570878074	1	2	6	2217	7900	1.14071653898152
IPR013328	6-phosphogluconate dehydrogenase, domain 2	  7	0.475337159710437	1	2	5	2217	7901	1.30367604455031
IPR013517	FG-GAP repeat	 10	0.156885367393478	1	4	6	2215	7900	1.82514646237044
IPR013518	Potassium channel, inwardly rectifying, Kir, cytoplasmic	 10	1	1	0	10	2219	7896	0
IPR013519	Integrin alpha beta-propellor	 10	0.156885367393478	1	4	6	2215	7900	1.82514646237044
IPR013520	Exonuclease, RNase T/DNA polymerase III	  9	0.112968561396348	1	4	5	2215	7901	2.02794051374493
IPR013548	Plexin, cytoplasmic RasGAP domain	  6	1	1	0	6	2219	7900	0
IPR013568	SEFIR domain	  5	1	1	0	5	2219	7901	0
IPR013579	FAST kinase-like protein, subdomain 2	  5	1	1	0	5	2219	7901	0
IPR013584	RAP domain	  5	1	1	0	5	2219	7901	0
IPR013602	Dynein heavy chain, domain-2	  6	0.023542473337703	0.604590751459735	4	2	2215	7904	3.0419107706174
IPR013625	Tensin/EPS8 phosphotyrosine-binding domain	  5	1	1	0	5	2219	7901	0
IPR013649	Integrin alpha-2	  9	0.112968561396348	1	4	5	2215	7901	2.02794051374493
IPR013655	PAS fold-3	  7	0.823119684279113	1	1	6	2218	7900	0.651838022275156
IPR013662	RyR/IP3R Homology associated domain	  6	0.391653542140149	1	2	4	2217	7902	1.5209553853087
IPR013684	Mitochondrial Rho-like	  8	0.55157570878074	1	2	6	2217	7900	1.14071653898152
IPR013761	Sterile alpha motif/pointed domain	 79	0.909368778186447	1	13	66	2206	7840	0.750851392747332
IPR013763	Cyclin-like	 29	0.457331376554077	1	7	22	2212	7884	1.10138148591319
IPR013766	Thioredoxin domain	 24	0.630273099607129	1	5	19	2214	7887	0.950597115817936
IPR013767	PAS fold	 12	0.258504508417295	1	4	8	2215	7898	1.5209553853087
IPR013785	Aldolase-type TIM barrel	 25	0.935005355316715	1	3	22	2216	7884	0.547543938711131
IPR013786	Acyl-CoA dehydrogenase/oxidase, N-terminal	 10	0.679378687010405	1	2	8	2217	7898	0.912573231185219
IPR013787	S100/CaBP-9k-type, calcium binding, subdomain	 12	1	1	0	12	2219	7894	0
IPR013790	Dwarfin	  7	0.182444498214428	1	3	4	2216	7902	1.95551406682547
IPR013799	STAT transcription factor, protein interaction	  6	0.391653542140149	1	2	4	2217	7902	1.5209553853087
IPR013800	STAT transcription factor, all-alpha domain	  6	0.391653542140149	1	2	4	2217	7902	1.5209553853087
IPR013801	STAT transcription factor, DNA-binding	  6	0.391653542140149	1	2	4	2217	7902	1.5209553853087
IPR013806	Kringle-like fold	 14	0.968755884502962	1	1	13	2218	7893	0.325919011137578
IPR013809	ENTH  domain	  8	0.246621512499529	1	3	5	2216	7901	1.71107480847228
IPR013815	ATP-grasp fold, subdomain 1	 12	0.508557401602509	1	3	9	2216	7897	1.14071653898152
IPR013830	SGNH hydrolase-type esterase domain	  5	1	1	0	5	2219	7901	0
IPR013838	Beta tubulin, autoregulation binding site	  6	1	1	0	6	2219	7900	0
IPR013977	Glycine cleavage T-protein, C-terminal barrel domain	  5	0.0736454441167817	0.979653214422437	3	2	2216	7904	2.73771969355566
IPR013979	Translation initiation factor, beta propellor-like domain	  5	0.709805979093015	1	1	4	2218	7902	0.912573231185219
IPR014001	Helicase superfamily 1/2, ATP-binding domain	 68	0.0911069943593781	1	20	48	2199	7858	1.34201945762532
IPR014009	PIK-related kinase	  5	0.302351833058719	1	2	3	2217	7903	1.82514646237044
IPR014014	RNA helicase, DEAD-box type, Q motif	 23	0.391190850015152	1	6	17	2213	7889	1.19031291024159
IPR014020	Tensin phosphatase, C2 domain	  5	1	1	0	5	2219	7901	0
IPR014352	FERM/acyl-CoA-binding protein, 3-helical bundle	 38	0.00410357903442855	0.330201326303684	16	22	2203	7884	1.9212068024952
IPR014710	RmlC-like jelly roll fold	 31	0.932227487299302	1	4	27	2215	7879	0.588756923345302
IPR014715	Fibrinogen, alpha/beta/gamma chain, C-terminal globular, subdomain 2	 13	0.959972064372729	1	1	12	2218	7894	0.350989704302007
IPR014716	Fibrinogen, alpha/beta/gamma chain, C-terminal globular, subdomain 1	 16	0.89532336867285	1	2	14	2217	7892	0.570358269490762
IPR014720	Double-stranded RNA-binding domain	 17	0.0585805185280644	0.979653214422437	7	10	2212	7896	1.87882724067545
IPR014721	Ribosomal protein S5 domain 2-type fold, subgroup	 14	0.0650087802585792	0.979653214422437	6	8	2213	7898	1.95551406682547
IPR014722	Ribosomal protein L2 domain 2	  6	0.773436466483588	1	1	5	2218	7901	0.760477692654349
IPR014729	Rossmann-like alpha/beta/alpha sandwich fold	 31	0.223595442759332	1	9	22	2210	7884	1.32470307752693
IPR014743	Chloride channel, core	  6	1	1	0	6	2219	7900	0
IPR014745	MHC class II, alpha/beta chain, N-terminal	  7	1	1	0	7	2219	7899	0
IPR014756	Immunoglobulin E-set	 63	0.99982695397895	1	4	59	2215	7847	0.289705787677847
IPR014764	Defective-in-cullin neddylation protein	  5	0.302351833058719	1	2	3	2217	7903	1.82514646237044
IPR014767	Diaphanous autoregulatory (DAD) domain	  6	0.391653542140149	1	2	4	2217	7902	1.5209553853087
IPR014768	Rho GTPase-binding/formin homology 3 (GBD/FH3) domain	  7	0.475337159710437	1	2	5	2217	7901	1.30367604455031
IPR014770	Munc13 homology 1	  6	0.773436466483588	1	1	5	2218	7901	0.760477692654349
IPR014775	L27 domain, C-terminal	  6	0.773436466483588	1	1	5	2218	7901	0.760477692654349
IPR014782	Peptidase M1, membrane alanine aminopeptidase, N-terminal	  7	1	1	0	7	2219	7899	0
IPR014821	Inositol 1,4,5-trisphosphate/ryanodine receptor	  6	0.391653542140149	1	2	4	2217	7902	1.5209553853087
IPR014847	FERM adjacent (FA)	 11	0.0711357956244884	0.979653214422437	5	6	2214	7900	2.0740300708755
IPR014853	Uncharacterised domain, cysteine-rich	  6	1	1	0	6	2219	7900	0
IPR014873	Voltage-dependent calcium channel, alpha-1 subunit, IQ domain	  5	0.709805979093015	1	1	4	2218	7902	0.912573231185219
IPR015048	Domain of unknown function DUF1899	  5	0.709805979093015	1	1	4	2218	7902	0.912573231185219
IPR015153	EF-hand domain, type 1	  5	0.302351833058719	1	2	3	2217	7903	1.82514646237044
IPR015154	EF-hand domain, type 2	  5	0.302351833058719	1	2	3	2217	7903	1.82514646237044
IPR015321	Type I cytokine receptor, cytokine-binding domain	  6	0.773436466483588	1	1	5	2218	7901	0.760477692654349
IPR015359	Phosphoinositide-specific phospholipase C, EF-hand-like domain	  9	0.892199115824019	1	1	8	2218	7898	0.506985128436233
IPR015373	Interferon/interleukin receptor domain	  5	0.709805979093015	1	1	4	2218	7902	0.912573231185219
IPR015404	Sorting nexin Vps5-like, C-terminal	  5	0.302351833058719	1	2	3	2217	7903	1.82514646237044
IPR015415	Vps4 oligomerisation, C-terminal	  7	0.475337159710437	1	2	5	2217	7901	1.30367604455031
IPR015421	Pyridoxal phosphate-dependent transferase, major region, subdomain 1	 23	0.0467021727149985	0.84838322906845	9	14	2210	7892	1.78546936536238
IPR015422	Pyridoxal phosphate-dependent transferase, subdomain 2	 21	0.0689303145852814	0.979653214422437	8	13	2211	7893	1.73823472606708
IPR015424	Pyridoxal phosphate-dependent transferase	 23	0.0467021727149985	0.84838322906845	9	14	2210	7892	1.78546936536238
IPR015425	Formin, FH2 domain	  9	0.112968561396348	1	4	5	2215	7901	2.02794051374493
IPR015433	Phosphatidylinositol kinase	  6	0.391653542140149	1	2	4	2217	7902	1.5209553853087
IPR015500	Peptidase S8, subtilisin-related	  7	0.182444498214428	1	3	4	2216	7902	1.95551406682547
IPR015505	Coronin	  5	0.709805979093015	1	1	4	2218	7902	0.912573231185219
IPR015526	Frizzled/secreted frizzled-related protein	 12	0.94872022890821	1	1	11	2218	7895	0.380238846327174
IPR015590	Aldehyde dehydrogenase domain	 12	0.508557401602509	1	3	9	2216	7897	1.14071653898152
IPR015615	Transforming growth factor-beta-related	  9	1	1	0	9	2219	7897	0
IPR015621	Interleukin-1 receptor family	  6	1	1	0	6	2219	7900	0
IPR015655	Protein phosphatase 2C family	 10	0.380546254047252	1	3	7	2216	7899	1.36885984677783
IPR015720	TMP21-related	  6	0.391653542140149	1	2	4	2217	7902	1.5209553853087
IPR015797	NUDIX hydrolase domain-like	 17	0.309606220431718	1	5	12	2214	7894	1.34201945762532
IPR015812	Integrin beta subunit	  6	1	1	0	6	2219	7900	0
IPR015847	Exoribonuclease, phosphorolytic domain 2	  7	0.475337159710437	1	2	5	2217	7901	1.30367604455031
IPR015894	Guanylate-binding protein, N-terminal	  7	1	1	0	7	2219	7899	0
IPR015898	G-protein gamma-like domain	 10	0.915845830136643	1	1	9	2218	7897	0.456286615592609
IPR015915	Kelch-type beta propeller	 32	0.733171015165276	1	6	26	2213	7880	0.855537404236142
IPR015916	Galactose oxidase, beta-propeller	 20	0.953198417975075	1	2	18	2217	7888	0.456286615592609
IPR015917	Peptidase C14A, caspase catalytic domain	  8	0.55157570878074	1	2	6	2217	7900	1.14071653898152
IPR015919	Cadherin-like	 43	0.933224661246027	1	6	37	2213	7869	0.636678998501315
IPR015925	Ryanodine receptor-related	  6	0.391653542140149	1	2	4	2217	7902	1.5209553853087
IPR015940	Ubiquitin-associated domain	 29	0.166269494282477	1	9	20	2210	7886	1.41606191045982
IPR015947	PUA-like domain	 13	0.567135500014957	1	3	10	2216	7896	1.05296911290602
IPR015955	Lactate dehydrogenase/glycoside hydrolase, family 4, C-terminal	  6	0.12374841489586	1	3	3	2216	7903	2.28143307796305
IPR015988	STAT transcription factor, coiled coil	  6	0.391653542140149	1	2	4	2217	7902	1.5209553853087
IPR016035	Acyl transferase/acyl hydrolase/lysophospholipase	  7	0.475337159710437	1	2	5	2217	7901	1.30367604455031
IPR016039	Thiolase-like	  6	0.391653542140149	1	2	4	2217	7902	1.5209553853087
IPR016050	Proteasome beta-type subunit, conserved site	 10	0.679378687010405	1	2	8	2217	7898	0.912573231185219
IPR016054	Ly-6 antigen/uPA receptor-like	 10	1	1	0	10	2219	7896	0
IPR016055	Alpha-D-phosphohexomutase, alpha/beta/alpha I/II/III	  5	0.302351833058719	1	2	3	2217	7903	1.82514646237044
IPR016064	NAD kinase/diacylglycerol kinase-like domain	 12	0.775765479746437	1	2	10	2217	7896	0.760477692654349
IPR016093	MIR motif	  8	0.55157570878074	1	2	6	2217	7900	1.14071653898152
IPR016129	Peptidase family C14A, His active site	  7	0.823119684279113	1	1	6	2218	7900	0.651838022275156
IPR016130	Protein-tyrosine phosphatase, active site	 56	0.587587294316793	1	12	44	2207	7862	0.977757033412734
IPR016135	Ubiquitin-conjugating enzyme/RWD-like	 39	0.492676738071747	1	9	30	2210	7876	1.05296911290602
IPR016137	RGS domain	 26	0.853273916781349	1	4	22	2215	7884	0.701979408604014
IPR016152	Phosphotransferase/anion transporter	  5	0.302351833058719	1	2	3	2217	7903	1.82514646237044
IPR016156	FAD/NAD-linked reductase, dimerisation domain	  5	0.709805979093015	1	1	4	2218	7902	0.912573231185219
IPR016157	Cullin, conserved site	  6	0.391653542140149	1	2	4	2217	7902	1.5209553853087
IPR016158	Cullin homology	  7	0.475337159710437	1	2	5	2217	7901	1.30367604455031
IPR016159	Cullin repeat-like-containing domain	 12	0.508557401602509	1	3	9	2216	7897	1.14071653898152
IPR016160	Aldehyde dehydrogenase, cysteine active site	  9	0.619612200417774	1	2	7	2217	7899	1.01397025687247
IPR016161	Aldehyde/histidinol dehydrogenase	 12	0.508557401602509	1	3	9	2216	7897	1.14071653898152
IPR016162	Aldehyde dehydrogenase N-terminal domain	 12	0.508557401602509	1	3	9	2216	7897	1.14071653898152
IPR016177	DNA-binding domain	 10	0.0470933524006513	0.84838322906845	5	5	2214	7901	2.28143307796305
IPR016181	Acyl-CoA N-acyltransferase	 26	0.19263471975536	1	8	18	2211	7888	1.40395881720803
IPR016185	Pre-ATP-grasp domain	 11	0.446044178306205	1	3	8	2216	7898	1.2444180425253
IPR016186	C-type lectin-like/link domain	 35	0.965078757558813	1	4	31	2215	7875	0.521470417820125
IPR016187	C-type lectin fold	 41	0.963229189316756	1	5	36	2214	7870	0.556447092186109
IPR016192	APOBEC/CMP deaminase, zinc-binding	  5	0.709805979093015	1	1	4	2218	7902	0.912573231185219
IPR016193	Cytidine deaminase-like	  6	0.773436466483588	1	1	5	2218	7901	0.760477692654349
IPR016194	SPOC-like, C-terminal domain	  5	0.709805979093015	1	1	4	2218	7902	0.912573231185219
IPR016197	Chromo domain-like	 17	0.309606220431718	1	5	12	2214	7894	1.34201945762532
IPR016201	PSI domain	 31	0.932227487299302	1	4	27	2215	7879	0.588756923345302
IPR016239	Ribosomal protein S6 kinase II	  6	0.773436466483588	1	1	5	2218	7901	0.760477692654349
IPR016257	Ephrin receptor type-A /type-B	 10	1	1	0	10	2219	7896	0
IPR016439	Ceramide synthase component Lag1/Lac1	  5	0.709805979093015	1	1	4	2218	7902	0.912573231185219
IPR016449	Potassium channel, inwardly rectifying, Kir	 10	1	1	0	10	2219	7896	0
IPR016491	Septin	  9	0.112968561396348	1	4	5	2215	7901	2.02794051374493
IPR017096	BTB-kelch protein	 25	0.66845793236727	1	5	20	2214	7886	0.912573231185218
IPR017448	SRCR-like domain	 13	0.959972064372729	1	1	12	2218	7894	0.350989704302007
IPR017455	Zinc finger, FYVE-related	 23	0.224211351990502	1	7	16	2212	7890	1.38869839528185
IPR017849	Alkaline phosphatase-like, alpha/beta/alpha	 18	0.579235824403936	1	4	14	2215	7892	1.01397025687247
IPR017850	Alkaline-phosphatase-like, core domain	 19	0.625320740552394	1	4	15	2215	7891	0.960603401247598
IPR017853	Glycoside hydrolase superfamily	 26	0.853273916781349	1	4	22	2215	7884	0.701979408604014
IPR017854	Metallothionein domain	  7	1	1	0	7	2219	7899	0
IPR017855	SMAD domain-like	 12	0.258504508417295	1	4	8	2215	7898	1.5209553853087
IPR017857	Coagulation factor, subgroup, Gla domain	  7	0.823119684279113	1	1	6	2218	7900	0.651838022275156
IPR017868	Filamin/ABP280 repeat-like	  8	0.55157570878074	1	2	6	2217	7900	1.14071653898152
IPR017871	ABC transporter, conserved site	 26	0.00147477233731776	0.316656565736196	13	13	2206	7893	2.28143307796305
IPR017877	Myb-like domain	  8	0.55157570878074	1	2	6	2217	7900	1.14071653898152
IPR017884	SANT domain	 19	0.222102541903365	1	6	13	2213	7893	1.4409051018714
IPR017891	Insulin-like growth factor binding protein, N-terminal, Cys-rich conserved site	  9	1	1	0	9	2219	7897	0
IPR017892	Protein kinase, C-terminal	 25	0.477533768566566	1	6	19	2213	7887	1.09508787742226
IPR017903	COS domain	  5	0.709805979093015	1	1	4	2218	7902	0.912573231185219
IPR017907	Zinc finger, RING-type, conserved site	 82	0.244777152064442	1	21	61	2198	7845	1.16853889359083
IPR017920	COMM domain	  8	0.861911680778881	1	1	7	2218	7899	0.570358269490762
IPR017926	Glutamine amidotransferase	  6	1	1	0	6	2219	7900	0
IPR017927	Ferredoxin reductase-type FAD-binding domain	 10	0.679378687010405	1	2	8	2217	7898	0.912573231185219
IPR017930	Myb domain	  8	0.0754828077392598	0.979653214422437	4	4	2215	7902	2.28143307796305
IPR017937	Thioredoxin, conserved site	 12	0.508557401602509	1	3	9	2216	7897	1.14071653898152
IPR017938	Riboflavin synthase-like beta-barrel	 10	0.679378687010405	1	2	8	2217	7898	0.912573231185219
IPR017946	PLC-like phosphodiesterase, TIM beta/alpha-barrel domain	 18	0.929700032751984	1	2	16	2217	7890	0.506985128436233
IPR017948	Transforming growth factor beta, conserved site	  9	1	1	0	9	2219	7897	0
IPR017970	Homeobox, conserved site	 51	0.999625295301731	1	3	48	2216	7858	0.268403891525064
IPR017972	Cytochrome P450, conserved site	 17	0.985143691979199	1	1	16	2218	7890	0.268403891525064
IPR017974	Claudin, conserved site	  5	1	1	0	5	2219	7901	0
IPR017975	Tubulin, conserved site	 14	0.968755884502962	1	1	13	2218	7893	0.325919011137578
IPR017978	GPCR family 3, C-terminal	 11	0.934307333144729	1	1	10	2218	7896	0.414806014175099
IPR017979	GPCR, family 3, conserved site	  7	1	1	0	7	2219	7899	0
IPR017981	GPCR, family 2-like	 30	0.670257615882273	1	6	24	2213	7882	0.912573231185219
IPR017983	GPCR, family 2, secretin-like, conserved site	 15	0.216879992767108	1	5	10	2214	7896	1.5209553853087
IPR017984	Chromo domain subgroup	  7	0.475337159710437	1	2	5	2217	7901	1.30367604455031
IPR017990	Connexin, conserved site	  9	0.892199115824019	1	1	8	2218	7898	0.506985128436233
IPR017998	Chaperone tailless complex polypeptide 1 (TCP-1)	  9	1	1	0	9	2219	7897	0
IPR018000	Neurotransmitter-gated ion-channel, conserved site	 16	0.89532336867285	1	2	14	2217	7892	0.570358269490762
IPR018039	Intermediate filament protein, conserved site	 14	0.968755884502962	1	1	13	2218	7893	0.325919011137578
IPR018048	CXC chemokine, conserved site	  6	1	1	0	6	2219	7900	0
IPR018056	Kringle, conserved site	  8	1	1	0	8	2219	7898	0
IPR018064	Metallothionein, vertebrate, metal binding site	  7	1	1	0	7	2219	7899	0
IPR018073	Proteinase inhibitor I25, cystatin, conserved site	  6	1	1	0	6	2219	7900	0
IPR018097	EGF-like calcium-binding, conserved site	 62	0.975610989263395	1	8	54	2211	7852	0.588756923345302
IPR018107	Sodium:dicarboxylate symporter, conserved site	  5	0.302351833058719	1	2	3	2217	7903	1.82514646237044
IPR018108	Mitochondrial substrate/solute carrier	 37	0.932009564506298	1	5	32	2214	7874	0.616603534584607
IPR018114	Serine proteases, trypsin family, histidine active site	 29	0.993054734064178	1	2	27	2217	7879	0.314680424546627
IPR018122	Fork head domain conserved site1	 13	0.813698203333979	1	2	11	2217	7895	0.701979408604014
IPR018123	WWE domain, subgroup	  5	0.709805979093015	1	1	4	2218	7902	0.912573231185219
IPR018143	Folate receptor-like	  5	0.709805979093015	1	1	4	2218	7902	0.912573231185219
IPR018159	Spectrin/alpha-actinin	 23	0.391190850015152	1	6	17	2213	7889	1.19031291024159
IPR018161	Wnt protein, conserved site	  6	0.773436466483588	1	1	5	2218	7901	0.760477692654349
IPR018181	Heat shock protein 70, conserved site	 12	0.94872022890821	1	1	11	2218	7895	0.380238846327174
IPR018184	Integrin alpha chain, C-terminal cytoplasmic region, conserved site	  9	0.112968561396348	1	4	5	2215	7901	2.02794051374493
IPR018186	Transcription factor, T-box, conserved site	  5	1	1	0	5	2219	7901	0
IPR018200	Ubiquitin specific protease, conserved site	 39	0.0322920038372622	0.721786085769916	14	25	2205	7881	1.63795195340937
IPR018252	Annexin repeat, conserved site	  8	0.861911680778881	1	1	7	2218	7899	0.570358269490762
IPR018253	DnaJ domain, conserved site	 17	0.914113969866565	1	2	15	2217	7891	0.536807783050129
IPR018297	Adenylyl cyclase class-4/guanylyl cyclase, conserved site	 13	0.813698203333979	1	2	11	2217	7895	0.701979408604014
IPR018303	P-type ATPase, phosphorylation site	 26	0.19263471975536	1	8	18	2211	7888	1.40395881720803
IPR018316	Tubulin/FtsZ, 2-layer sandwich domain	 13	0.959972064372729	1	1	12	2218	7894	0.350989704302007
IPR018338	Carbonic anhydrase, alpha-class, conserved site	  6	1	1	0	6	2219	7900	0
IPR018358	Disintegrin, conserved site	  5	0.302351833058719	1	2	3	2217	7903	1.82514646237044
IPR018359	Bromodomain, conserved site	 23	0.00139563859743629	0.316656565736196	12	11	2207	7895	2.38062582048318
IPR018376	Enoyl-CoA hydratase/isomerase, conserved site	  5	0.0736454441167817	0.979653214422437	3	2	2216	7904	2.73771969355566
IPR018378	C-type lectin, conserved site	 13	0.959972064372729	1	1	12	2218	7894	0.350989704302007
IPR018379	BEN domain	  6	1	1	0	6	2219	7900	0
IPR018392	LysM domain	  6	0.391653542140149	1	2	4	2217	7902	1.5209553853087
IPR018487	Hemopexin-like repeats	  7	1	1	0	7	2219	7899	0
IPR018488	Cyclic nucleotide-binding, conserved site	  9	0.619612200417774	1	2	7	2217	7899	1.01397025687247
IPR018490	Cyclic nucleotide-binding-like	 22	0.890429693591044	1	3	19	2216	7887	0.622209021262649
IPR018491	SLC12A transporter, C-terminal	  5	0.709805979093015	1	1	4	2218	7902	0.912573231185219
IPR018494	Oxysterol-binding protein, conserved site	 10	0.679378687010405	1	2	8	2217	7898	0.912573231185219
IPR018499	Tetraspanin/Peripherin	 21	0.961921008436792	1	2	19	2217	7887	0.434558681516771
IPR018502	Annexin repeat	  8	0.861911680778881	1	1	7	2218	7899	0.570358269490762
IPR018503	Tetraspanin, conserved site	 14	0.845782402679702	1	2	12	2217	7894	0.651838022275156
IPR018506	Cytochrome b5, heme-binding site	  5	1	1	0	5	2219	7901	0
IPR018525	Mini-chromosome maintenance, conserved site	  5	1	1	0	5	2219	7901	0
IPR018933	Netrin module, non-TIMP type	  9	1	1	0	9	2219	7897	0
IPR018936	Phosphatidylinositol 3/4-kinase, conserved site	 10	0.156885367393478	1	4	6	2215	7900	1.82514646237044
IPR018955	Branched-chain alpha-ketoacid dehydrogenase kinase/Pyruvate dehydrogenase kinase, N-terminal	  5	0.709805979093015	1	1	4	2218	7902	0.912573231185219
IPR018957	Zinc finger, C3HC4 RING-type	 20	0.262481828577984	1	6	14	2213	7892	1.36885984677783
IPR018979	FERM, N-terminal	 23	0.110469985066994	1	8	15	2211	7891	1.58708388032212
IPR018980	FERM, C-terminal PH-like domain	 22	0.0882898764228218	1	8	14	2211	7892	1.6592240567004
IPR019018	Rab-binding domain FIP-RBD	  5	0.709805979093015	1	1	4	2218	7902	0.912573231185219
IPR019479	Peroxiredoxin, C-terminal	  5	0.709805979093015	1	1	4	2218	7902	0.912573231185219
IPR019542	Enhancer of polycomb-like, N-terminal	  8	0.861911680778881	1	1	7	2218	7899	0.570358269490762
IPR019559	Cullin protein, neddylation domain	  6	0.391653542140149	1	2	4	2217	7902	1.5209553853087
IPR019570	Gap junction protein, cysteine-rich domain	  9	0.892199115824019	1	1	8	2218	7898	0.506985128436233
IPR019577	SPARC/Testican, calcium-binding domain	  5	0.0736454441167817	0.979653214422437	3	2	2216	7904	2.73771969355566
IPR019594	Ionotropic glutamate receptor, L-glutamate and glycine-binding domain	 12	0.94872022890821	1	1	11	2218	7895	0.380238846327174
IPR019734	Tetratricopeptide repeat	 97	0.00397936563335826	0.330201326303684	33	64	2186	7842	1.55231529016042
IPR019747	FERM conserved site	 20	0.0524085853900867	0.930252390674039	8	12	2211	7894	1.82514646237044
IPR019748	FERM central domain	 39	0.00556581020956239	0.369707424169972	16	23	2203	7883	1.8719450896107
IPR019749	Band 4.1 domain	 40	0.00742293876147273	0.369707424169972	16	24	2203	7882	1.82514646237044
IPR019762	Dynamin, GTPase region, conserved site	  5	0.709805979093015	1	1	4	2218	7902	0.912573231185219
IPR019786	Zinc finger, PHD-type, conserved site	 47	0.0730624556387834	0.979653214422437	15	32	2204	7874	1.45623387955088
IPR019787	Zinc finger, PHD-finger	 57	0.254045416296769	1	15	42	2204	7864	1.2007542515595
IPR019804	Ras guanine-nucleotide exchange factor, conserved site	 11	0.731230800055783	1	2	9	2217	7897	0.829612028350199
IPR019817	Interferon regulatory factor, conserved site	  6	0.773436466483588	1	1	5	2218	7901	0.760477692654349
IPR019819	Carboxylesterase type B, conserved site	  9	0.619612200417774	1	2	7	2217	7899	1.01397025687247
IPR019821	Kinesin motor domain, conserved site	 23	0.589519856325972	1	5	18	2214	7888	0.991927425201324
IPR019954	Ubiquitin conserved site	  5	1	1	0	5	2219	7901	0
IPR020003	ATPase, alpha/beta subunit, nucleotide-binding domain, active site	  5	1	1	0	5	2219	7901	0
IPR020067	Frizzled domain	 14	0.968755884502962	1	1	13	2218	7893	0.325919011137578
IPR020084	NUDIX hydrolase, conserved site	  9	0.619612200417774	1	2	7	2217	7899	1.01397025687247
IPR020103	Pseudouridine synthase, catalytic domain	  8	0.55157570878074	1	2	6	2217	7900	1.14071653898152
IPR020417	Atypical dual specificity phosphatase	  7	0.475337159710437	1	2	5	2217	7901	1.30367604455031
IPR020422	Dual specificity protein phosphatase domain	 25	0.298882782279106	1	7	18	2212	7888	1.27760252365931
IPR020454	Diacylglycerol/phorbol-ester binding	 24	0.630273099607129	1	5	19	2214	7887	0.950597115817936
IPR020472	G-protein beta WD-40 repeat	 61	0.811878668963729	1	11	50	2208	7856	0.822811929757164
IPR020479	Homeobox domain, metazoa	 24	1	1	0	24	2219	7882	0
IPR020568	Ribosomal protein S5 domain 2-type fold	 26	0.0958018950237156	1	9	17	2210	7889	1.57945366935903
IPR020590	Guanylate kinase, conserved site	 13	0.959972064372729	1	1	12	2218	7894	0.350989704302007
IPR020613	Thiolase, conserved site	  5	0.302351833058719	1	2	3	2217	7903	1.82514646237044
IPR020616	Thiolase, N-terminal	  5	0.302351833058719	1	2	3	2217	7903	1.82514646237044
IPR020617	Thiolase, C-terminal	  5	0.302351833058719	1	2	3	2217	7903	1.82514646237044
IPR020635	Tyrosine-protein kinase, catalytic domain	 52	0.909607921004448	1	8	44	2211	7862	0.701979408604014
IPR020636	Calcium/calmodulin-dependent/calcium-dependent protein kinase	 18	0.579235824403936	1	4	14	2215	7892	1.01397025687247
IPR020717	Apoptosis regulator, Bcl-2, BH1 motif, conserved site	  6	0.773436466483588	1	1	5	2218	7901	0.760477692654349
IPR020726	Apoptosis regulator, Bcl-2, BH2 motif, conserved site	  6	0.773436466483588	1	1	5	2218	7901	0.760477692654349
IPR020728	Apoptosis regulator, Bcl-2, BH3 motif, conserved site	  6	0.391653542140149	1	2	4	2217	7902	1.5209553853087
IPR020821	Extracellular Endonuclease, subunit A	  5	0.302351833058719	1	2	3	2217	7903	1.82514646237044
IPR020837	Fibrinogen, conserved site	 10	0.915845830136643	1	1	9	2218	7897	0.456286615592609
IPR020843	Polyketide synthase, enoylreductase domain	  8	0.55157570878074	1	2	6	2217	7900	1.14071653898152
IPR020845	AMP-binding, conserved site	 14	0.845782402679702	1	2	12	2217	7894	0.651838022275156
IPR020846	Major facilitator superfamily domain	 75	0.921093816507086	1	12	63	2207	7843	0.730058584948175
IPR020849	Small GTPase superfamily, Ras type	 28	0.962280271964013	1	3	25	2216	7881	0.488878516706367
IPR020850	GTPase effector domain	  6	0.391653542140149	1	2	4	2217	7902	1.5209553853087
IPR020864	Membrane attack complex component/perforin (MACPF) domain	  5	1	1	0	5	2219	7901	0
IPR020892	Cyclophilin-type peptidyl-prolyl cis-trans isomerase, conserved site	 11	0.446044178306205	1	3	8	2216	7898	1.2444180425253
IPR020894	Cadherin conserved site	 39	0.885193968336847	1	6	33	2213	7873	0.701979408604014
IPR020901	Proteinase inhibitor I2, Kunitz, conserved site	  7	1	1	0	7	2219	7899	0
IPR020902	Actin/actin-like conserved site	  9	0.892199115824019	1	1	8	2218	7898	0.506985128436233
IPR020904	Short-chain dehydrogenase/reductase, conserved site	 22	0.0350510813695857	0.769211912965271	9	13	2210	7893	1.86662706378795
IPR021109	Aspartic peptidase domain	  9	0.892199115824019	1	1	8	2218	7898	0.506985128436233
IPR021133	HEAT, type 2	 11	0.731230800055783	1	2	9	2217	7897	0.829612028350199
IPR021156	Transcription elongation factor A-like/Brain expressed X-linked	 11	0.446044178306205	1	3	8	2216	7898	1.2444180425253
IPR021190	Peptidase M10A	  7	1	1	0	7	2219	7899	0
IPR021852	Domain of unknown function DUF3456	  5	0.709805979093015	1	1	4	2218	7902	0.912573231185219
IPR021869	Ribonuclease Zc3h12a-like, NYN domain	  5	0.709805979093015	1	1	4	2218	7902	0.912573231185219
IPR021893	Protein of unknown function DUF3504	  5	0.709805979093015	1	1	4	2218	7902	0.912573231185219
IPR022137	Protein of unknown function DUF3669, zinc finger protein	  5	0.302351833058719	1	2	3	2217	7903	1.82514646237044
IPR022164	Kinesin-like	  6	0.773436466483588	1	1	5	2218	7901	0.760477692654349
IPR022272	Lipocalin family conserved site	  5	1	1	0	5	2219	7901	0
IPR022321	Insulin-like growth factor-binding protein family 1-6, chordata	  5	0.709805979093015	1	1	4	2218	7902	0.912573231185219
IPR022383	Lactate/malate dehydrogenase, C-terminal	  5	0.0736454441167817	0.979653214422437	3	2	2216	7904	2.73771969355566
IPR022398	Peptidase S8, subtilisin, His-active site	  7	0.182444498214428	1	3	4	2216	7902	1.95551406682547
IPR022409	PKD/Chitinase domain	  6	0.773436466483588	1	1	5	2218	7901	0.760477692654349
IPR022684	Peptidase C2, calpain family	  5	1	1	0	5	2219	7901	0
IPR022735	Domain of unknown function DUF3585	  7	0.182444498214428	1	3	4	2216	7902	1.95551406682547
IPR022742	Serine aminopeptidase, S33	  6	0.773436466483588	1	1	5	2218	7901	0.760477692654349
IPR022755	Zinc finger, double-stranded RNA binding	 10	0.156885367393478	1	4	6	2215	7900	1.82514646237044
IPR022764	Peptidase S54, rhomboid domain	  7	0.823119684279113	1	1	6	2218	7900	0.651838022275156
IPR022775	AP complex, mu/sigma subunit	 11	0.731230800055783	1	2	9	2217	7897	0.829612028350199
IPR022812	Dynamin superfamily	 12	0.775765479746437	1	2	10	2217	7896	0.760477692654349
IPR022967	RNA-binding domain, S1	  6	0.391653542140149	1	2	4	2217	7902	1.5209553853087
IPR023088	3'5'-cyclic nucleotide phosphodiesterase	 15	0.0015641301624024	0.316656565736196	9	6	2210	7900	2.73771969355566
IPR023152	Ras GTPase-activating protein, conserved site	 11	0.446044178306205	1	3	8	2216	7898	1.2444180425253
IPR023174	3'5'-cyclic nucleotide phosphodiesterase, conserved site	 15	0.0015641301624024	0.316656565736196	9	6	2210	7900	2.73771969355566
IPR023210	NADP-dependent oxidoreductase domain	  7	0.823119684279113	1	1	6	2218	7900	0.651838022275156
IPR023214	HAD-like domain	 58	0.390331080538458	1	14	44	2205	7862	1.10138148591319
IPR023271	Aquaporin-like	  5	0.709805979093015	1	1	4	2218	7902	0.912573231185219
IPR023298	P-type ATPase,  transmembrane domain	  9	0.892199115824019	1	1	8	2218	7898	0.506985128436233
IPR023299	P-type ATPase, cytoplasmic domain N	 26	0.19263471975536	1	8	18	2211	7888	1.40395881720803
IPR023313	Ubiquitin-conjugating enzyme, active site	 19	0.406417388847219	1	5	14	2214	7892	1.2007542515595
IPR023333	Proteasome B-type subunit	  9	0.619612200417774	1	2	7	2217	7899	1.01397025687247
IPR023341	MABP domain	  5	0.302351833058719	1	2	3	2217	7903	1.82514646237044
IPR023362	PH-BEACH domain	  7	0.182444498214428	1	3	4	2216	7902	1.95551406682547
IPR023393	START-like domain	 17	0.530053081593445	1	4	13	2215	7893	1.07361556610026
IPR023394	Sec7 domain, alpha orthogonal bundle	 12	0.258504508417295	1	4	8	2215	7898	1.5209553853087
IPR023395	Mitochondrial carrier domain	 37	0.932009564506298	1	5	32	2214	7874	0.616603534584607
IPR023409	14-3-3 protein, conserved site	  6	1	1	0	6	2219	7900	0
IPR023410	14-3-3 domain	  6	1	1	0	6	2219	7900	0
IPR023411	Ribonuclease A, active site	  5	0.709805979093015	1	1	4	2218	7902	0.912573231185219
IPR023412	Ribonuclease A-domain	  5	0.709805979093015	1	1	4	2218	7902	0.912573231185219
IPR023415	Low-density lipoprotein (LDL) receptor class A, conserved site	 21	0.501228974502052	1	5	16	2214	7890	1.08639670379193
IPR023561	Carbonic anhydrase, alpha-class	  9	0.892199115824019	1	1	8	2218	7898	0.506985128436233
IPR023566	Peptidyl-prolyl cis-trans isomerase, FKBP-type	 12	1	1	0	12	2219	7894	0
IPR023578	Ras guanine nucleotide exchange factor domain	 24	0.922440857155266	1	3	21	2216	7885	0.570358269490762
IPR023581	Platelet-derived growth factor, conserved site	  6	0.773436466483588	1	1	5	2218	7901	0.760477692654349
IPR023587	Metallothionein domain, vertebrate	  7	1	1	0	7	2219	7899	0
IPR023610	Phosphatidylinositol-4-phosphate 5-kinase	  7	1	1	0	7	2219	7899	0
IPR023753	FAD/NAD(P)-binding domain	 43	0.335072569494907	1	11	32	2208	7874	1.16724483058574
IPR023779	Chromo domain, conserved site	 12	0.258504508417295	1	4	8	2215	7898	1.5209553853087
IPR023780	Chromo domain	 15	0.424213602790741	1	4	11	2215	7895	1.21676430824696
IPR023795	Serpin, conserved site	 13	1	1	0	13	2219	7893	0
IPR023796	Serpin domain	 14	1	1	0	14	2219	7892	0
IPR023801	Histone deacetylase domain	 10	0.380546254047252	1	3	7	2216	7899	1.36885984677783
IPR023828	Peptidase S8, subtilisin, Ser-active site	  7	0.182444498214428	1	3	4	2216	7902	1.95551406682547
IPR024066	RGS, subdomain 1	 16	0.980965473031397	1	1	15	2218	7891	0.285179134745381
IPR024079	Metallopeptidase, catalytic domain	 33	0.761237000151127	1	6	27	2213	7879	0.829612028350199
IPR024096	NO signalling/Golgi transport  ligand-binding domain	  6	0.391653542140149	1	2	4	2217	7902	1.5209553853087
IPR024156	Small GTPase superfamily, ARF type	 15	0.670437858376869	1	3	12	2216	7894	0.912573231185219
IPR024317	Dynein heavy chain, P-loop containing D4 domain	  5	0.00949538537636216	0.369707424169972	4	1	2215	7905	3.65029292474087
IPR024607	Sulfatase, conserved site	  7	1	1	0	7	2219	7899	0
IPR024678	Serine/threonine-protein kinase OSR1/WNK, CCT domain	  5	0.00949538537636216	0.369707424169972	4	1	2215	7905	3.65029292474087
IPR024731	EGF domain	  5	1	1	0	5	2219	7901	0
IPR024743	Dynein heavy chain, coiled coil stalk	  6	0.023542473337703	0.604590751459735	4	2	2215	7904	3.0419107706174
IPR024874	Transcription factor Maf family	  5	1	1	0	5	2219	7901	0
IPR024936	Cyclophilin-type peptidyl-prolyl cis-trans isomerase	 12	0.100646351235543	1	5	7	2214	7899	1.90119423163587
IPR024950	Dual specificity phosphatase	 21	0.501228974502052	1	5	16	2214	7890	1.08639670379193
IPR024964	CTLH/CRA C-terminal to LisH motif domain	  5	0.709805979093015	1	1	4	2218	7902	0.912573231185219
IPR024977	Anaphase-promoting complex subunit 4, WD40 domain	 16	0.478183231908334	1	4	12	2215	7894	1.14071653898152
IPR025110	AMP-binding enzyme C-terminal domain	  8	0.861911680778881	1	1	7	2218	7899	0.570358269490762
IPR025202	Phospholipase D-like domain	  5	0.709805979093015	1	1	4	2218	7902	0.912573231185219
IPR025660	Cysteine peptidase, histidine active site	  7	0.475337159710437	1	2	5	2217	7901	1.30367604455031
IPR025661	Cysteine peptidase, asparagine active site	  6	0.391653542140149	1	2	4	2217	7902	1.5209553853087
IPR025799	Protein arginine N-methyltransferase	  9	0.112968561396348	1	4	5	2215	7901	2.02794051374493
IPR025875	Leucine rich repeat 4	  8	0.0754828077392598	0.979653214422437	4	4	2215	7902	2.28143307796305
IPR026082	ABC transporter A, ABCA	  6	0.023542473337703	0.604590751459735	4	2	2215	7904	3.0419107706174
IPR026298	Blc2 family	  7	0.823119684279113	1	1	6	2218	7900	0.651838022275156
IPR026307	Transmembrane protein 132	  5	0.709805979093015	1	1	4	2218	7902	0.912573231185219
IPR026523	Paraneoplastic antigen Ma	 10	1	1	0	10	2219	7896	0
IPR026613	KRAB domain C2H2 zinc finger family	 12	0.100646351235543	1	5	7	2214	7899	1.90119423163587
IPR026791	Dedicator of cytokinesis	  9	0.112968561396348	1	4	5	2215	7901	2.02794051374493
IPR026823	Complement Clr-like EGF domain	 16	0.714804310638839	1	3	13	2216	7893	0.855537404236142
IPR026854	Vacuolar protein sorting-associated protein 13, N-terminal domain	  6	0.391653542140149	1	2	4	2217	7902	1.5209553853087
IPR026906	Leucine rich repeat 5	  7	0.475337159710437	1	2	5	2217	7901	1.30367604455031
IPR026983	Dynein heavy chain	  6	0.023542473337703	0.604590751459735	4	2	2215	7904	3.0419107706174
IPR027007	DHR-1 domain	  9	0.112968561396348	1	4	5	2215	7901	2.02794051374493
IPR027214	Cystatin	  5	1	1	0	5	2219	7901	0
IPR027231	Semaphorin	 16	0.478183231908334	1	4	12	2215	7894	1.14071653898152
IPR027267	Arfaptin homology (AH) domain/BAR domain	 25	0.162840004453315	1	8	17	2211	7889	1.46011716989635
IPR027357	DHR-2 domain	  9	0.112968561396348	1	4	5	2215	7901	2.02794051374493
IPR027370	RING-type zinc-finger, LisH dimerisation motif	 18	0.357913481756731	1	5	13	2214	7893	1.26746282109058
IPR027397	Catenin binding domain	 17	0.985143691979199	1	1	16	2218	7890	0.268403891525064
IPR027408	PNPase/RNase PH domain	  6	0.391653542140149	1	2	4	2217	7902	1.5209553853087
IPR027409	GroEL-like apical domain	 12	0.94872022890821	1	1	11	2218	7895	0.380238846327174
IPR027413	GroEL-like equatorial domain	 11	1	1	0	11	2219	7895	0
IPR027450	Alpha-ketoglutarate-dependent dioxygenase AlkB-like	  6	0.391653542140149	1	2	4	2217	7902	1.5209553853087
IPR027483	Phosphatidylinositol-4-phosphate 5-kinase, C-terminal	  8	0.861911680778881	1	1	7	2218	7899	0.570358269490762
IPR027484	Phosphatidylinositol-4-phosphate 5-kinase, N-terminal domain	  8	0.861911680778881	1	1	7	2218	7899	0.570358269490762
IPR027775	C2H2- zinc finger protein family subset	 13	0.313297073561014	1	4	9	2215	7897	1.40395881720803
IPR027789	Syndecan/Neurexin domain	  6	0.391653542140149	1	2	4	2217	7902	1.5209553853087
IPR027791	Galactosyltransferase, C-terminal	  6	1	1	0	6	2219	7900	0
IPR027925	MCM N-terminal domain	  5	1	1	0	5	2219	7901	0
IPR027936	Ephrin receptor, transmembrane domain	 10	1	1	0	10	2219	7896	0
IPR027995	Galactosyltransferase, N-terminal	  5	1	1	0	5	2219	7901	0
IPR028082	Periplasmic binding protein-like I	 20	0.992937722130014	1	1	19	2218	7887	0.228143307796305
IPR028325	Voltage-gated potassium channel	 23	0.775384083696739	1	4	19	2215	7887	0.79354194016106
IPR028375	KA1 domain/Ssp2, C-terminal	  6	0.023542473337703	0.604590751459735	4	2	2215	7904	3.0419107706174
IPR028565	Mu homology domain	 10	0.679378687010405	1	2	8	2217	7898	0.912573231185219
IPR028889	Ubiquitin specific protease domain	 43	0.0160867318014903	0.588384402557541	16	27	2203	7879	1.69781066267017
IPR029000	Cyclophilin-like domain	 13	0.135221236843926	1	5	8	2214	7898	1.75494852151004
IPR029006	ADF-H/Gelsolin-like domain	 15	0.670437858376869	1	3	12	2216	7894	0.912573231185219
IPR029021	Protein-tyrosine phosphatase-like	 79	0.775651824514763	1	15	64	2204	7842	0.866366991631537
IPR029023	Tensin-type phosphatase domain	  5	1	1	0	5	2219	7901	0
IPR029030	Caspase-like domain	  9	0.31344798805112	1	3	6	2216	7900	1.5209553853087
IPR029033	Histidine phosphatase superfamily	 12	0.775765479746437	1	2	10	2217	7896	0.760477692654349
IPR029034	Cystine-knot cytokine	 26	0.986730852367472	1	2	24	2217	7882	0.350989704302007
IPR029035	DHS-like NAD/FAD-binding domain	  7	1	1	0	7	2219	7899	0
IPR029039	Flavoprotein-like domain	  5	0.709805979093015	1	1	4	2218	7902	0.912573231185219
IPR029044	Nucleotide-diphospho-sugar transferases	 62	0.828645018942252	1	11	51	2208	7855	0.809540769599791
IPR029045	ClpP/crotonase-like domain	 13	0.135221236843926	1	5	8	2214	7898	1.75494852151004
IPR029047	Heat shock protein 70kD, peptide-binding domain	 11	0.934307333144729	1	1	10	2218	7896	0.414806014175099
IPR029048	Heat shock protein 70kD, C-terminal domain	 11	1	1	0	11	2219	7895	0
IPR029052	Metallo-dependent phosphatase-like	 20	0.847043894921231	1	3	17	2216	7889	0.684429923388914
IPR029055	Nucleophile aminohydrolases, N-terminal	 21	0.707304412916063	1	4	17	2215	7889	0.869117363033541
IPR029057	Phosphoribosyltransferase-like	  8	0.861911680778881	1	1	7	2218	7899	0.570358269490762
IPR029058	Alpha/Beta hydrolase fold	 66	0.603276808468741	1	14	52	2205	7854	0.967880699741898
IPR029060	PIN domain-like	  6	1	1	0	6	2219	7900	0
IPR029061	Thiamin diphosphate-binding fold	  9	0.892199115824019	1	1	8	2218	7898	0.506985128436233
IPR029062	Class I glutamine amidotransferase-like	  9	1	1	0	9	2219	7897	0
IPR029063	S-adenosyl-L-methionine-dependent methyltransferase	 77	0.0372895746841804	0.789623099014136	24	53	2195	7853	1.42219204860034
IPR029064	50S ribosomal protein L30e-like	  7	1	1	0	7	2219	7899	0
IPR029069	HotDog domain	  8	0.861911680778881	1	1	7	2218	7899	0.570358269490762
IPR029149	Creatinase/Aminopeptidase P/Spt16, N-terminal	  5	1	1	0	5	2219	7901	0
IPR029510	Aldehyde dehydrogenase, glutamic acid active site	  9	0.619612200417774	1	2	7	2217	7899	1.01397025687247
IPR029515	LAR-interacting protein, Liprin	  6	0.773436466483588	1	1	5	2218	7901	0.760477692654349
IPR029787	Nucleotide cyclase	 13	0.813698203333979	1	2	11	2217	7895	0.701979408604014
IPR030378	Circularly permuted (CP)-type guanine nucleotide-binding (G) domain	  6	0.023542473337703	0.604590751459735	4	2	2215	7904	3.0419107706174
IPR030379	Septin-type guanine nucleotide-binding (G) domain	  9	0.112968561396348	1	4	5	2215	7901	2.02794051374493
IPR030381	Dynamin-type guanine nucleotide-binding (G) domain	 12	0.775765479746437	1	2	10	2217	7896	0.760477692654349
IPR030386	GB1/RHD3-type guanine nucleotide-binding (G) domain	  7	1	1	0	7	2219	7899	0
IPR030395	Glycerophosphodiester phosphodiesterase domain	  5	0.709805979093015	1	1	4	2218	7902	0.912573231185219
IPR030456	Fork head domain conserved site 2	 21	0.707304412916063	1	4	17	2215	7889	0.869117363033541
IPR030492	Rel homology domain, conserved site	  5	1	1	0	5	2219	7901	0
IPR030564	Myotubularin family	 14	0.845782402679702	1	2	12	2217	7894	0.651838022275156
IPR030672	Adenylate cyclase	  8	1	1	0	8	2219	7898	0
IPR031107	Small heat shock protein HSP20	  6	1	1	0	6	2219	7900	0
IPR031127	E3 ubiquitin ligase RBR family	  8	0.55157570878074	1	2	6	2217	7900	1.14071653898152
IPR031148	Plexin family	  7	1	1	0	7	2219	7899	0
IPR031157	Tr-type G domain, conserved site	  8	0.55157570878074	1	2	6	2217	7900	1.14071653898152
IPR031160	F-BAR domain	 16	0.89532336867285	1	2	14	2217	7892	0.570358269490762
IPR031167	OBG-type guanine nucleotide-binding (G) domain	  6	0.391653542140149	1	2	4	2217	7902	1.5209553853087
IPR031259	Intracellular lipid binding protein	  9	0.619612200417774	1	2	7	2217	7899	1.01397025687247
IPR031315	LNS2/PITP	  5	0.302351833058719	1	2	3	2217	7903	1.82514646237044
IPR031327	Mini-chromosome maintenance protein	  6	0.773436466483588	1	1	5	2218	7901	0.760477692654349
IPR031435	Transmembrane protein TMEM132, N-terminal	  5	0.709805979093015	1	1	4	2218	7902	0.912573231185219
IPR031436	Transmembrane protein TMEM132, C-terminal	  5	0.709805979093015	1	1	4	2218	7902	0.912573231185219
IPR031437	Transmembrane protein family 132, middle domain	  5	0.709805979093015	1	1	4	2218	7902	0.912573231185219
IPR031570	Domain of unknown function DUF4704	  5	0.709805979093015	1	1	4	2218	7902	0.912573231185219
IPR031649	Voltage-dependent L-type calcium channel, IQ-associated domain	  5	0.709805979093015	1	1	4	2218	7902	0.912573231185219
IPR031692	EH domain-containing protein, N-terminal	  5	1	1	0	5	2219	7901	0
IPR031777	Sortilin, C-terminal	  5	0.709805979093015	1	1	4	2218	7902	0.912573231185219
IPR031778	Sortilin, N-terminal	  5	0.709805979093015	1	1	4	2218	7902	0.912573231185219
IPR031847	Domain of unknown function DUF4749	  6	0.773436466483588	1	1	5	2218	7901	0.760477692654349
IPR031904	Cadherin, C-terminal catenin-binding domain	  6	0.12374841489586	1	3	3	2216	7903	2.28143307796305
IPR032098	Acyltransferase, C-terminal domain	  5	0.709805979093015	1	1	4	2218	7902	0.912573231185219
IPR032376	Dedicator of cytokinesis, N-terminal domain	  5	0.302351833058719	1	2	3	2217	7903	1.82514646237044
IPR032397	Rel homology dimerisation domain	  9	1	1	0	9	2219	7897	0
IPR032405	Kinesin-associated	  5	0.709805979093015	1	1	4	2218	7902	0.912573231185219
IPR032454	Histone H2A, C-terminal domain	  5	0.709805979093015	1	1	4	2218	7902	0.912573231185219
IPR032455	Cadherin, cytoplasmic C-terminal domain	 11	0.446044178306205	1	3	8	2216	7898	1.2444180425253
IPR032466	Metal-dependent hydrolase	 12	0.775765479746437	1	2	10	2217	7896	0.760477692654349
IPR032471	GAIN domain, N-terminal	  7	0.182444498214428	1	3	4	2216	7902	1.95551406682547
IPR032549	Domain of unknown function DUF4939	  5	1	1	0	5	2219	7901	0
IPR032567	LDOC1-related	  5	1	1	0	5	2219	7901	0
IPR032628	Adenylate cyclase, N-terminal	  8	1	1	0	8	2219	7898	0
IPR032630	P-type ATPase, C-terminal	 12	0.0298210177690119	0.6791314801358	6	6	2213	7900	2.28143307796305
IPR032631	P-type ATPase, N-terminal	 12	0.0298210177690119	0.6791314801358	6	6	2213	7900	2.28143307796305
IPR032695	Integrin domain	 14	0.368924640117772	1	4	10	2215	7896	1.30367604455031
IPR032710	NTF2-like domain	  8	0.55157570878074	1	2	6	2217	7900	1.14071653898152
IPR032778	Growth factor receptor domain 4	  6	0.391653542140149	1	2	4	2217	7902	1.5209553853087
IPR032815	Peptidase S8, pro-domain	  5	0.302351833058719	1	2	3	2217	7903	1.82514646237044
IPR033116	Serine proteases, trypsin family, serine active site	 28	0.991372900356805	1	2	26	2217	7880	0.325919011137578
IPR033121	Peptidase family A1 domain	  5	0.709805979093015	1	1	4	2218	7902	0.912573231185219
IPR033139	Peptidase family C14A, cysteine active site	  7	0.823119684279113	1	1	6	2218	7900	0.651838022275156
IPR033275	E3 ubiquitin-protein ligase MARCH-like	  7	0.823119684279113	1	1	6	2218	7900	0.651838022275156
IPR033614	C-terminal RASSF family	  5	0.709805979093015	1	1	4	2218	7902	0.912573231185219
IPR033690	Adenylate kinase, conserved site	  5	0.302351833058719	1	2	3	2217	7903	1.82514646237044
IPR033760	Integrin beta N-terminal	  6	1	1	0	6	2219	7900	0
IPR033762	MCM OB domain	  6	0.773436466483588	1	1	5	2218	7901	0.760477692654349
